CODREG;CODDEP;CODARR;CODCAN;CODCOM;COM;PMUN;PCAP;PTOT;comuneid
84;01;02;08;001;L'Abergement-Clémenciat;779;19;798;01001
84;01;01;01;002;L'Abergement-de-Varey;256;1;257;01002
84;01;01;01;004;Ambérieu-en-Bugey;14134;380;14514;01004
84;01;02;22;005;Ambérieux-en-Dombes;1751;25;1776;01005
84;01;01;04;006;Ambléon;112;6;118;01006
84;01;01;01;007;Ambronay;2800;115;2915;01007
84;01;01;01;008;Ambutrix;762;15;777;01008
84;01;01;04;009;Andert-et-Condon;326;9;335;01009
84;01;01;10;010;Anglefort;1105;17;1122;01010
84;01;04;14;011;Apremont;368;11;379;01011
84;01;01;10;012;Aranc;329;4;333;01012
84;01;01;01;013;Arandas;143;4;147;01013
84;01;04;15;014;Arbent;3349;93;3442;01014
84;01;01;04;015;Arboys en Bugey;650;17;667;01015
84;01;02;17;016;Arbigny;460;9;469;01016
84;01;01;01;017;Argis;457;16;473;01017
84;01;01;10;019;Armix;27;4;31;01019
84;01;02;22;021;Ars-sur-Formans;1457;28;1485;01021
84;01;01;10;022;Artemare;1249;18;1267;01022
84;01;02;17;023;Asnières-sur-Saône;76;0;76;01023
84;01;02;02;024;Attignat;3251;65;3316;01024
84;01;02;17;025;Bâgé-Dommartin;4065;106;4171;01025
84;01;02;17;026;Bâgé-le-Châtel;973;68;1041;01026
84;01;02;12;027;Balan;2563;52;2615;01027
84;01;02;22;028;Baneins;617;17;634;01028
84;01;02;18;029;Beaupont;685;8;693;01029
84;01;02;21;030;Beauregard;829;15;844;01030
84;01;04;14;031;Bellignat;3652;234;3886;01031
84;01;02;12;032;Béligneux;3376;29;3405;01032
84;01;04;03;033;Valserhône;16378;350;16728;01033
84;01;01;04;034;Belley;9182;400;9582;01034
84;01;04;14;035;Belleydoux;310;8;318;01035
84;01;01;10;036;Valromey-sur-Séran;1326;19;1345;01036
84;01;01;11;037;Bénonces;308;4;312;01037
84;01;02;18;038;Bény;754;21;775;01038
84;01;01;10;039;Béon;443;8;451;01039
84;01;02;02;040;Béréziat;486;10;496;01040
84;01;01;01;041;Bettant;748;21;769;01041
84;01;02;23;042;Bey;291;14;305;01042
84;01;02;13;043;Beynost;4754;113;4867;01043
84;01;04;03;044;Billiat;632;16;648;01044
84;01;02;22;045;Birieux;283;4;287;01045
84;01;02;23;046;Biziat;895;8;903;01046
84;01;01;11;047;Blyes;1182;32;1214;01047
84;01;02;13;049;La Boisse;3283;73;3356;01049
84;01;02;17;050;Boissey;365;4;369;01050
84;01;04;16;051;Bolozon;91;1;92;01051
84;01;02;22;052;Bouligneux;328;6;334;01052
84;01;02;99;053;Bourg-en-Bresse;41111;1742;42853;01053
84;01;01;12;054;Bourg-Saint-Christophe;1457;32;1489;01054
84;01;04;16;056;Boyeux-Saint-Jérôme;349;5;354;01056
84;01;02;17;057;Boz;519;16;535;01057
84;01;01;04;058;Brégnier-Cordon;828;21;849;01058
84;01;04;10;060;Brénod;493;21;514;01060
84;01;01;04;061;Brens;1144;35;1179;01061
84;01;02;12;062;Bressolles;934;22;956;01062
84;01;04;14;063;Brion;533;7;540;01063
84;01;01;11;064;Briord;1070;20;1090;01064
84;01;02;02;065;Buellas;1812;64;1876;01065
84;01;01;04;066;La Burbanche;89;1;90;01066
84;01;04;16;067;Ceignes;255;13;268;01067
84;01;04;16;068;Cerdon;775;15;790;01068
84;01;02;07;069;Certines;1503;39;1542;01069
84;01;03;09;071;Cessy;4808;117;4925;01071
84;01;02;07;072;Ceyzériat;3194;62;3256;01072
84;01;01;04;073;Ceyzérieu;1000;25;1025;01073
84;01;02;07;074;Chalamont;2589;35;2624;01074
84;01;02;22;075;Chaleins;1382;31;1413;01075
84;01;01;10;076;Chaley;125;3;128;01076
84;01;04;16;077;Challes-la-Montagne;196;3;199;01077
84;01;03;20;078;Challex;1557;33;1590;01078
84;01;01;10;079;Champagne-en-Valromey;811;31;842;01079
84;01;01;10;080;Champdor-Corcelles;643;14;657;01080
84;01;04;03;081;Champfromier;735;21;756;01081
84;01;04;03;082;Chanay;628;14;642;01082
84;01;02;22;083;Chaneins;927;17;944;01083
84;01;02;23;084;Chanoz-Châtenay;895;18;913;01084
84;01;02;08;085;La Chapelle-du-Châtelard;400;5;405;01085
84;01;04;14;087;Charix;282;10;292;01087
84;01;01;11;088;Charnoz-sur-Ain;903;27;930;01088
84;01;01;01;089;Château-Gaillard;2253;50;2303;01089
84;01;02;07;090;Châtenay;356;6;362;01090
84;01;02;07;092;Châtillon-la-Palud;1604;58;1662;01092
84;01;02;08;093;Châtillon-sur-Chalaronne;4931;203;5134;01093
84;01;02;17;094;Chavannes-sur-Reyssouze;761;12;773;01094
84;01;02;18;095;Nivigne et Suran;853;12;865;01095
84;01;02;23;096;Chaveyriat;1034;30;1064;01096
84;01;01;04;098;Chazey-Bons;1159;36;1195;01098
84;01;01;11;099;Chazey-sur-Ain;1566;57;1623;01099
84;01;01;04;100;Cheignieu-la-Balme;131;4;135;01100
84;01;04;10;101;Chevillard;152;7;159;01101
84;01;02;17;102;Chevroux;961;15;976;01102
84;01;03;20;103;Chevry;2149;47;2196;01103
84;01;03;20;104;Chézery-Forens;461;10;471;01104
84;01;02;22;105;Civrieux;1829;53;1882;01105
84;01;02;18;106;Cize;179;7;186;01106
84;01;01;01;107;Cleyzieu;133;4;137;01107
84;01;02;18;108;Coligny;1176;24;1200;01108
84;01;03;20;109;Collonges;2226;46;2272;01109
84;01;01;04;110;Colomieu;156;2;158;01110
84;01;01;01;111;Conand;132;1;133;01111
84;01;04;10;112;Condamine;450;12;462;01112
84;01;02;08;113;Condeissiat;817;12;829;01113
84;01;04;03;114;Confort;667;12;679;01114
84;01;02;02;115;Confrançon;1333;30;1363;01115
84;01;01;04;116;Contrevoz;498;12;510;01116
84;01;01;04;117;Conzieu;151;2;153;01117
84;01;01;10;118;Corbonod;1278;32;1310;01118
84;01;01;10;121;Corlier;116;1;117;01121
84;01;02;23;123;Cormoranche-sur-Saône;1162;35;1197;01123
84;01;02;18;124;Cormoz;689;8;697;01124
84;01;02;18;125;Corveissiat;612;13;625;01125
84;01;02;18;127;Courmangoux;508;8;516;01127
84;01;02;17;128;Courtes;305;1;306;01128
84;01;02;07;129;Crans;291;6;297;01129
84;01;02;02;130;Bresse Vallons;2363;44;2407;01130
84;01;01;04;133;Cressin-Rochefort;394;6;400;01133
84;01;02;23;134;Crottet;1758;45;1803;01134
84;01;03;20;135;Crozet;2171;64;2235;01135
84;01;02;23;136;Cruzilles-lès-Mépillat;893;20;913;01136
84;01;01;10;138;Culoz;3004;64;3068;01138
84;01;02;17;139;Curciat-Dongalon;444;5;449;01139
84;01;02;02;140;Curtafond;767;19;786;01140
84;01;01;04;141;Cuzieu;453;15;468;01141
84;01;02;12;142;Dagneux;4777;57;4834;01142
84;01;03;09;143;Divonne-les-Bains;9951;239;10190;01143
84;01;02;07;145;Dompierre-sur-Veyle;1179;22;1201;01145
84;01;02;08;146;Dompierre-sur-Chalaronne;436;3;439;01146
84;01;02;18;147;Domsure;492;3;495;01147
84;01;04;16;148;Dortan;1879;46;1925;01148
84;01;01;01;149;Douvres;1076;28;1104;01149
84;01;02;18;150;Drom;214;5;219;01150
84;01;02;07;151;Druillat;1146;27;1173;01151
84;01;04;14;152;Echallon;748;20;768;01152
84;01;03;20;153;Echenevex;2115;74;2189;01153
84;01;01;10;155;Evosges;143;4;147;01155
84;01;01;12;156;Faramans;815;12;827;01156
84;01;02;22;157;Fareins;2250;42;2292;01157
84;01;03;20;158;Farges;1048;17;1065;01158
84;01;02;17;159;Feillens;3365;71;3436;01159
84;01;03;19;160;Ferney-Voltaire;10026;163;10189;01160
84;01;01;04;162;Flaxieu;65;3;68;01162
84;01;02;02;163;Foissiat;2038;35;2073;01163
84;01;02;22;165;Francheleins;1594;33;1627;01165
84;01;02;21;166;Frans;2423;61;2484;01166
84;01;02;08;167;Garnerans;634;24;658;01167
84;01;02;08;169;Genouilleux;641;22;663;01169
84;01;04;14;170;Béard-Géovreissiat;1053;28;1081;01170
84;01;04;14;171;Géovreisset;844;42;886;01171
84;01;03;09;173;Gex;13121;270;13391;01173
84;01;04;03;174;Giron;178;2;180;01174
84;01;02;17;175;Gorrevod;784;23;807;01175
84;01;02;18;177;Grand-Corent;183;6;189;01177
84;01;02;23;179;Grièges;1881;52;1933;01179
84;01;03;09;180;Grilly;839;21;860;01180
84;01;04;14;181;Groissiat;1241;50;1291;01181
84;01;02;08;183;Guéreins;1479;29;1508;01183
84;01;02;18;184;Hautecourt-Romanèche;763;26;789;01184
84;01;01;10;185;Plateau d'Hauteville;4844;176;5020;01185
84;01;01;10;187;Haut Valromey;618;21;639;01187
84;01;02;08;188;Illiat;663;20;683;01188
84;01;04;03;189;Injoux-Génissiat;1115;26;1141;01189
84;01;01;11;190;Innimond;87;3;90;01190
84;01;04;10;191;Izenave;154;4;158;01191
84;01;04;16;192;Izernore;2277;61;2338;01192
84;01;01;04;193;Izieu;222;7;229;01193
84;01;02;21;194;Jassans-Riottier;6346;93;6439;01194
84;01;02;18;195;Jasseron;1783;54;1837;01195
84;01;02;02;196;Jayat;1226;13;1239;01196
84;01;02;07;197;Journans;351;13;364;01197
84;01;01;12;198;Joyeux;268;3;271;01198
84;01;04;16;199;Jujurieux;2137;46;2183;01199
84;01;04;16;200;Labalme;214;5;219;01200
84;01;01;11;202;Lagnieu;7161;147;7308;01202
84;01;02;23;203;Laiz;1313;42;1355;01203
84;01;04;14;204;Le Poizat-Lalleyriat;735;15;750;01204
84;01;04;10;206;Lantenay;277;6;283;01206
84;01;02;22;207;Lapeyrouse;317;12;329;01207
84;01;01;04;208;Lavours;131;4;135;01208
84;01;03;20;209;Léaz;778;16;794;01209
84;01;03;20;210;Lélex;228;4;232;01210
84;01;02;07;211;Lent;1395;35;1430;01211
84;01;02;17;212;Lescheroux;718;9;727;01212
84;01;01;11;213;Leyment;1341;29;1370;01213
84;01;04;16;214;Leyssard;158;6;164;01214
84;01;04;03;215;Surjoux-Lhopital;140;3;143;01215
84;01;01;11;216;Lhuis;894;21;915;01216
84;01;01;11;219;Lompnas;164;3;167;01219
84;01;01;11;224;Loyettes;3225;31;3256;01224
84;01;02;22;225;Lurcy;372;8;380;01225
84;01;01;04;227;Magnieu;643;14;657;01227
84;01;04;14;228;Maillat;660;14;674;01228
84;01;02;02;229;Malafretaz;1235;24;1259;01229
84;01;02;17;230;Mantenay-Montlin;312;7;319;01230
84;01;02;17;231;Manziat;1948;48;1996;01231
84;01;02;18;232;Marboz;2276;47;2323;01232
84;01;01;11;233;Marchamp;130;3;133;01233
84;01;01;04;234;Marignieu;169;3;172;01234
84;01;02;08;235;Marlieux;1159;87;1246;01235
84;01;02;02;236;Marsonnas;1011;29;1040;01236
84;01;04;14;237;Martignat;1667;65;1732;01237
84;01;02;21;238;Massieux;2670;56;2726;01238
84;01;01;04;239;Massignieu-de-Rives;620;14;634;01239
84;01;04;16;240;Matafelon-Granges;627;16;643;01240
84;01;02;18;241;Meillonnas;1356;34;1390;01241
84;01;04;16;242;Mérignat;135;2;137;01242
84;01;02;22;243;Messimy-sur-Saône;1253;35;1288;01243
84;01;01;12;244;Meximieux;7923;139;8062;01244
84;01;02;18;245;Bohas-Meyriat-Rignat;943;21;964;01245
84;01;02;23;246;Mézériat;2217;36;2253;01246
84;01;03;20;247;Mijoux;312;14;326;01247
84;01;02;22;248;Mionnay;2197;54;2251;01248
84;01;02;13;249;Miribel;10122;151;10273;01249
84;01;02;21;250;Misérieux;1974;252;2226;01250
84;01;02;08;252;Mogneneins;786;22;808;01252
84;01;02;07;254;Montagnat;2116;51;2167;01254
84;01;01;11;255;Montagnieu;647;12;659;01255
84;01;04;03;257;Montanges;351;10;361;01257
84;01;02;08;258;Montceaux;1190;32;1222;01258
84;01;02;02;259;Montcet;702;16;718;01259
84;01;01;12;260;Le Montellier;302;5;307;01260
84;01;02;22;261;Monthieux;668;23;691;01261
84;01;02;12;262;Montluel;6886;83;6969;01262
84;01;02;08;263;Montmerle-sur-Saône;3772;87;3859;01263
84;01;02;02;264;Montracol;1016;20;1036;01264
84;01;04;14;265;Montréal-la-Cluse;3456;71;3527;01265
84;01;02;02;266;Montrevel-en-Bresse;2576;42;2618;01266
84;01;04;16;267;Nurieux-Volognat;1025;23;1048;01267
84;01;01;04;268;Murs-et-Gélignieux;246;3;249;01268
84;01;04;14;269;Nantua;3454;135;3589;01269
84;01;02;08;272;Neuville-les-Dames;1500;20;1520;01272
84;01;04;16;273;Neuville-sur-Ain;1800;27;1827;01273
84;01;04;14;274;Les Neyrolles;645;15;660;01274
84;01;02;13;275;Neyron;2569;50;2619;01275
84;01;02;13;276;Niévroz;1624;27;1651;01276
84;01;01;01;277;Nivollet-Montgriffon;117;2;119;01277
84;01;01;01;279;Oncieu;80;6;86;01279
84;01;01;11;280;Ordonnaz;138;1;139;01280
84;01;03;19;281;Ornex;4483;170;4653;01281
84;01;04;10;282;Outriaz;258;6;264;01282
84;01;04;15;283;Oyonnax;22456;479;22935;01283
84;01;02;17;284;Ozan;694;13;707;01284
84;01;02;21;285;Parcieux;1229;30;1259;01285
84;01;01;04;286;Parves et Nattages;951;38;989;01286
84;01;03;20;288;Péron;2717;55;2772;01288
84;01;02;06;289;Péronnas;6520;291;6811;01289
84;01;01;12;290;Pérouges;1273;32;1305;01290
84;01;02;23;291;Perrex;842;7;849;01291
84;01;04;16;293;Peyriat;148;4;152;01293
84;01;01;04;294;Peyrieu;886;16;902;01294
84;01;02;08;295;Peyzieux-sur-Saône;686;13;699;01295
84;01;02;18;296;Pirajoux;420;8;428;01296
84;01;02;12;297;Pizay;867;15;882;01297
84;01;04;03;298;Plagne;150;2;152;01298
84;01;02;07;299;Le Plantay;584;8;592;01299
84;01;02;02;301;Polliat;2547;61;2608;01301
84;01;01;04;302;Pollieu;163;5;168;01302
84;01;04;16;303;Poncin;1699;36;1735;01303
84;01;04;16;304;Pont-d'Ain;2924;53;2977;01304
84;01;02;17;305;Pont-de-Vaux;2213;43;2256;01305
84;01;02;23;306;Pont-de-Veyle;1641;64;1705;01306
84;01;04;14;307;Port;836;21;857;01307
84;01;03;20;308;Pougny;807;14;821;01308
84;01;02;18;309;Pouillat;85;0;85;01309
84;01;01;04;310;Prémeyzel;251;4;255;01310
84;01;01;10;311;Prémillieu;44;0;44;01311
84;01;03;19;313;Prévessin-MoÃ«ns;8711;239;8950;01313
84;01;04;16;314;Priay;1729;33;1762;01314
84;01;02;18;317;Ramasse;330;6;336;01317
84;01;02;22;318;Rancé;726;17;743;01318
84;01;02;22;319;Relevant;466;9;475;01319
84;01;02;17;320;Replonges;3791;91;3882;01320
84;01;02;07;321;Revonnas;888;29;917;01321
84;01;02;21;322;Reyrieux;4984;140;5124;01322
84;01;02;17;323;Reyssouze;989;14;1003;01323
84;01;01;12;325;Rignieux-le-Franc;1032;18;1050;01325
84;01;02;08;328;Romans;597;4;601;01328
84;01;01;04;329;Rossillon;153;6;159;01329
84;01;01;10;330;Ruffieu;182;6;188;01330
84;01;04;16;331;Saint-Alban;187;0;187;01331
84;01;02;17;332;Saint-André-de-Bâgé;779;23;802;01332
84;01;02;22;333;Saint-André-de-Corcy;3369;59;3428;01333
84;01;02;23;334;Saint-André-d'Huiriat;658;9;667;01334
84;01;02;08;335;Saint-André-le-Bouchoux;402;6;408;01335
84;01;02;07;336;Saint-André-sur-Vieux-Jonc;1174;22;1196;01336
84;01;02;17;337;Saint-Bénigne;1311;27;1338;01337
84;01;01;04;338;Groslée-Saint-Benoit;1227;37;1264;01338
84;01;02;21;339;Saint-Bernard;1463;43;1506;01339
84;01;02;12;342;Sainte-Croix;554;11;565;01342
84;01;02;23;343;Saint-Cyr-sur-Menthon;1793;41;1834;01343
84;01;02;06;344;Saint-Denis-lès-Bourg;5943;166;6109;01344
84;01;01;01;345;Saint-Denis-en-Bugey;2266;34;2300;01345
84;01;02;02;346;Saint-Didier-d'Aussiat;858;19;877;01346
84;01;02;21;347;Saint-Didier-de-Formans;2035;63;2098;01347
84;01;02;08;348;Saint-Didier-sur-Chalaronne;2938;65;3003;01348
84;01;01;12;349;Saint-Eloi;503;5;508;01349
84;01;02;18;350;Saint-Etienne-du-Bois;2542;40;2582;01350
84;01;02;08;351;Saint-Etienne-sur-Chalaronne;1571;26;1597;01351
84;01;02;17;352;Saint-Etienne-sur-Reyssouze;583;6;589;01352
84;01;02;21;353;Sainte-Euphémie;1700;28;1728;01353
84;01;03;19;354;Saint-Genis-Pouilly;13943;200;14143;01354
84;01;02;23;355;Saint-Genis-sur-Menthon;486;7;493;01355
84;01;02;08;356;Saint-Georges-sur-Renon;208;5;213;01356
84;01;04;03;357;Saint-Germain-de-Joux;502;7;509;01357
84;01;01;04;358;Saint-Germain-les-Paroisses;429;3;432;01358
84;01;02;08;359;Saint-Germain-sur-Renon;246;3;249;01359
84;01;03;20;360;Saint-Jean-de-Gonville;1895;48;1943;01360
84;01;01;11;361;Saint-Jean-de-Niost;1577;48;1625;01361
84;01;02;22;362;Saint-Jean-de-Thurigneux;786;15;801;01362
84;01;04;16;363;Saint-Jean-le-Vieux;1772;70;1842;01363
84;01;02;17;364;Saint-Jean-sur-Reyssouze;756;7;763;01364
84;01;02;23;365;Saint-Jean-sur-Veyle;1162;20;1182;01365
84;01;01;11;366;Sainte-Julie;1082;18;1100;01366
84;01;02;17;367;Saint-Julien-sur-Reyssouze;746;4;750;01367
84;01;02;23;368;Saint-Julien-sur-Veyle;838;15;853;01368
84;01;02;07;369;Saint-Just;942;25;967;01369
84;01;02;23;370;Saint-Laurent-sur-Saône;1688;28;1716;01370
84;01;02;22;371;Saint-Marcel;1242;29;1271;01371
84;01;01;04;372;Saint-Martin-de-Bavel;444;5;449;01372
84;01;04;14;373;Saint-Martin-du-Frêne;1023;30;1053;01373
84;01;02;07;374;Saint-Martin-du-Mont;1871;45;1916;01374
84;01;02;02;375;Saint-Martin-le-Châtel;782;20;802;01375
84;01;02;13;376;Saint-Maurice-de-Beynost;3962;39;4001;01376
84;01;01;11;378;Saint-Maurice-de-Gourdans;2645;54;2699;01378
84;01;01;01;379;Saint-Maurice-de-Rémens;760;11;771;01379
84;01;02;17;380;Saint-Nizier-le-Bouchoux;632;13;645;01380
84;01;02;07;381;Saint-Nizier-le-Désert;921;18;939;01381
84;01;02;22;382;Sainte-Olive;279;2;281;01382
84;01;02;08;383;Saint-Paul-de-Varax;1562;21;1583;01383
84;01;01;01;384;Saint-Rambert-en-Bugey;2188;33;2221;01384
84;01;02;06;385;Saint-Rémy;985;23;1008;01385
84;01;01;11;386;Saint-Sorlin-en-Bugey;1127;66;1193;01386
84;01;02;02;387;Saint-Sulpice;256;3;259;01387
84;01;02;17;388;Saint-Trivier-de-Courtes;1102;9;1111;01388
84;01;02;22;389;Saint-Trivier-sur-Moignans;1834;43;1877;01389
84;01;01;11;390;Saint-Vulbas;1246;21;1267;01390
84;01;02;18;391;Salavre;271;8;279;01391
84;01;04;16;392;Samognat;656;27;683;01392
84;01;02;08;393;Sandrans;544;5;549;01393
84;01;01;11;396;Sault-Brénaz;977;13;990;01396
84;01;03;09;397;Sauverny;978;19;997;01397
84;01;02;22;398;Savigneux;1421;17;1438;01398
84;01;03;20;399;Ségny;2107;51;2158;01399
84;01;01;11;400;Seillonnaz;139;3;142;01400
84;01;03;20;401;Sergy;2167;71;2238;01401
84;01;02;17;402;Sermoyer;652;20;672;01402
84;01;01;11;403;Serrières-de-Briord;1295;41;1336;01403
84;01;04;16;404;Serrières-sur-Ain;135;2;137;01404
84;01;02;07;405;Servas;1280;29;1309;01405
84;01;02;17;406;Servignat;174;1;175;01406
84;01;01;10;407;Seyssel;1002;18;1020;01407
84;01;02;18;408;Simandre-sur-Suran;661;12;673;01408
84;01;04;16;410;Sonthonnax-la-Montagne;300;7;307;01410
84;01;01;11;411;Souclin;273;6;279;01411
84;01;02;08;412;Sulignat;595;12;607;01412
84;01;01;10;415;Talissieu;499;6;505;01415
84;01;01;10;416;Tenay;1014;11;1025;01416
84;01;02;13;418;Thil;1087;27;1114;01418
84;01;03;20;419;Thoiry;6021;176;6197;01419
84;01;02;08;420;Thoissey;1690;8;1698;01420
84;01;01;01;421;Torcieu;729;16;745;01421
84;01;02;07;422;Tossiat;1355;36;1391;01422
84;01;02;21;423;Toussieux;1124;21;1145;01423
84;01;02;13;424;Tramoyes;1776;43;1819;01424
84;01;02;07;425;La Tranclière;288;7;295;01425
84;01;02;18;426;Val-Revermont;2538;59;2597;01426
84;01;02;21;427;Trévoux;6920;164;7084;01427
84;01;02;08;428;Valeins;126;1;127;01428
84;01;02;02;429;Vandeins;707;13;720;01429
84;01;04;16;430;Varambon;619;12;631;01430
84;01;01;01;431;Vaux-en-Bugey;1227;30;1257;01431
84;01;02;18;432;Verjon;323;2;325;01432
84;01;02;17;433;Vernoux;313;4;317;01433
84;01;02;07;434;Versailleux;472;10;482;01434
84;01;03;09;435;Versonnex;2157;69;2226;01435
84;01;03;09;436;Vesancy;481;11;492;01436
84;01;02;17;437;Vescours;223;5;228;01437
84;01;02;17;439;Vésines;99;4;103;01439
84;01;04;10;441;Vieu-d'Izenave;734;18;752;01441
84;01;02;22;443;Villars-les-Dombes;4978;95;5073;01443
84;01;01;11;444;Villebois;1196;17;1213;01444
84;01;02;18;445;Villemotier;615;21;636;01445
84;01;02;22;446;Villeneuve;1548;37;1585;01446
84;01;02;18;447;Villereversure;1342;32;1374;01447
84;01;04;03;448;Villes;389;8;397;01448
84;01;02;07;449;Villette-sur-Ain;759;14;773;01449
84;01;01;11;450;Villieu-Loyes-Mollon;3717;67;3784;01450
84;01;02;05;451;Viriat;6595;150;6745;01451
84;01;01;04;452;Virieu-le-Grand;1132;24;1156;01452
84;01;01;10;453;Arvière-en-Valromey;710;23;733;01453
84;01;01;04;454;Virignin;1112;21;1133;01454
84;01;01;04;456;Vongnes;71;2;73;01456
84;01;02;23;457;Vonnas;3181;59;3240;01457
32;02;02;03;001;Abbécourt;502;11;513;02001
32;02;02;18;002;Achery;610;8;618;02002
32;02;04;17;003;Acy;1021;24;1045;02003
32;02;02;11;004;Agnicourt-et-Séchelles;182;5;187;02004
32;02;02;06;005;Aguilcourt;380;8;388;02005
32;02;05;07;006;Aisonville-et-Bernoville;262;9;271;02006
32;02;02;06;007;Aizelles;122;1;123;02007
32;02;04;05;008;Aizy-Jouy;294;4;298;02008
32;02;03;12;009;Alaincourt;534;6;540;02009
32;02;04;05;010;Allemant;173;4;177;02010
32;02;04;20;011;Ambleny;1138;54;1192;02011
32;02;04;21;012;Ambrief;71;0;71;02012
32;02;02;06;013;Amifontaine;386;9;395;02013
32;02;02;03;014;Amigny-Rouy;729;23;752;02014
32;02;04;21;015;Ancienville;72;1;73;02015
32;02;02;18;016;Andelain;216;9;225;02016
32;02;02;18;017;Anguilcourt-le-Sart;323;4;327;02017
32;02;02;09;018;Anizy-le-Grand;2574;53;2627;02018
32;02;03;12;019;Annois;362;5;367;02019
32;02;05;08;020;Any-Martin-Rieux;455;8;463;02020
32;02;05;19;021;Archon;84;3;87;02021
32;02;04;21;022;Arcy-Sainte-Restitue;403;6;409;02022
32;02;01;21;023;Armentières-sur-Ourcq;102;3;105;02023
32;02;02;10;024;Arrancy;51;0;51;02024
32;02;03;12;025;Artemps;367;2;369;02025
32;02;02;11;027;Assis-sur-Serre;214;7;221;02027
32;02;02;10;028;Athies-sous-Laon;2606;60;2666;02028
32;02;03;13;029;Attilly;354;12;366;02029
32;02;03;01;030;Aubencheul-aux-Bois;257;4;261;02030
32;02;05;08;031;Aubenton;661;6;667;02031
32;02;03;12;032;Aubigny-aux-Kaisnes;253;4;257;02032
32;02;02;06;033;Aubigny-en-Laonnois;104;2;106;02033
32;02;04;20;034;Audignicourt;121;4;125;02034
32;02;05;07;035;Audigny;280;9;289;02035
32;02;04;05;036;Augy;72;1;73;02036
32;02;02;09;037;Aulnois-sous-Laon;1386;30;1416;02037
32;02;05;19;038;Les Autels;59;0;59;02038
32;02;02;11;039;Autremencourt;173;3;176;02039
32;02;05;19;040;Autreppes;180;3;183;02040
32;02;02;03;041;Autreville;807;15;822;02041
32;02;01;04;042;Azy-sur-Marne;384;2;386;02042
32;02;04;16;043;Bagneux;65;1;66;02043
32;02;05;19;044;Bancigny;25;0;25;02044
32;02;02;11;046;Barenton-Bugny;557;9;566;02046
32;02;02;11;047;Barenton-Cel;108;5;113;02047
32;02;02;11;048;Barenton-sur-Serre;133;4;137;02048
32;02;02;20;049;Barisis-aux-Bois;739;13;752;02049
32;02;05;07;050;Barzy-en-Thiérache;323;2;325;02050
32;02;01;04;051;Barzy-sur-Marne;391;6;397;02051
32;02;02;09;052;Bassoles-Aulers;135;6;141;02052
32;02;01;04;053;Vallées en Champagne;571;6;577;02053
32;02;04;05;054;Bazoches-sur-Vesles;461;4;465;02054
32;02;05;08;055;Beaumé;88;2;90;02055
32;02;02;03;056;Beaumont-en-Beine;179;1;180;02056
32;02;03;01;057;Beaurevoir;1406;18;1424;02057
32;02;02;06;058;Beaurieux;856;10;866;02058
32;02;02;18;059;Beautor;2714;28;2742;02059
32;02;03;13;060;Beauvois-en-Vermandois;257;7;264;02060
32;02;03;01;061;Becquigny;246;7;253;02061
32;02;01;02;062;Belleau;137;4;141;02062
32;02;03;01;063;Bellenglise;378;8;386;02063
32;02;04;17;064;Belleu;3832;53;3885;02064
32;02;03;01;065;Bellicourt;600;13;613;02065
32;02;03;12;066;Benay;196;2;198;02066
32;02;05;07;067;Bergues-sur-Sambre;210;5;215;02067
32;02;05;11;068;Berlancourt;88;4;92;02068
32;02;05;19;069;Berlise;105;2;107;02069
32;02;05;07;070;Bernot;445;12;457;02070
32;02;04;20;071;Berny-Rivière;658;15;673;02071
32;02;02;06;072;Berrieux;186;2;188;02072
32;02;02;06;073;Berry-au-Bac;670;4;674;02073
32;02;02;18;074;Bertaucourt-Epourdon;593;10;603;02074
32;02;03;12;075;Berthenicourt;195;2;197;02075
32;02;02;06;076;Bertricourt;152;3;155;02076
32;02;04;17;077;Berzy-le-Sec;379;9;388;02077
32;02;02;20;078;Besmé;163;3;166;02078
32;02;05;08;079;Besmont;149;0;149;02079
32;02;02;09;080;Besny-et-Loizy;333;9;342;02080
32;02;02;03;081;Béthancourt-en-Vaux;434;8;442;02081
32;02;04;21;082;Beugneux;110;0;110;02082
32;02;01;05;083;Beuvardes;750;15;765;02083
32;02;01;04;084;Bézu-le-Guéry;257;5;262;02084
32;02;01;02;085;Bézu-Saint-Germain;1015;25;1040;02085
32;02;02;20;086;Bichancourt;1006;11;1017;02086
32;02;04;20;087;Bieuxy;34;1;35;02087
32;02;02;10;088;Bièvres;92;3;95;02088
32;02;04;17;089;Billy-sur-Aisne;1148;21;1169;02089
32;02;04;21;090;Billy-sur-Ourcq;207;10;217;02090
32;02;04;05;091;Blanzy-lès-Fismes;95;1;96;02091
32;02;02;20;093;Blérancourt;1298;59;1357;02093
32;02;01;02;094;Blesmes;464;9;473;02094
32;02;03;01;095;Bohain-en-Vermandois;5686;78;5764;02095
32;02;02;11;096;Bois-lès-Pargny;197;3;200;02096
32;02;02;06;097;Boncourt;256;2;258;02097
32;02;01;04;098;Bonneil;379;14;393;02098
32;02;01;21;099;Bonnesvalyn;221;5;226;02099
32;02;03;01;100;Bony;138;0;138;02100
32;02;02;11;101;Bosmont-sur-Serre;192;5;197;02101
32;02;02;06;102;Bouconville-Vauclair;191;6;197;02102
32;02;05;07;103;Boué;1339;16;1355;02103
32;02;02;06;104;Bouffignereux;99;4;103;02104
32;02;01;02;105;Bouresches;196;2;198;02105
32;02;02;06;106;Bourg-et-Comin;810;12;822;02106
32;02;02;20;107;Bourguignon-sous-Coucy;107;4;111;02107
32;02;02;09;108;Bourguignon-sous-Montbavin;159;4;163;02108
32;02;05;19;109;La Bouteille;475;10;485;02109
32;02;04;05;110;Braine;2235;25;2260;02110
32;02;02;09;111;Brancourt-en-Laonnois;721;11;732;02111
32;02;03;01;112;Brancourt-le-Grand;553;13;566;02112
32;02;01;02;114;Brasles;1563;37;1600;02114
32;02;02;06;115;Braye-en-Laonnois;190;6;196;02115
32;02;05;19;116;Braye-en-Thiérache;147;1;148;02116
32;02;03;12;117;Bray-Saint-Christophe;68;0;68;02117
32;02;04;05;118;Braye;129;2;131;02118
32;02;01;02;119;Brécy;327;6;333;02119
32;02;04;05;120;Brenelle;196;6;202;02120
32;02;04;21;121;Breny;240;4;244;02121
32;02;02;18;122;Brie;54;1;55;02122
32;02;03;12;123;Brissay-Choigny;301;5;306;02123
32;02;03;12;124;Brissy-Hamégicourt;651;10;661;02124
32;02;01;21;125;Brumetz;193;11;204;02125
32;02;05;19;126;Brunehamel;455;5;460;02126
32;02;01;05;127;Bruyères-sur-Fère;192;5;197;02127
32;02;02;10;128;Bruyères-et-Montbérault;1475;47;1522;02128
32;02;04;05;129;Bruys;18;0;18;02129
32;02;05;08;130;Bucilly;194;7;201;02130
32;02;04;05;131;Bucy-le-Long;1861;42;1903;02131
32;02;02;09;132;Bucy-lès-Cerny;194;3;197;02132
32;02;02;06;133;Bucy-lès-Pierrepont;404;9;413;02133
32;02;05;08;134;Buire;862;18;880;02134
32;02;05;19;135;Buironfosse;1157;17;1174;02135
32;02;05;19;136;Burelles;128;3;131;02136
32;02;01;21;137;Bussiares;160;0;160;02137
32;02;04;21;138;Buzancy;200;3;203;02138
32;02;02;03;139;CaillouÃ«l-Crépigny;442;5;447;02139
32;02;02;20;140;Camelin;456;7;463;02140
32;02;05;19;141;La Capelle;1778;79;1857;02141
32;02;03;15;142;Castres;253;5;258;02142
32;02;03;01;143;Le Catelet;185;6;191;02143
32;02;03;13;144;Caulaincourt;144;3;147;02144
32;02;02;03;145;Caumont;545;10;555;02145
32;02;01;04;146;Celles-lès-Condé;94;1;95;02146
32;02;04;05;148;Celles-sur-Aisne;255;2;257;02148
32;02;03;12;149;Cerizy;62;2;64;02149
32;02;02;10;150;Cerny-en-Laonnois;63;0;63;02150
32;02;02;09;151;Cerny-lès-Bucy;116;3;119;02151
32;02;04;05;152;Cerseuil;89;0;89;02152
32;02;02;09;153;Cessières-Suzy;764;20;784;02153
32;02;04;21;154;Chacrise;365;7;372;02154
32;02;02;09;155;Chaillevois;166;5;171;02155
32;02;02;11;156;Chalandry;257;1;258;02156
32;02;02;09;157;Chambry;836;23;859;02157
32;02;02;10;158;Chamouille;273;2;275;02158
32;02;02;20;159;Champs;295;2;297;02159
32;02;05;19;160;Chaourse;544;12;556;02160
32;02;01;04;162;La Chapelle-sur-Chézy;291;8;299;02162
32;02;01;04;163;Charly-sur-Marne;2585;42;2627;02163
32;02;01;05;164;Le Charmel;325;7;332;02164
32;02;02;18;165;Charmes;1654;26;1680;02165
32;02;01;04;166;Chartèves;356;9;365;02166
32;02;04;05;167;Chassemy;890;14;904;02167
32;02;01;02;168;Château-Thierry;15254;362;15616;02168
32;02;02;11;169;Châtillon-lès-Sons;84;0;84;02169
32;02;03;12;170;Châtillon-sur-Oise;125;0;125;02170
32;02;02;06;171;Chaudardes;88;1;89;02171
32;02;04;21;172;Chaudun;252;9;261;02172
32;02;02;03;173;Chauny;11653;419;12072;02173
32;02;04;05;174;Chavignon;829;16;845;02174
32;02;04;16;175;Chavigny;161;4;165;02175
32;02;04;05;176;Chavonne;206;3;209;02176
32;02;02;10;177;Chérêt;139;2;141;02177
32;02;02;06;178;Chermizy-Ailles;106;2;108;02178
32;02;04;05;179;Chéry-Chartreuve;385;8;393;02179
32;02;02;11;180;Chéry-lès-Pouilly;721;14;735;02180
32;02;05;19;181;Chéry-lès-Rozoy;79;1;80;02181
32;02;05;11;182;Chevennes;117;3;120;02182
32;02;02;06;183;Chevregny;185;1;186;02183
32;02;03;12;184;Chevresis-Monceau;351;5;356;02184
32;02;01;21;185;Chézy-en-Orxois;390;15;405;02185
32;02;01;04;186;Chézy-sur-Marne;1351;45;1396;02186
32;02;01;02;187;Chierry;1134;15;1149;02187
32;02;05;07;188;Chigny;147;4;151;02188
32;02;02;06;189;Chivres-en-Laonnois;350;8;358;02189
32;02;04;05;190;Chivres-Val;518;12;530;02190
32;02;02;10;191;Chivy-lès-Etouvelles;523;5;528;02191
32;02;04;21;192;Chouy;371;7;378;02192
32;02;01;05;193;Cierges;65;1;66;02193
32;02;02;11;194;Cilly;186;8;194;02194
32;02;04;05;195;Ciry-Salsogne;910;25;935;02195
32;02;02;09;196;Clacy-et-Thierret;311;7;318;02196
32;02;05;19;197;Clairfontaine;535;102;637;02197
32;02;04;05;198;Clamecy;228;2;230;02198
32;02;03;12;199;Clastres;601;8;609;02199
32;02;05;19;200;Clermont-les-Fermes;106;1;107;02200
32;02;04;20;201;CÅ“uvres-et-Valsery;441;6;447;02201
32;02;01;02;203;Coincy;1282;20;1302;02203
32;02;05;08;204;Coingt;65;2;67;02204
32;02;02;10;205;Colligis-Crandelain;229;3;232;02205
32;02;05;11;206;Colonfay;76;3;79;02206
32;02;02;03;207;Commenchon;216;3;219;02207
32;02;02;06;208;Concevreux;267;6;273;02208
32;02;01;04;209;Condé-en-Brie;708;11;719;02209
32;02;04;05;210;Condé-sur-Aisne;364;6;370;02210
32;02;02;06;211;Condé-sur-Suippe;294;3;297;02211
32;02;02;03;212;Condren;708;11;719;02212
32;02;01;04;213;Connigis;343;2;345;02213
32;02;03;15;214;Contescourt;61;1;62;02214
32;02;02;06;215;Corbeny;841;6;847;02215
32;02;04;21;216;Corcy;294;4;298;02216
32;02;02;20;217;Coucy-le-Château-Auffrique;992;9;1001;02217
32;02;02;06;218;Coucy-lès-Eppes;628;12;640;02218
32;02;02;20;219;Coucy-la-Ville;200;72;272;02219
32;02;01;05;220;Coulonges-Cohan;436;15;451;02220
32;02;01;04;221;Coupru;152;4;156;02221
32;02;02;18;222;Courbes;32;0;32;02222
32;02;01;04;223;Courboin;301;12;313;02223
32;02;04;05;224;Courcelles-sur-Vesle;346;4;350;02224
32;02;01;21;225;Courchamps;84;2;86;02225
32;02;04;17;226;Courmelles;1863;30;1893;02226
32;02;01;05;227;Courmont;120;1;121;02227
32;02;01;04;228;Courtemont-Varennes;339;6;345;02228
32;02;02;06;229;Courtrizy-et-Fussigny;71;0;71;02229
32;02;04;05;230;Couvrelles;186;6;192;02230
32;02;02;11;231;Couvron-et-Aumencourt;941;9;950;02231
32;02;04;21;232;Coyolles;362;10;372;02232
32;02;04;21;233;Cramaille;145;8;153;02233
32;02;02;06;234;Craonne;83;1;84;02234
32;02;02;06;235;Craonnelle;115;3;118;02235
32;02;02;20;236;Crécy-au-Mont;330;3;333;02236
32;02;02;11;237;Crécy-sur-Serre;1502;16;1518;02237
32;02;02;09;238;Crépy;1816;31;1847;02238
32;02;01;04;239;Crézancy;1244;85;1329;02239
32;02;03;01;240;Croix-Fonsomme;218;3;221;02240
32;02;01;21;241;La Croix-sur-Ourcq;96;3;99;02241
32;02;01;04;242;Crouttes-sur-Marne;641;11;652;02242
32;02;04;16;243;Crouy;2923;47;2970;02243
32;02;05;07;244;Crupilly;63;3;66;02244
32;02;04;16;245;Cuffies;1805;35;1840;02245
32;02;03;12;246;Cugny;611;4;615;02246
32;02;02;11;248;Cuirieux;156;3;159;02248
32;02;04;21;249;Cuiry-Housse;100;0;100;02249
32;02;02;06;250;Cuiry-lès-Chaudardes;73;4;77;02250
32;02;05;19;251;Cuiry-lès-Iviers;27;1;28;02251
32;02;02;06;252;Cuissy-et-Geny;71;2;73;02252
32;02;04;16;253;Cuisy-en-Almont;358;3;361;02253
32;02;04;20;254;Cutry;129;5;134;02254
32;02;04;05;255;Cys-la-Commune;153;2;155;02255
32;02;05;19;256;Dagny-Lambercy;129;3;132;02256
32;02;03;12;257;Dallon;437;13;450;02257
32;02;04;21;258;Dammard;370;13;383;02258
32;02;04;21;259;Dampleux;392;15;407;02259
32;02;02;18;260;Danizy;650;11;661;02260
32;02;02;11;261;Dercy;391;9;400;02261
32;02;02;18;262;Deuillet;211;3;214;02262
32;02;04;05;263;Dhuizel;112;0;112;02263
32;02;05;19;264;Dizy-le-Gros;730;16;746;02264
32;02;05;19;265;Dohis;99;2;101;02265
32;02;05;19;266;Dolignon;46;2;48;02266
32;02;04;20;267;Dommiers;292;10;302;02267
32;02;01;04;268;Domptin;647;13;660;02268
32;02;05;07;269;Dorengt;155;6;161;02269
32;02;03;13;270;Douchy;164;3;167;02270
32;02;01;05;271;Dravegny;130;2;132;02271
32;02;04;21;272;Droizy;78;2;80;02272
32;02;03;12;273;Dury;207;0;207;02273
32;02;02;06;274;Ebouleau;195;6;201;02274
32;02;05;08;275;Effry;319;6;325;02275
32;02;05;19;276;Englancourt;117;5;122;02276
32;02;04;20;277;Epagny;342;7;349;02277
32;02;05;08;278;Eparcy;28;5;33;02278
32;02;01;02;279;Epaux-Bézu;553;25;578;02279
32;02;01;02;280;Epieds;409;12;421;02280
32;02;01;04;281;L'Epine-aux-Bois;256;11;267;02281
32;02;02;10;282;Eppes;427;8;435;02282
32;02;02;11;283;Erlon;287;8;295;02283
32;02;05;19;284;Erloy;102;1;103;02284
32;02;05;07;286;Esquéhéries;867;11;878;02286
32;02;03;12;287;Essigny-le-Grand;1048;27;1075;02287
32;02;03;14;288;Essigny-le-Petit;347;8;355;02288
32;02;01;04;289;Essises;411;11;422;02289
32;02;01;04;290;Essômes-sur-Marne;2745;73;2818;02290
32;02;03;01;291;Estrées;410;8;418;02291
32;02;01;02;292;Etampes-sur-Marne;1305;28;1333;02292
32;02;03;01;293;Etaves-et-Bocquiaux;553;10;563;02293
32;02;02;10;294;Etouvelles;207;8;215;02294
32;02;05;19;295;Etréaupont;853;7;860;02295
32;02;03;13;296;Etreillers;1197;21;1218;02296
32;02;01;02;297;Etrépilly;121;2;123;02297
32;02;05;07;298;Etreux;1420;9;1429;02298
32;02;02;06;299;Evergnicourt;546;6;552;02299
32;02;04;21;302;Faverolles;321;12;333;02302
32;02;03;13;303;Fayet;680;16;696;02303
32;02;02;18;304;La Fère;2838;135;2973;02304
32;02;01;05;305;Fère-en-Tardenois;3001;55;3056;02305
32;02;03;12;306;La Ferté-Chevresis;510;9;519;02306
32;02;04;21;307;La Ferté-Milon;2060;159;2219;02307
32;02;05;07;308;Fesmy-le-Sart;476;8;484;02308
32;02;02;10;309;Festieux;671;5;676;02309
32;02;03;14;310;Fieulaine;248;7;255;02310
32;02;04;05;311;Filain;120;2;122;02311
32;02;05;19;312;La Flamengrie;1100;10;1110;02312
32;02;05;07;313;Flavigny-le-Grand-et-Beaurain;444;5;449;02313
32;02;03;12;315;Flavy-le-Martel;1669;34;1703;02315
32;02;04;21;316;Fleury;128;5;133;02316
32;02;03;13;317;Fluquières;218;4;222;02317
32;02;02;20;318;Folembray;1381;18;1399;02318
32;02;03;14;319;Fonsomme;490;8;498;02319
32;02;03;12;320;Fontaine-lès-Clercs;237;4;241;02320
32;02;05;19;321;Fontaine-lès-Vervins;901;189;1090;02321
32;02;03;14;322;Fontaine-Notre-Dame;386;3;389;02322
32;02;03;01;323;Fontaine-Uterte;134;3;137;02323
32;02;05;19;324;Fontenelle;281;3;284;02324
32;02;04;20;326;Fontenoy;470;8;478;02326
32;02;03;13;327;Foreste;163;1;164;02327
32;02;01;02;328;Fossoy;513;6;519;02328
32;02;02;18;329;Fourdrain;425;9;434;02329
32;02;03;13;330;Francilly-Selency;530;7;537;02330
32;02;05;11;331;Franqueville;110;3;113;02331
32;02;01;05;332;Fresnes-en-Tardenois;265;4;269;02332
32;02;02;20;333;Fresnes-sous-Coucy;164;0;164;02333
32;02;03;01;334;Fresnoy-le-Grand;2958;70;3028;02334
32;02;02;18;335;Fressancourt;183;8;191;02335
32;02;02;03;336;Frières-FaillouÃ«l;983;15;998;02336
32;02;05;19;337;Froidestrées;168;4;172;02337
32;02;02;11;338;Froidmont-Cohartille;252;10;262;02338
32;02;01;21;339;Gandelu;690;9;699;02339
32;02;03;15;340;Gauchy;5235;74;5309;02340
32;02;05;19;341;Gercy;268;1;269;02341
32;02;05;19;342;Gergny;134;2;136;02342
32;02;03;13;343;Germaine;81;0;81;02343
32;02;03;12;345;Gibercourt;41;1;42;02345
32;02;02;06;346;Gizy;664;12;676;02346
32;02;01;02;347;Gland;444;6;450;02347
32;02;02;06;349;Goudelancourt-lès-Berrieux;56;0;56;02349
32;02;02;06;350;Goudelancourt-lès-Pierrepont;136;2;138;02350
32;02;01;05;351;Goussancourt;113;6;119;02351
32;02;03;01;352;Gouy;560;10;570;02352
32;02;02;11;353;Grandlup-et-Fay;287;10;297;02353
32;02;05;19;354;Grandrieux;80;2;82;02354
32;02;03;13;355;Gricourt;953;26;979;02355
32;02;01;02;356;Grisolles;240;2;242;02356
32;02;05;19;357;Gronard;71;2;73;02357
32;02;05;07;358;Grougis;333;3;336;02358
32;02;03;15;359;Grugies;1301;20;1321;02359
32;02;02;06;360;Villeneuve-sur-Aisne;2751;39;2790;02360
32;02;05;07;361;Guise;4645;78;4723;02361
32;02;02;03;362;Guivry;238;12;250;02362
32;02;02;20;363;Guny;390;3;393;02363
32;02;02;06;364;Guyencourt;258;5;263;02364
32;02;05;07;366;Hannapes;324;7;331;02366
32;02;03;12;367;Happencourt;130;4;134;02367
32;02;04;21;368;Haramont;574;7;581;02368
32;02;05;19;369;Harcigny;242;2;244;02369
32;02;03;01;370;Hargicourt;610;5;615;02370
32;02;03;15;371;Harly;1578;35;1613;02371
32;02;04;21;372;Hartennes-et-Taux;347;10;357;02372
32;02;05;19;373;Hary;197;5;202;02373
32;02;03;01;374;Lehaucourt;861;9;870;02374
32;02;01;21;375;Hautevesnes;159;3;162;02375
32;02;05;07;376;Hauteville;174;5;179;02376
32;02;05;19;377;Haution;135;8;143;02377
32;02;05;08;378;La Hérie;129;5;134;02378
32;02;05;11;379;Le Hérie-la-Viéville;209;123;332;02379
32;02;03;12;380;Hinacourt;24;1;25;02380
32;02;05;08;381;Hirson;8710;187;8897;02381
32;02;03;13;382;Holnon;1367;39;1406;02382
32;02;03;15;383;Homblières;1452;46;1498;02383
32;02;05;19;384;Houry;56;2;58;02384
32;02;05;11;385;Housset;160;3;163;02385
32;02;05;07;386;Iron;225;2;227;02386
32;02;03;12;387;Itancourt;1015;35;1050;02387
32;02;05;08;388;Iviers;225;6;231;02388
32;02;01;04;389;Jaulgonne;659;16;675;02389
32;02;03;13;390;Jeancourt;264;2;266;02390
32;02;05;08;391;Jeantes;206;0;206;02391
32;02;03;01;392;Joncourt;311;6;317;02392
32;02;04;05;393;Jouaignes;141;5;146;02393
32;02;02;20;395;Jumencourt;141;6;147;02395
32;02;02;06;396;Jumigny;64;1;65;02396
32;02;03;12;397;Jussy;1252;20;1272;02397
32;02;04;16;398;Juvigny;284;4;288;02398
32;02;02;06;399;Juvincourt-et-Damary;607;5;612;02399
32;02;04;05;400;Laffaux;148;4;152;02400
32;02;05;19;401;Laigny;194;2;196;02401
32;02;03;13;402;Lanchy;37;2;39;02402
32;02;05;11;403;Landifay-et-Bertaignemont;260;7;267;02403
32;02;05;19;404;Landouzy-la-Cour;190;0;190;02404
32;02;05;08;405;Landouzy-la-Ville;535;5;540;02405
32;02;02;20;406;Landricourt;132;5;137;02406
32;02;02;09;407;Laniscourt;199;9;208;02407
32;02;02;97;408;Laon;24304;666;24970;02408
32;02;02;06;409;Lappion;268;4;272;02409
32;02;04;21;410;Largny-sur-Automne;244;10;254;02410
32;02;01;21;411;Latilly;203;4;207;02411
32;02;04;21;412;Launoy;100;1;101;02412
32;02;02;10;413;Laval-en-Laonnois;244;4;248;02413
32;02;05;07;414;Lavaqueresse;201;5;206;02414
32;02;04;20;415;Laversine;160;4;164;02415
32;02;05;11;416;Lemé;420;10;430;02416
32;02;03;01;417;Lempire;116;0;116;02417
32;02;05;19;418;Lerzy;223;4;227;02418
32;02;05;07;419;Leschelle;269;9;278;02419
32;02;03;14;420;Lesdins;829;11;840;02420
32;02;04;05;421;Lesges;106;1;107;02421
32;02;05;07;422;Lesquielles-Saint-Germain;805;10;815;02422
32;02;02;20;423;Leuilly-sous-Coucy;422;8;430;02423
32;02;04;16;424;Leury;104;0;104;02424
32;02;05;08;425;Leuze;172;3;175;02425
32;02;03;01;426;Levergies;540;10;550;02426
32;02;04;05;427;Lhuys;138;1;139;02427
32;02;01;21;428;Licy-Clignon;74;2;76;02428
32;02;02;10;429;Lierval;122;1;123;02429
32;02;02;06;430;Liesse-Notre-Dame;1281;119;1400;02430
32;02;02;18;431;Liez;383;9;392;02431
32;02;04;05;432;Limé;189;5;194;02432
32;02;05;19;433;Lislet;221;8;229;02433
32;02;05;08;435;Logny-lès-Aubenton;79;0;79;02435
32;02;04;21;438;Longpont;249;9;258;02438
32;02;04;05;439;Les Septvallons;1177;20;1197;02439
32;02;02;06;440;Lor;138;0;138;02440
32;02;04;21;441;Louâtre;188;3;191;02441
32;02;01;05;442;Loupeigne;90;1;91;02442
32;02;01;04;443;Lucy-le-Bocage;203;6;209;02443
32;02;05;11;444;Lugny;121;0;121;02444
32;02;05;19;445;Luzoir;282;6;288;02445
32;02;03;12;446;Ly-Fontaine;118;1;119;02446
32;02;04;21;447;Maast-et-Violaine;147;5;152;02447
32;02;02;06;448;Mâchecourt;121;4;125;02448
32;02;04;21;449;Macogny;66;3;69;02449
32;02;05;07;450;Macquigny;366;4;370;02450
32;02;03;01;451;Magny-la-Fosse;124;1;125;02451
32;02;03;13;452;Maissemy;236;10;246;02452
32;02;02;06;453;Maizy;404;8;412;02453
32;02;02;06;454;La Malmaison;404;3;407;02454
32;02;05;07;455;Malzy;204;1;205;02455
32;02;02;20;456;Manicamp;299;4;303;02456
32;02;02;06;457;Marchais;404;10;414;02457
32;02;01;04;458;Dhuys et Morin-en-Brie;820;17;837;02458
32;02;03;14;459;Marcy;161;8;169;02459
32;02;02;11;460;Marcy-sous-Marle;201;1;202;02460
32;02;02;03;461;Marest-Dampcourt;383;6;389;02461
32;02;01;05;462;Mareuil-en-Dôle;231;2;233;02462
32;02;05;11;463;Marfontaine;89;2;91;02463
32;02;04;05;464;Margival;365;2;367;02464
32;02;01;04;465;Marigny-en-Orxois;513;7;520;02465
32;02;04;21;466;Marizy-Sainte-Geneviève;133;0;133;02466
32;02;04;21;467;Marizy-Saint-Mard;51;1;52;02467
32;02;02;11;468;Marle;2235;29;2264;02468
32;02;05;07;469;Marly-Gomont;485;13;498;02469
32;02;05;08;470;Martigny;435;12;447;02470
32;02;02;10;471;Martigny-Courpierre;135;2;137;02471
32;02;02;06;472;Mauregny-en-Haye;409;7;416;02472
32;02;02;18;473;Mayot;215;1;216;02473
32;02;02;18;474;Mennessis;392;4;396;02474
32;02;05;07;476;Mennevret;669;14;683;02476
32;02;04;17;477;Mercin-et-Vaux;964;21;985;02477
32;02;02;09;478;Merlieux-et-Fouquerolles;261;8;269;02478
32;02;02;11;480;Mesbrecourt-Richecourt;312;3;315;02480
32;02;03;15;481;Mesnil-Saint-Laurent;473;16;489;02481
32;02;02;06;482;Meurival;54;1;55;02482
32;02;03;12;483;Mézières-sur-Oise;513;10;523;02483
32;02;01;04;484;Mézy-Moulins;527;3;530;02484
32;02;04;17;485;Missy-aux-Bois;94;4;98;02485
32;02;02;06;486;Missy-lès-Pierrepont;107;1;108;02486
32;02;04;05;487;Missy-sur-Aisne;627;9;636;02487
32;02;05;07;488;Molain;156;2;158;02488
32;02;02;09;489;Molinchart;342;7;349;02489
32;02;04;05;490;Monampteuil;126;3;129;02490
32;02;05;11;491;Monceau-le-Neuf-et-Faucouzy;324;9;333;02491
32;02;02;18;492;Monceau-lès-Leups;454;8;462;02492
32;02;02;11;493;Monceau-le-Waast;224;6;230;02493
32;02;05;07;494;Monceau-sur-Oise;127;2;129;02494
32;02;05;08;495;Mondrepuis;1046;15;1061;02495
32;02;04;21;496;Monnes;100;1;101;02496
32;02;02;09;497;Mons-en-Laonnois;1154;29;1183;02497
32;02;02;06;498;Montaigu;763;13;776;02498
32;02;02;09;499;Montbavin;43;2;45;02499
32;02;03;01;500;Montbrehain;810;19;829;02500
32;02;02;10;501;Montchâlons;93;2;95;02501
32;02;05;19;502;Montcornet;1324;9;1333;02502
32;02;03;12;503;Mont-d'Origny;831;2;833;02503
32;02;03;12;504;Montescourt-Lizerolles;1616;28;1644;02504
32;02;01;04;505;Montfaucon;206;5;211;02505
32;02;04;21;506;Montgobert;195;6;201;02506
32;02;04;21;507;Montgru-Saint-Hilaire;31;1;32;02507
32;02;02;10;508;Monthenault;151;6;157;02508
32;02;01;21;509;Monthiers;156;0;156;02509
32;02;01;04;510;Monthurel;151;2;153;02510
32;02;03;01;511;Montigny-en-Arrouaise;295;4;299;02511
32;02;01;21;512;Montigny-l'Allier;270;5;275;02512
32;02;02;11;513;Montigny-le-Franc;138;2;140;02513
32;02;04;20;514;Montigny-Lengrain;704;15;719;02514
32;02;01;04;515;Montigny-lès-Condé;55;6;61;02515
32;02;02;11;516;Montigny-sous-Marle;67;1;68;02516
32;02;02;11;517;Montigny-sur-Crécy;299;5;304;02517
32;02;01;04;518;Montlevon;303;3;306;02518
32;02;05;19;519;Montloué;186;4;190;02519
32;02;04;05;520;Mont-Notre-Dame;741;7;748;02520
32;02;01;04;521;Montreuil-aux-Lions;1364;14;1378;02521
32;02;05;08;522;Mont-Saint-Jean;74;2;76;02522
32;02;04;05;523;Mont-Saint-Martin;72;1;73;02523
32;02;01;02;524;Mont-Saint-Père;694;15;709;02524
32;02;03;14;525;Morcourt;577;13;590;02525
32;02;05;19;526;Morgny-en-Thiérache;99;3;102;02526
32;02;04;20;527;Morsain;458;9;467;02527
32;02;04;20;528;Mortefontaine;228;5;233;02528
32;02;02;11;529;Mortiers;178;1;179;02529
32;02;02;06;530;Moulins;78;1;79;02530
32;02;02;06;531;Moussy-Verneuil;118;1;119;02531
32;02;03;12;532;MoÃ¿-de-l'Aisne;986;18;1004;02532
32;02;04;21;533;Muret-et-Crouttes;111;8;119;02533
32;02;02;06;534;Muscourt;48;1;49;02534
32;02;05;19;535;Nampcelles-la-Cour;113;5;118;02535
32;02;04;21;536;Nampteuil-sous-Muret;103;1;104;02536
32;02;04;05;537;Nanteuil-la-Fosse;202;1;203;02537
32;02;01;05;538;Nanteuil-Notre-Dame;70;0;70;02538
32;02;03;01;539;Nauroy;702;8;710;02539
32;02;01;02;540;Nesles-la-Montagne;1227;36;1263;02540
32;02;02;06;541;Neufchâtel-sur-Aisne;421;6;427;02541
32;02;02;03;542;Neuflieux;82;2;84;02542
32;02;01;21;543;Neuilly-Saint-Front;2066;34;2100;02543
32;02;05;08;544;Neuve-Maison;616;14;630;02544
32;02;02;11;545;La Neuville-Bosmont;187;2;189;02545
32;02;02;03;546;La Neuville-en-Beine;193;4;197;02546
32;02;05;11;547;La Neuville-Housset;66;1;67;02547
32;02;05;07;548;La Neuville-lès-Dorengt;377;7;384;02548
32;02;03;15;549;Neuville-Saint-Amand;846;25;871;02549
32;02;02;06;550;Neuville-sur-Ailette;115;3;118;02550
32;02;04;05;551;Neuville-sur-Margival;115;0;115;02551
32;02;03;12;552;Neuvillette;187;9;196;02552
32;02;02;06;553;Nizy-le-Comte;244;4;248;02553
32;02;01;04;554;Nogentel;1071;22;1093;02554
32;02;01;04;555;Nogent-l'Artaud;2108;46;2154;02555
32;02;05;19;556;Noircourt;81;1;82;02556
32;02;04;21;557;Noroy-sur-Ourcq;127;0;127;02557
32;02;05;07;558;Le Nouvion-en-Thiérache;2557;28;2585;02558
32;02;02;11;559;Nouvion-et-Catillon;462;4;466;02559
32;02;02;11;560;Nouvion-le-Comte;246;4;250;02560
32;02;02;10;561;Nouvion-le-Vineux;153;4;157;02561
32;02;04;20;562;Nouvron-Vingré;212;2;214;02562
32;02;05;07;563;Noyales;164;3;167;02563
32;02;04;17;564;Noyant-et-Aconin;495;5;500;02564
32;02;02;06;565;Œuilly;291;3;294;02565
32;02;02;03;566;Ognes;1104;23;1127;02566
32;02;05;08;567;Ohis;279;8;287;02567
32;02;04;21;568;Oigny-en-Valois;162;4;166;02568
32;02;05;07;569;Oisy;471;3;474;02569
32;02;03;12;570;Ollezy;177;0;177;02570
32;02;03;14;571;Omissy;717;75;792;02571
32;02;02;06;572;Orainville;502;9;511;02572
32;02;02;10;573;Orgeval;60;1;61;02573
32;02;05;08;574;Origny-en-Thiérache;1432;28;1460;02574
32;02;03;12;575;Origny-Sainte-Benoite;1670;14;1684;02575
32;02;04;16;576;Osly-Courtil;330;8;338;02576
32;02;04;05;577;Ostel;90;1;91;02577
32;02;02;06;578;Oulches-la-Vallée-Foulon;86;1;87;02578
32;02;04;21;579;Oulchy-la-Ville;125;9;134;02579
32;02;04;21;580;Oulchy-le-Château;816;10;826;02580
32;02;04;05;581;Paars;323;1;324;02581
32;02;02;06;582;Paissy;76;2;78;02582
32;02;02;06;583;Pancy-Courtecon;54;2;56;02583
32;02;05;19;584;Papleux;121;6;127;02584
32;02;04;21;585;Parcy-et-Tigny;259;7;266;02585
32;02;05;19;586;Parfondeval;139;6;145;02586
32;02;02;10;587;Parfondru;355;7;362;02587
32;02;02;06;588;Pargnan;68;2;70;02588
32;02;04;05;589;Pargny-Filain;261;0;261;02589
32;02;01;04;590;Pargny-la-Dhuys;169;4;173;02590
32;02;02;11;591;Pargny-les-Bois;135;1;136;02591
32;02;03;12;592;Parpeville;192;4;196;02592
32;02;04;16;593;Pasly;1064;21;1085;02593
32;02;04;21;594;Passy-en-Valois;132;6;138;02594
32;02;01;04;595;Passy-sur-Marne;133;0;133;02595
32;02;01;04;596;Pavant;763;15;778;02596
32;02;04;20;598;Pernant;669;18;687;02598
32;02;02;03;599;Pierremande;255;3;258;02599
32;02;02;11;600;Pierrepont;347;5;352;02600
32;02;02;06;601;Pignicourt;197;2;199;02601
32;02;02;09;602;Pinon;1698;27;1725;02602
32;02;03;12;604;Pithon;84;1;85;02604
32;02;03;12;605;Pleine-Selve;192;5;197;02605
32;02;04;21;606;Le Plessier-Huleu;70;3;73;02606
32;02;04;17;607;Ploisy;78;3;81;02607
32;02;05;19;608;Plomion;473;2;475;02608
32;02;02;06;609;Ployart-et-Vaurseine;20;0;20;02609
32;02;04;16;610;Pommiers;736;11;747;02610
32;02;04;05;612;Pont-Arcy;127;1;128;02612
32;02;02;06;613;Pontavert;605;11;616;02613
32;02;03;13;614;Pontru;265;7;272;02614
32;02;03;13;615;Pontruet;360;5;365;02615
32;02;02;20;616;Pont-Saint-Mard;211;3;214;02616
32;02;02;11;617;Pouilly-sur-Serre;508;4;512;02617
32;02;03;01;618;Prémont;694;12;706;02618
32;02;02;09;619;Prémontré;658;0;658;02619
32;02;04;05;620;Presles-et-Boves;347;9;356;02620
32;02;02;10;621;Presles-et-Thierny;379;15;394;02621
32;02;01;21;622;Priez;54;0;54;02622
32;02;05;19;623;Prisces;97;3;100;02623
32;02;05;07;624;Proisy;275;66;341;02624
32;02;05;07;625;Proix;142;2;144;02625
32;02;02;06;626;Prouvais;334;7;341;02626
32;02;02;06;627;Proviseux-et-Plesnoy;123;3;126;02627
32;02;04;21;628;Puiseux-en-Retz;217;6;223;02628
32;02;05;11;629;Puisieux-et-Clanlieu;311;12;323;02629
32;02;02;20;631;Quierzy;411;5;416;02631
32;02;02;20;632;Quincy-Basse;57;1;58;02632
32;02;04;05;633;Quincy-sous-le-Mont;60;0;60;02633
32;02;05;19;634;Raillimont;82;4;86;02634
32;02;03;01;635;Ramicourt;146;5;151;02635
32;02;03;12;636;Regny;199;5;204;02636
32;02;03;14;637;Remaucourt;293;10;303;02637
32;02;02;11;638;Remies;237;1;238;02638
32;02;03;12;639;Remigny;346;7;353;02639
32;02;03;12;640;Renansart;157;4;161;02640
32;02;05;19;641;Renneval;111;4;115;02641
32;02;05;19;642;Résigny;173;3;176;02642
32;02;04;20;643;Ressons-le-Long;769;8;777;02643
32;02;04;21;644;Retheuil;346;13;359;02644
32;02;01;04;645;Reuilly-Sauvigny;192;9;201;02645
32;02;05;07;647;Ribeauville;60;0;60;02647
32;02;03;12;648;Ribemont;1937;38;1975;02648
32;02;01;02;649;Rocourt-Saint-Martin;307;4;311;02649
32;02;05;19;650;Rocquigny;357;6;363;02650
32;02;02;18;651;Rogécourt;106;1;107;02651
32;02;05;11;652;Rogny;104;1;105;02652
32;02;01;04;653;Romeny-sur-Marne;500;13;513;02653
32;02;05;07;654;Romery;82;1;83;02654
32;02;01;05;655;Ronchères;135;0;135;02655
32;02;02;06;656;Roucy;394;10;404;02656
32;02;05;11;657;Rougeries;250;4;254;02657
32;02;03;13;658;Roupy;236;8;244;02658
32;02;03;14;659;Rouvroy;504;13;517;02659
32;02;05;19;660;Rouvroy-sur-Serre;38;2;40;02660
32;02;02;09;661;Royaucourt-et-Chailvet;254;3;257;02661
32;02;01;21;662;Rozet-Saint-Albin;322;9;331;02662
32;02;04;21;663;Rozières-sur-Crise;221;5;226;02663
32;02;01;04;664;Rozoy-Bellevalle;123;3;126;02664
32;02;04;21;665;Grand-Rozoy;300;5;305;02665
32;02;05;19;666;Rozoy-sur-Serre;1002;17;1019;02666
32;02;04;20;667;Saconin-et-Breuil;203;6;209;02667
32;02;05;11;668;Sains-Richaumont;1057;21;1078;02668
32;02;05;19;670;Saint-Algis;151;0;151;02670
32;02;02;20;671;Saint-Aubin;287;5;292;02671
32;02;04;20;672;Saint-Bandry;261;4;265;02672
32;02;04;20;673;Saint-Christophe-Ã -Berry;444;7;451;02673
32;02;05;08;674;Saint-Clément;48;0;48;02674
32;02;02;06;675;Sainte-Croix;133;1;134;02675
32;02;02;06;676;Saint-Erme-Outre-et-Ramecourt;1716;40;1756;02676
32;02;01;04;677;Saint-Eugène;240;3;243;02677
32;02;05;19;678;Sainte-Geneviève;68;0;68;02678
32;02;01;21;679;Saint-Gengoulph;150;4;154;02679
32;02;02;18;680;Saint-Gobain;2294;37;2331;02680
32;02;05;11;681;Saint-Gobert;279;5;284;02681
32;02;04;05;682;Saint-Mard;114;3;117;02682
32;02;05;07;683;Saint-Martin-Rivière;110;3;113;02683
32;02;05;08;684;Saint-Michel;3314;57;3371;02684
32;02;02;18;685;Saint-Nicolas-aux-Bois;120;1;121;02685
32;02;02;20;686;Saint-Paul-aux-Bois;373;4;377;02686
32;02;04;20;687;Saint-Pierre-Aigle;333;9;342;02687
32;02;05;11;688;Saint-Pierre-lès-Franqueville;48;4;52;02688
32;02;02;11;689;Saint-Pierremont;41;1;42;02689
32;02;02;06;690;Sainte-Preuve;80;1;81;02690
32;02;03;98;691;Saint-Quentin;53570;1281;54851;02691
32;02;04;21;693;Saint-Rémy-Blanzy;221;3;224;02693
32;02;03;12;694;Saint-Simon;641;10;651;02694
32;02;04;05;695;Saint-Thibaut;81;0;81;02695
32;02;02;06;696;Saint-Thomas;76;3;79;02696
32;02;02;10;697;Samoussy;384;5;389;02697
32;02;04;05;698;Sancy-les-Cheminots;101;2;103;02698
32;02;01;05;699;Saponay;280;3;283;02699
32;02;01;04;701;Saulchery;708;8;716;02701
32;02;03;13;702;Savy;602;22;624;02702
32;02;03;01;703;Seboncourt;1083;13;1096;02703
32;02;02;20;704;Selens;247;4;251;02704
32;02;02;06;705;La Selve;210;6;216;02705
32;02;04;17;706;Septmonts;566;11;577;02706
32;02;02;20;707;Septvaux;181;0;181;02707
32;02;03;01;708;Sequehart;215;8;223;02708
32;02;03;01;709;Serain;407;8;415;02709
32;02;03;12;710;Seraucourt-le-Grand;742;18;760;02710
32;02;04;17;711;Serches;293;7;300;02711
32;02;01;05;712;Sergy;142;3;145;02712
32;02;01;05;713;Seringes-et-Nesles;270;4;274;02713
32;02;04;17;714;Sermoise;358;2;360;02714
32;02;04;05;715;Serval;45;3;48;02715
32;02;02;18;716;Servais;290;5;295;02716
32;02;03;12;717;Séry-lès-Mézières;590;13;603;02717
32;02;04;21;718;Silly-la-Poterie;121;3;124;02718
32;02;02;03;719;Sinceny;2028;41;2069;02719
32;02;02;06;720;Sissonne;2034;74;2108;02720
32;02;03;12;721;Sissy;476;2;478;02721
32;02;04;99;722;Soissons;28712;651;29363;02722
32;02;05;19;723;Soize;98;1;99;02723
32;02;01;21;724;Sommelans;61;1;62;02724
32;02;05;19;725;Sommeron;139;6;145;02725
32;02;03;12;726;Sommette-Eaucourt;181;3;184;02726
32;02;02;11;727;Sons-et-Ronchères;221;3;224;02727
32;02;05;19;728;Sorbais;264;4;268;02728
32;02;04;21;729;Soucy;81;1;82;02729
32;02;04;05;730;Soupir;267;6;273;02730
32;02;05;11;731;Le Sourd;171;2;173;02731
32;02;03;12;732;Surfontaine;104;0;104;02732
32;02;04;21;734;Taillefontaine;274;6;280;02734
32;02;04;05;735;Tannières;17;0;17;02735
32;02;04;20;736;Tartiers;167;5;172;02736
32;02;02;11;737;Tavaux-et-Pontséricourt;552;12;564;02737
32;02;02;18;738;Tergnier;13588;200;13788;02738
32;02;04;05;739;Terny-Sorny;335;7;342;02739
32;02;05;19;740;Thenailles;221;6;227;02740
32;02;03;12;741;Thenelles;539;5;544;02741
32;02;02;11;742;Thiernu;114;0;114;02742
32;02;05;19;743;Le Thuel;158;1;159;02743
32;02;01;21;744;Torcy-en-Valois;72;2;74;02744
32;02;02;11;745;Toulis-et-Attencourt;121;1;122;02745
32;02;02;18;746;Travecy;658;8;666;02746
32;02;03;13;747;Trefcon;83;0;83;02747
32;02;01;04;748;Trélou-sur-Marne;939;24;963;02748
32;02;04;21;749;TroÃ«snes;219;7;226;02749
32;02;02;20;750;Trosly-Loire;583;8;591;02750
32;02;02;06;751;Trucy;144;2;146;02751
32;02;03;12;752;Tugny-et-Pont;281;5;286;02752
32;02;05;07;753;Tupigny;328;4;332;02753
32;02;02;03;754;Ugny-le-Gay;185;3;188;02754
32;02;02;09;755;Urcel;589;10;599;02755
32;02;03;12;756;Urvillers;684;12;696;02756
32;02;05;07;757;Vadencourt;529;8;537;02757
32;02;04;05;758;Vailly-sur-Aisne;2012;37;2049;02758
32;02;05;11;759;La Vallée-au-Blé;370;3;373;02759
32;02;05;07;760;La Vallée-Mulâtre;142;3;145;02760
32;02;02;06;761;Variscourt;211;4;215;02761
32;02;04;20;762;Vassens;139;5;144;02762
32;02;04;05;763;Vasseny;219;4;223;02763
32;02;02;06;764;Vassogne;88;3;91;02764
32;02;02;09;765;Vaucelles-et-Beffecourt;246;10;256;02765
32;02;04;05;766;Vaudesson;235;6;241;02766
32;02;04;16;767;Vauxrezis;322;3;325;02767
32;02;02;09;768;Vauxaillon;542;6;548;02768
32;02;05;07;769;Vaux-Andigny;898;14;912;02769
32;02;04;17;770;Vauxbuin;788;20;808;02770
32;02;03;13;772;Vaux-en-Vermandois;160;1;161;02772
32;02;04;05;773;Vauxtin;39;0;39;02773
32;02;03;13;774;Vendelles;118;1;119;02774
32;02;03;12;775;Vendeuil;936;17;953;02775
32;02;03;01;776;Vendhuile;558;12;570;02776
32;02;01;04;777;Vendières;142;7;149;02777
32;02;02;06;778;Vendresse-Beaulne;97;1;98;02778
32;02;05;07;779;Vénérolles;219;3;222;02779
32;02;04;16;780;Venizel;1378;17;1395;02780
32;02;01;02;781;Verdilly;453;16;469;02781
32;02;03;13;782;Le Verguier;220;2;222;02782
32;02;05;07;783;Grand-Verly;138;0;138;02783
32;02;05;07;784;Petit-Verly;138;0;138;02784
32;02;03;13;785;Vermand;1100;30;1130;02785
32;02;02;20;786;Verneuil-sous-Coucy;127;2;129;02786
32;02;02;11;787;Verneuil-sur-Serre;258;2;260;02787
32;02;02;18;788;Versigny;460;7;467;02788
32;02;05;19;789;Vervins;2587;96;2683;02789
32;02;02;11;790;Vesles-et-Caumont;238;3;241;02790
32;02;02;10;791;Veslud;259;6;265;02791
32;02;01;04;792;Veuilly-la-Poterie;157;7;164;02792
32;02;04;20;793;Vézaponin;119;1;120;02793
32;02;01;05;794;Vézilly;188;4;192;02794
32;02;04;20;795;Vic-sur-Aisne;1618;18;1636;02795
32;02;01;21;796;Vichel-Nanteuil;83;0;83;02796
32;02;04;05;797;Viel-Arcy;172;1;173;02797
32;02;01;04;798;Viels-Maisons;1221;19;1240;02798
32;02;04;21;799;Vierzy;407;9;416;02799
32;02;01;04;800;Viffort;313;5;318;02800
32;02;05;19;801;Vigneux-Hocquet;272;3;275;02801
32;02;05;19;802;La Ville-aux-Bois-lès-Dizy;209;0;209;02802
32;02;02;06;803;La Ville-aux-Bois-lès-Pontavert;146;5;151;02803
32;02;04;21;804;Villemontoire;186;3;189;02804
32;02;04;16;805;Villeneuve-Saint-Germain;2549;44;2593;02805
32;02;01;02;806;Villeneuve-sur-Fère;294;5;299;02806
32;02;02;03;807;Villequier-Aumont;656;24;680;02807
32;02;03;01;808;Villeret;289;5;294;02808
32;02;01;05;809;Villers-Agron-Aiguizy;69;3;72;02809
32;02;04;21;810;Villers-Cotterêts;10424;417;10841;02810
32;02;04;21;812;Villers-Hélon;207;6;213;02812
32;02;03;12;813;Villers-le-Sec;252;8;260;02813
32;02;05;07;814;Villers-lès-Guise;162;0;162;02814
32;02;03;12;815;Villers-Saint-Christophe;430;17;447;02815
32;02;01;05;816;Villers-sur-Fère;531;6;537;02816
32;02;04;05;817;Ville-Savoye;82;1;83;02817
32;02;01;04;818;Villiers-Saint-Denis;1166;11;1177;02818
32;02;05;19;819;Vincy-Reuil-et-Magny;116;1;117;02819
32;02;02;03;820;Viry-Noureuil;1688;43;1731;02820
32;02;02;09;821;Vivaise;680;21;701;02821
32;02;04;21;822;Vivières;391;12;403;02822
32;02;05;11;823;Voharies;74;0;74;02823
32;02;02;10;824;Vorges;375;8;383;02824
32;02;05;11;826;Voulpaix;356;7;363;02826
32;02;02;11;827;Voyenne;312;5;317;02827
32;02;04;16;828;Vregny;94;0;94;02828
32;02;04;05;829;Vuillery;42;1;43;02829
32;02;05;07;830;Wassigny;955;16;971;02830
32;02;05;08;831;Watigny;379;6;385;02831
32;02;05;11;832;Wiège-Faty;189;5;194;02832
32;02;05;08;833;Wimy;508;7;515;02833
32;02;02;09;834;Wissignicourt;169;6;175;02834
84;03;03;18;001;Abrest;2904;60;2964;03001
84;03;02;16;002;Agonges;309;12;321;03002
84;03;01;02;003;Ainay-le-Château;987;27;1014;03003
84;03;03;08;004;Andelaroche;253;7;260;03004
84;03;01;07;005;Archignat;338;3;341;03005
84;03;03;08;006;Arfeuilles;633;17;650;03006
84;03;01;11;007;Arpheuilles-Saint-Priest;357;7;364;03007
84;03;03;08;008;Arronnes;372;14;386;03008
84;03;02;13;009;Aubigny;135;36;171;03009
84;03;01;07;010;Audes;424;13;437;03010
84;03;02;19;011;AurouÃ«r;421;9;430;03011
84;03;02;16;012;Autry-Issards;323;5;328;03012
84;03;02;13;013;Avermes;3953;96;4049;03013
84;03;03;05;014;Avrilly;136;3;139;03014
84;03;02;13;015;Bagneux;328;11;339;03015
84;03;02;06;016;Barberier;143;2;145;03016
84;03;03;08;017;Barrais-Bussolles;189;6;195;03017
84;03;02;15;018;Bayet;685;14;699;03018
84;03;02;05;019;Beaulon;1640;24;1664;03019
84;03;01;03;020;Beaune-d'Allier;294;7;301;03020
84;03;03;06;021;Bègues;224;2;226;03021
84;03;03;06;022;Bellenaves;997;17;1014;03022
84;03;03;01;023;Bellerive-sur-Allier;8741;231;8972;03023
84;03;03;14;024;Bert;237;6;243;03024
84;03;02;14;025;Bessay-sur-Allier;1328;31;1359;03025
84;03;02;16;026;Besson;761;18;779;03026
84;03;01;03;027;Bézenet;928;24;952;03027
84;03;03;08;028;Billezois;364;7;371;03028
84;03;03;15;029;Billy;783;12;795;03029
84;03;03;06;030;Biozat;856;15;871;03030
84;03;01;07;031;Bizeneuille;291;9;300;03031
84;03;01;03;032;Blomard;244;2;246;03032
84;03;03;04;033;Bost;181;4;185;03033
84;03;03;15;034;Boucé;496;12;508;03034
84;03;03;05;035;Le Bouchaud;212;4;216;03035
84;03;02;02;036;Bourbon-l'Archambault;2572;72;2644;03036
84;03;01;02;037;Braize;259;2;261;03037
84;03;02;16;038;Bransat;521;8;529;03038
84;03;02;16;039;Bresnay;384;7;391;03039
84;03;02;16;040;Bressolles;1126;38;1164;03040
84;03;01;07;041;Le Brethon;319;12;331;03041
84;03;03;08;042;Le Breuil;530;17;547;03042
84;03;03;01;043;Broût-Vernet;1189;75;1264;03043
84;03;03;01;044;Brugheas;1516;36;1552;03044
84;03;03;08;045;Busset;849;18;867;03045
84;03;02;02;046;Buxières-les-Mines;1026;23;1049;03046
84;03;01;11;047;La Celle;407;9;416;03047
84;03;01;02;048;Cérilly;1305;24;1329;03048
84;03;02;16;049;Cesset;428;10;438;03049
84;03;03;08;050;La Chabanne;179;10;189;03050
84;03;01;07;051;Chambérat;301;6;307;03051
84;03;01;03;052;Chamblet;1093;29;1122;03052
84;03;02;06;053;Chantelle;1102;25;1127;03053
84;03;02;14;054;Chapeau;237;6;243;03054
84;03;01;07;055;La Chapelaude;966;17;983;03055
84;03;03;08;056;La Chapelle;382;7;389;03056
84;03;02;05;057;La Chapelle-aux-Chasses;201;6;207;03057
84;03;01;03;058;Chappes;238;6;244;03058
84;03;02;06;059;Chareil-Cintrat;359;7;366;03059
84;03;03;17;060;Charmeil;1030;17;1047;03060
84;03;03;06;061;Charmes;394;6;400;03061
84;03;02;06;062;Charroux;351;17;368;03062
84;03;02;05;063;Chassenard;1028;20;1048;03063
84;03;02;02;064;Château-sur-Allier;180;1;181;03064
84;03;02;16;065;Châtel-de-Neuvre;544;9;553;03065
84;03;03;08;066;Châtel-Montagne;324;5;329;03066
84;03;03;14;067;Châtelperron;138;4;142;03067
84;03;03;08;068;Châtelus;104;1;105;03068
84;03;02;16;069;Châtillon;312;6;318;03069
84;03;01;03;070;Chavenon;133;1;134;03070
84;03;03;14;071;Chavroches;248;3;251;03071
84;03;01;07;072;Chazemais;492;12;504;03072
84;03;02;16;073;Chemilly;638;11;649;03073
84;03;02;05;074;Chevagnes;656;15;671;03074
84;03;03;06;075;Chezelle;168;2;170;03075
84;03;02;05;076;Chézy;227;7;234;03076
84;03;03;06;077;Chirat-l'Eglise;128;3;131;03077
84;03;03;06;078;Chouvigny;231;8;239;03078
84;03;03;14;079;Cindré;303;8;311;03079
84;03;03;01;080;Cognat-Lyonne;691;11;702;03080
84;03;01;03;081;Colombier;327;12;339;03081
84;03;01;03;082;Commentry;6132;189;6321;03082
84;03;02;16;083;Contigny;580;13;593;03083
84;03;01;07;084;Cosne-d'Allier;2034;31;2065;03084
84;03;02;13;085;Coulandon;646;55;701;03085
84;03;02;05;086;Coulanges;321;8;329;03086
84;03;02;02;087;Couleuvre;597;7;604;03087
84;03;01;07;088;Courçais;320;2;322;03088
84;03;03;06;089;Coutansouze;152;1;153;03089
84;03;02;02;090;Couzon;305;8;313;03090
84;03;03;15;091;Créchy;438;9;447;03091
84;03;02;16;092;Cressanges;628;13;641;03092
84;03;03;04;093;Creuzier-le-Neuf;1185;27;1212;03093
84;03;03;04;094;Creuzier-le-Vieux;3297;102;3399;03094
84;03;03;04;095;Cusset;12474;481;12955;03095
84;03;02;06;096;Deneuille-lès-Chantelle;86;1;87;03096
84;03;01;03;097;Deneuille-les-Mines;360;9;369;03097
84;03;01;10;098;Désertines;4459;87;4546;03098
84;03;02;16;099;Deux-Chaises;391;11;402;03099
84;03;02;05;100;Diou;1381;35;1416;03100
84;03;01;09;101;Domérat;8729;166;8895;03101
84;03;02;05;102;Dompierre-sur-Besbre;3032;59;3091;03102
84;03;03;05;103;Le Donjon;1065;25;1090;03103
84;03;01;03;104;Doyet;1169;32;1201;03104
84;03;03;08;105;Droiturier;357;7;364;03105
84;03;01;11;106;Durdat-Larequille;1316;105;1421;03106
84;03;03;06;107;Ebreuil;1270;27;1297;03107
84;03;03;06;108;Echassières;376;6;382;03108
84;03;03;01;109;Escurolles;781;32;813;03109
84;03;03;01;110;Espinasse-Vozelle;968;26;994;03110
84;03;01;07;111;Estivareilles;1112;24;1136;03111
84;03;02;06;112;Etroussat;668;9;677;03112
84;03;03;08;113;Ferrières-sur-Sichon;536;16;552;03113
84;03;02;14;114;La Ferté-Hauterive;279;7;286;03114
84;03;02;06;115;Fleuriel;341;7;348;03115
84;03;02;06;116;Fourilles;191;5;196;03116
84;03;02;02;117;Franchesse;475;12;487;03117
84;03;03;06;118;Gannat;5830;197;6027;03118
84;03;02;05;119;Gannay-sur-Loire;413;4;417;03119
84;03;02;05;120;Garnat-sur-Engièvre;710;12;722;03120
84;03;02;19;121;Gennetines;647;17;664;03121
84;03;02;16;122;Gipcy;236;6;242;03122
84;03;02;14;124;Gouise;219;3;222;03124
84;03;03;08;125;La Guillermie;124;2;126;03125
84;03;03;01;126;Hauterive;1167;13;1180;03126
84;03;01;07;127;Hérisson;620;10;630;03127
84;03;01;07;128;Huriel;2645;57;2702;03128
84;03;01;03;129;Hyds;312;13;325;03129
84;03;01;02;130;Isle-et-Bardais;279;6;285;03130
84;03;03;08;131;Isserpent;550;13;563;03131
84;03;03;14;132;Jaligny-sur-Besbre;559;15;574;03132
84;03;03;06;133;Jenzat;519;10;529;03133
84;03;02;16;134;Laféline;193;3;196;03134
84;03;03;06;135;Lalizolle;407;9;416;03135
84;03;01;12;136;Lamaids;235;5;240;03136
84;03;03;15;137;Langy;271;6;277;03137
84;03;03;08;138;Lapalisse;3144;73;3217;03138
84;03;03;08;139;Laprugne;313;11;324;03139
84;03;01;12;140;Lavault-Sainte-Anne;1154;33;1187;03140
84;03;03;08;141;Lavoine;149;2;151;03141
84;03;03;05;142;Lenax;242;5;247;03142
84;03;01;02;143;Lételon;92;3;95;03143
84;03;03;14;144;Liernolles;211;8;219;03144
84;03;01;12;145;Lignerolles;736;13;749;03145
84;03;02;02;146;Limoise;154;35;189;03146
84;03;03;05;147;Loddes;167;2;169;03147
84;03;02;15;148;Loriges;349;6;355;03148
84;03;02;15;149;Louchy-Montfand;441;16;457;03149
84;03;01;07;150;Louroux-Bourbonnais;203;7;210;03150
84;03;01;03;151;Louroux-de-Beaune;159;3;162;03151
84;03;03;06;152;Louroux-de-Bouble;231;7;238;03152
84;03;03;05;154;Luneau;276;4;280;03154
84;03;02;02;155;Lurcy-Lévis;1881;42;1923;03155
84;03;02;05;156;Lusigny;1688;54;1742;03156
84;03;03;15;157;Magnet;1020;23;1043;03157
84;03;01;07;158;Haut-Bocage;871;19;890;03158
84;03;01;03;159;Malicorne;780;15;795;03159
84;03;02;15;160;Marcenat;410;4;414;03160
84;03;01;11;161;Marcillat-en-Combraille;900;29;929;03161
84;03;02;16;162;Marigny;202;6;208;03162
84;03;03;08;163;Mariol;751;22;773;03163
84;03;03;06;164;Le Mayet-d'Ecole;273;2;275;03164
84;03;03;08;165;Le Mayet-de-Montagne;1384;86;1470;03165
84;03;03;06;166;Mazerier;306;5;311;03166
84;03;01;11;167;Mazirat;286;4;290;03167
84;03;01;02;168;Meaulne-Vitray;906;15;921;03168
84;03;02;16;169;Meillard;331;6;337;03169
84;03;02;16;170;Meillers;129;6;135;03170
84;03;02;14;171;Mercy;249;6;255;03171
84;03;01;07;172;Mesples;122;2;124;03172
84;03;02;05;173;Molinet;1142;33;1175;03173
84;03;03;08;174;Molles;914;25;939;03174
84;03;03;06;175;Monestier;278;12;290;03175
84;03;02;16;176;Monétay-sur-Allier;541;10;551;03176
84;03;02;05;177;Monétay-sur-Loire;253;3;256;03177
84;03;03;05;178;MontaiguÃ«t-en-Forez;298;6;304;03178
84;03;03;15;179;Montaigu-le-Blin;297;10;307;03179
84;03;02;14;180;Montbeugny;662;11;673;03180
84;03;03;05;181;Montcombroux-les-Mines;296;3;299;03181
84;03;03;06;182;Monteignet-sur-l'Andelot;263;1;264;03182
84;03;02;16;183;Le Montet;469;4;473;03183
84;03;02;13;184;Montilly;505;8;513;03184
84;03;01;97;185;Montluçon;34361;1070;35431;03185
84;03;01;03;186;Montmarault;1524;21;1545;03186
84;03;03;15;187;Montoldre;630;9;639;03187
84;03;02;15;188;Montord;219;1;220;03188
84;03;01;03;189;Montvicq;715;24;739;03189
84;03;02;98;190;Moulins;19246;542;19788;03190
84;03;01;03;191;Murat;280;8;288;03191
84;03;03;06;192;Nades;150;3;153;03192
84;03;01;07;193;Nassigny;187;4;191;03193
84;03;03;06;194;Naves;125;2;127;03194
84;03;01;11;195;Néris-les-Bains;2570;94;2664;03195
84;03;03;05;196;Neuilly-en-Donjon;221;3;224;03196
84;03;02;14;197;Neuilly-le-Réal;1453;32;1485;03197
84;03;02;02;198;Neure;187;0;187;03198
84;03;02;13;200;Neuvy;1520;256;1776;03200
84;03;03;08;201;Nizerolles;304;13;317;03201
84;03;02;16;202;Noyant-d'Allier;603;15;618;03202
84;03;02;05;203;Paray-le-Frésil;387;9;396;03203
84;03;02;15;204;Paray-sous-Briailles;623;18;641;03204
84;03;03;08;205;Périgny;440;11;451;03205
84;03;01;11;206;La Petite-Marche;168;6;174;03206
84;03;02;05;207;Pierrefitte-sur-Loire;512;13;525;03207
84;03;03;05;208;Le Pin;423;9;432;03208
84;03;03;06;209;PoÃ«zat;151;3;154;03209
84;03;02;02;210;Pouzy-Mésangy;399;10;409;03210
84;03;01;12;211;Prémilhat;2507;49;2556;03211
84;03;01;12;212;Quinssaines;1512;25;1537;03212
84;03;01;07;213;Reugny;252;4;256;03213
84;03;02;16;214;Rocles;382;3;385;03214
84;03;03;15;215;Rongères;550;8;558;03215
84;03;01;11;216;Ronnet;172;3;175;03216
84;03;01;03;217;Saint-Angel;761;35;796;03217
84;03;02;02;218;Saint-Aubin-le-Monial;272;8;280;03218
84;03;01;03;219;Saint-Bonnet-de-Four;215;5;220;03219
84;03;03;06;220;Saint-Bonnet-de-Rochefort;710;15;725;03220
84;03;01;02;221;Saint-Bonnet-Tronçais;730;8;738;03221
84;03;01;07;222;Saint-Caprais;90;5;95;03222
84;03;03;08;223;Saint-Christophe;441;14;455;03223
84;03;03;08;224;Saint-Clément;288;7;295;03224
84;03;01;07;225;Saint-Désiré;444;10;454;03225
84;03;03;05;226;Saint-Didier-en-Donjon;250;5;255;03226
84;03;03;01;227;Saint-Didier-la-Forêt;373;8;381;03227
84;03;01;07;228;Saint-Eloy-d'Allier;38;0;38;03228
84;03;02;19;229;Saint-Ennemond;612;18;630;03229
84;03;03;08;230;Saint-Etienne-de-Vicq;526;16;542;03230
84;03;01;11;231;Saint-Fargeol;188;5;193;03231
84;03;03;15;232;Saint-Félix;303;9;312;03232
84;03;01;11;233;Saint-Genest;395;8;403;03233
84;03;02;14;234;Saint-Gérand-de-Vaux;373;11;384;03234
84;03;03;15;235;Saint-Gérand-le-Puy;969;10;979;03235
84;03;03;17;236;Saint-Germain-des-Fossés;3654;70;3724;03236
84;03;02;06;237;Saint-Germain-de-Salles;427;9;436;03237
84;03;02;02;238;Saint-Hilaire;529;9;538;03238
84;03;03;05;239;Saint-Léger-sur-Vouzance;265;9;274;03239
84;03;03;14;240;Saint-Léon;543;11;554;03240
84;03;02;02;241;Saint-Léopardin-d'Augy;368;46;414;03241
84;03;03;15;242;Saint-Loup;568;14;582;03242
84;03;01;03;243;Saint-Marcel-en-Murat;121;6;127;03243
84;03;01;11;244;Saint-Marcel-en-Marcillat;128;2;130;03244
84;03;02;05;245;Saint-Martin-des-Lais;124;1;125;03245
84;03;01;07;246;Saint-Martinien;594;12;606;03246
84;03;02;16;247;Saint-Menoux;1106;33;1139;03247
84;03;03;08;248;Saint-Nicolas-des-Biefs;165;2;167;03248
84;03;01;07;249;Saint-Palais;162;2;164;03249
84;03;03;08;250;Saint-Pierre-Laval;349;6;355;03250
84;03;02;02;251;Saint-Plaisir;376;9;385;03251
84;03;03;01;252;Saint-Pont;677;15;692;03252
84;03;02;05;253;Saint-Pourçain-sur-Besbre;379;10;389;03253
84;03;02;15;254;Saint-Pourçain-sur-Sioule;5221;118;5339;03254
84;03;03;06;255;Saint-Priest-d'Andelot;143;4;147;03255
84;03;01;03;256;Saint-Priest-en-Murat;214;5;219;03256
84;03;03;08;257;Saint-Prix;803;23;826;03257
84;03;03;17;258;Saint-Rémy-en-Rollat;1737;26;1763;03258
84;03;01;07;259;Saint-Sauvier;338;3;341;03259
84;03;02;16;260;Saint-Sornin;224;5;229;03260
84;03;01;11;261;Sainte-Thérence;178;7;185;03261
84;03;01;09;262;Saint-Victor;2092;38;2130;03262
84;03;02;14;263;Saint-Voir;194;8;202;03263
84;03;03;18;264;Saint-Yorre;2570;53;2623;03264
84;03;02;05;265;Saligny-sur-Roudon;671;78;749;03265
84;03;03;15;266;Sanssat;272;8;280;03266
84;03;02;15;267;Saulcet;664;24;688;03267
84;03;03;06;268;Saulzet;386;3;389;03268
84;03;01;07;269;Sauvagny;85;2;87;03269
84;03;01;03;270;Sazeret;143;5;148;03270
84;03;03;01;271;Serbannes;805;32;837;03271
84;03;03;08;272;Servilly;282;7;289;03272
84;03;03;15;273;Seuillet;492;15;507;03273
84;03;03;14;274;Sorbier;318;6;324;03274
84;03;02;16;275;Souvigny;1747;49;1796;03275
84;03;03;06;276;Sussat;102;6;108;03276
84;03;03;06;277;Target;254;5;259;03277
84;03;02;06;278;Taxat-Senat;191;4;195;03278
84;03;01;12;279;Teillet-Argenty;556;10;566;03279
84;03;01;11;280;Terjat;182;9;191;03280
84;03;02;16;281;Le Theil;391;3;394;03281
84;03;01;02;282;Theneuille;372;13;385;03282
84;03;02;05;283;Thiel-sur-Acolin;1065;18;1083;03283
84;03;03;14;284;Thionne;290;9;299;03284
84;03;01;07;285;Tortezais;178;8;186;03285
84;03;02;14;286;Toulon-sur-Allier;1138;20;1158;03286
84;03;02;16;287;Treban;379;9;388;03287
84;03;01;07;288;Treignat;384;8;392;03288
84;03;03;14;289;Treteau;514;12;526;03289
84;03;02;19;290;Trévol;1630;59;1689;03290
84;03;03;14;291;Trézelles;415;13;428;03291
84;03;02;16;292;Tronget;879;12;891;03292
84;03;01;02;293;Urçay;283;10;293;03293
84;03;02;06;294;Ussel-d'Allier;168;1;169;03294
84;03;03;06;295;Valignat;76;0;76;03295
84;03;01;02;296;Valigny;376;12;388;03296
84;03;01;07;297;Vallon-en-Sully;1538;26;1564;03297
84;03;03;15;298;Varennes-sur-Allier;3618;73;3691;03298
84;03;03;14;299;Varennes-sur-Tèche;229;8;237;03299
84;03;02;05;300;Vaumas;537;9;546;03300
84;03;01;09;301;Vaux;1166;26;1192;03301
84;03;03;06;302;Veauce;39;1;40;03302
84;03;01;07;303;Venas;236;10;246;03303
84;03;03;01;304;Vendat;2249;59;2308;03304
84;03;01;03;305;Verneix;593;15;608;03305
84;03;03;08;306;Le Vernet;1918;52;1970;03306
84;03;02;16;307;Verneuil-en-Bourbonnais;236;3;239;03307
84;03;01;03;308;Vernusse;152;4;156;03308
84;03;02;02;309;Le Veurdre;454;10;464;03309
84;03;03;99;310;Vichy;24980;322;25302;03310
84;03;03;06;311;Vicq;305;7;312;03311
84;03;02;02;312;Vieure;274;10;284;03312
84;03;01;02;313;Le Vilhain;275;9;284;03313
84;03;01;11;314;Villebret;1322;36;1358;03314
84;03;01;03;315;Villefranche-d'Allier;1283;37;1320;03315
84;03;02;19;316;Villeneuve-sur-Allier;1073;16;1089;03316
84;03;01;07;317;Viplaix;294;8;302;03317
84;03;02;06;319;Voussac;484;10;494;03319
84;03;02;02;320;Ygrande;776;17;793;03320
84;03;02;19;321;Yzeure;12838;517;13355;03321
93;04;03;05;001;Aiglun;1432;28;1460;04001
93;04;04;15;004;Allemagne-en-Provence;546;30;576;04004
93;04;02;02;005;Allons;133;2;135;04005
93;04;02;02;006;Allos;824;8;832;04006
93;04;02;02;007;Angles;67;0;67;04007
93;04;02;02;008;Annot;1031;35;1066;04008
93;04;03;13;009;Archail;14;0;14;04009
93;04;04;11;012;Aubenas-les-Alpes;95;0;95;04012
93;04;04;03;013;Aubignosc;605;15;620;04013
93;04;04;14;016;Authon;63;0;63;04016
93;04;03;13;017;Auzet;99;5;104;04017
93;04;04;11;018;Banon;1028;15;1043;04018
93;04;01;01;019;Barcelonnette;2564;198;2762;04019
93;04;03;13;020;Barles;133;2;135;04020
93;04;03;05;021;Barras;147;4;151;04021
93;04;02;12;022;Barrême;417;8;425;04022
93;04;04;13;023;Bayons;189;4;193;04023
93;04;03;13;024;Beaujeu;127;3;130;04024
93;04;02;02;025;Beauvezer;386;14;400;04025
93;04;04;13;026;Bellaffaire;136;6;142;04026
93;04;04;14;027;Bevons;252;56;308;04027
93;04;03;12;028;Beynes;122;9;131;04028
93;04;02;12;030;Blieux;57;0;57;04030
93;04;03;12;031;Bras-d'Asse;557;10;567;04031
93;04;02;02;032;Braux;127;0;127;04032
93;04;01;01;033;Ubaye-Serre-Ponçon;766;19;785;04033
93;04;04;06;034;La Brillanne;1124;15;1139;04034
93;04;04;15;035;Brunet;290;6;296;04035
93;04;03;13;036;Le Brusquet;960;28;988;04036
93;04;04;13;037;Le Caire;73;2;75;04037
93;04;02;02;039;Castellane;1470;39;1509;04039
93;04;03;04;040;Le Castellard-Mélan;63;1;64;04040
93;04;04;12;041;Le Castellet;299;6;305;04041
93;04;02;02;042;Castellet-lès-Sausses;138;1;139;04042
93;04;02;02;043;Val-de-Chalvagne;86;3;89;04043
93;04;04;11;045;Céreste;1206;21;1227;04045
93;04;03;12;046;Le Chaffaut-Saint-Jurson;687;107;794;04046
93;04;03;05;047;Champtercier;848;20;868;04047
93;04;03;03;049;Château-Arnoux-Saint-Auban;5089;108;5197;04049
93;04;04;13;050;Châteaufort;27;0;27;04050
93;04;04;14;051;Châteauneuf-Miravail;72;2;74;04051
93;04;04;03;053;Châteauneuf-Val-Saint-Donat;492;20;512;04053
93;04;03;12;054;Châteauredon;74;1;75;04054
93;04;02;12;055;Chaudon-Norante;188;0;188;04055
93;04;04;13;057;Clamensane;176;3;179;04057
93;04;04;13;058;Claret;272;6;278;04058
93;04;02;12;059;Clumanc;220;1;221;04059
93;04;02;02;061;Colmars;482;5;487;04061
93;04;01;01;062;La Condamine-Châtelard;149;4;153;04062
93;04;04;09;063;Corbières-en-Provence;1219;32;1251;04063
93;04;04;06;065;Cruis;633;6;639;04065
93;04;04;13;066;Curbans;571;12;583;04066
93;04;04;14;067;Curel;52;1;53;04067
93;04;04;11;068;Dauphin;836;14;850;04068
93;04;02;02;069;Demandolx;135;3;138;04069
93;04;03;98;070;Digne-les-Bains;16482;922;17404;04070
93;04;03;13;072;Draix;110;2;112;04072
93;04;01;01;073;Enchastrayes;388;12;400;04073
93;04;03;04;074;Entrages;102;2;104;04074
93;04;04;14;075;Entrepierres;372;11;383;04075
93;04;02;02;076;Entrevaux;816;21;837;04076
93;04;04;12;077;Entrevennes;172;3;175;04077
93;04;03;03;079;L'Escale;1371;37;1408;04079
93;04;04;15;081;Esparron-de-Verdon;392;4;396;04081
93;04;03;12;084;Estoublon;493;7;500;04084
93;04;04;13;085;Faucon-du-Caire;59;2;61;04085
93;04;01;01;086;Faucon-de-Barcelonnette;303;17;320;04086
93;04;04;06;087;Fontienne;133;2;135;04087
93;04;04;06;088;Forcalquier;5121;88;5209;04088
93;04;02;02;090;Le Fugeret;207;4;211;04090
93;04;03;03;091;Ganagobie;92;0;92;04091
93;04;02;02;092;La Garde;118;4;122;04092
93;04;04;13;093;Gigors;62;1;63;04093
93;04;04;15;094;Gréoux-les-Bains;2639;48;2687;04094
93;04;04;11;095;L'Hospitalet;90;0;90;04095
93;04;01;01;096;Jausiers;1132;26;1158;04096
93;04;03;13;097;La Javie;385;5;390;04097
93;04;02;02;099;Lambruisse;88;5;93;04099
93;04;04;06;101;Lardiers;133;3;136;04101
93;04;01;01;102;Le Lauzet-Ubaye;179;3;182;04102
93;04;04;06;104;Limans;385;11;396;04104
93;04;04;06;106;Lurs;380;10;390;04106
93;04;03;12;107;Majastres;4;0;4;04107
93;04;03;05;108;Malijai;1975;30;2005;04108
93;04;03;06;109;Mallefougasse-Augès;322;4;326;04109
93;04;03;05;110;Mallemoisson;1011;28;1039;04110
93;04;04;11;111;Mane;1347;28;1375;04111
93;04;04;99;112;Manosque;22528;669;23197;04112
93;04;03;04;113;Marcoux;451;14;465;04113
93;04;02;02;115;Méailles;121;2;123;04115
93;04;03;10;116;Les Mées;3751;45;3796;04116
93;04;04;13;118;Melve;123;1;124;04118
93;04;01;01;120;Val d'Oronaye;118;1;119;04120
93;04;03;12;121;Mézel;639;11;650;04121
93;04;03;05;122;Mirabeau;511;10;521;04122
93;04;04;14;123;Mison;1121;29;1150;04123
93;04;04;15;124;Montagnac-Montpezat;417;6;423;04124
93;04;03;13;126;Montclar;406;15;421;04126
93;04;04;03;127;Montfort;322;3;325;04127
93;04;04;07;128;Montfuron;221;9;230;04128
93;04;04;11;129;Montjustin;59;1;60;04129
93;04;04;06;130;Montlaux;203;2;205;04130
93;04;04;11;132;Montsalier;144;1;145;04132
93;04;02;02;133;Moriez;237;1;238;04133
93;04;04;13;134;La Motte-du-Caire;553;20;573;04134
93;04;03;12;135;Moustiers-Sainte-Marie;720;15;735;04135
93;04;02;02;136;La Mure-Argens;313;8;321;04136
93;04;04;13;137;Nibles;42;0;42;04137
93;04;04;06;138;Niozelles;281;6;287;04138
93;04;04;14;139;Noyers-sur-Jabron;523;9;532;04139
93;04;04;14;140;Les Omergues;127;3;130;04140
93;04;04;06;141;Ongles;365;9;374;04141
93;04;04;11;142;Oppedette;54;0;54;04142
93;04;04;10;143;Oraison;5867;74;5941;04143
93;04;02;12;144;La Palud-sur-Verdon;353;1;354;04144
93;04;04;14;145;Peipin;1448;37;1485;04145
93;04;02;02;148;Peyroules;253;9;262;04148
93;04;03;03;149;Peyruis;2813;43;2856;04149
93;04;04;13;150;Piégut;202;4;206;04150
93;04;04;06;151;Pierrerue;520;13;533;04151
93;04;04;07;152;Pierrevert;3905;126;4031;04152
93;04;01;01;154;Pontis;92;1;93;04154
93;04;03;13;155;Prads-Haute-Bléone;179;1;180;04155
93;04;04;12;156;Puimichel;264;1;265;04156
93;04;04;12;157;Puimoisson;691;8;699;04157
93;04;04;15;158;Quinson;407;8;415;04158
93;04;04;11;159;Redortiers;85;5;90;04159
93;04;04;11;160;Reillanne;1680;37;1717;04160
93;04;01;01;161;Méolans-Revel;329;8;337;04161
93;04;04;11;162;Revest-des-Brousses;258;6;264;04162
93;04;04;11;163;Revest-du-Bion;525;11;536;04163
93;04;04;06;164;Revest-Saint-Martin;88;1;89;04164
93;04;04;12;166;Riez;1726;39;1765;04166
93;04;03;04;167;La Robine-sur-Galabre;288;5;293;04167
93;04;04;11;169;La Rochegiron;104;3;107;04169
93;04;02;02;170;La Rochette;75;0;75;04170
93;04;02;02;171;Rougon;121;0;121;04171
93;04;04;12;172;Roumoules;738;10;748;04172
93;04;02;02;173;Saint-André-les-Alpes;1010;21;1031;04173
93;04;02;02;174;Saint-Benoît;145;2;147;04174
93;04;04;11;175;Sainte-Croix-Ã -Lauze;91;1;92;04175
93;04;03;15;176;Sainte-Croix-du-Verdon;119;4;123;04176
93;04;03;04;177;Hautes-Duyes;45;0;45;04177
93;04;04;06;178;Saint-Etienne-les-Orgues;1319;35;1354;04178
93;04;04;14;179;Saint-Geniez;105;2;107;04179
93;04;02;12;180;Saint-Jacques;79;4;83;04180
93;04;03;12;181;Saint-Jeannet;48;1;49;04181
93;04;03;12;182;Saint-Julien-d'Asse;215;2;217;04182
93;04;02;02;183;Saint-Julien-du-Verdon;142;3;145;04183
93;04;03;12;184;Saint-Jurs;136;3;139;04184
93;04;04;15;186;Saint-Laurent-du-Verdon;99;4;103;04186
93;04;02;12;187;Saint-Lions;41;1;42;04187
93;04;04;11;188;Saint-Maime;867;8;875;04188
93;04;04;15;189;Saint-Martin-de-Brômes;627;14;641;04189
93;04;04;08;190;Saint-Martin-les-Eaux;114;3;117;04190
93;04;03;13;191;Saint-Martin-lès-Seyne;13;2;15;04191
93;04;04;11;192;Saint-Michel-l'Observatoire;1235;24;1259;04192
93;04;01;01;193;Saint-Paul-sur-Ubaye;180;7;187;04193
93;04;02;02;194;Saint-Pierre;96;2;98;04194
93;04;01;01;195;Saint-Pons;597;13;610;04195
93;04;04;09;197;Sainte-Tulle;3442;78;3520;04197
93;04;04;14;199;Saint-Vincent-sur-Jabron;177;4;181;04199
93;04;04;14;200;Salignac;640;21;661;04200
93;04;04;11;201;Saumane;122;3;125;04201
93;04;02;02;202;Sausses;132;2;134;04202
93;04;03;13;203;Selonnet;475;9;484;04203
93;04;02;12;204;Senez;163;4;167;04204
93;04;03;13;205;Seyne;1379;27;1406;04205
93;04;04;06;206;Sigonce;425;8;433;04206
93;04;04;13;207;Sigoyer;103;4;107;04207
93;04;04;11;208;Simiane-la-Rotonde;602;16;618;04208
93;04;04;14;209;Sisteron;7595;239;7834;04209
93;04;02;02;210;Soleilhas;89;4;93;04210
93;04;04;14;211;Sourribes;178;3;181;04211
93;04;02;12;214;Tartonne;130;1;131;04214
93;04;04;13;216;Thèze;234;5;239;04216
93;04;03;04;217;Thoard;748;19;767;04217
93;04;02;02;218;Thorame-Basse;231;3;234;04218
93;04;02;02;219;Thorame-Haute;244;6;250;04219
93;04;01;01;220;Les Thuiles;379;11;390;04220
93;04;04;13;222;Turriers;335;8;343;04222
93;04;02;02;224;Ubraye;100;1;101;04224
93;04;01;01;226;Uvernet-Fours;594;14;608;04226
93;04;04;11;227;Vachères;287;7;294;04227
93;04;04;13;228;Valavoire;39;0;39;04228
93;04;04;14;229;Valbelle;252;5;257;04229
93;04;04;15;230;Valensole;3173;62;3235;04230
93;04;04;13;231;Valernes;245;6;251;04231
93;04;04;13;233;Vaumeilh;268;8;276;04233
93;04;04;13;234;Venterol;226;2;228;04234
93;04;03;13;235;Verdaches;61;1;62;04235
93;04;02;02;236;Vergons;108;0;108;04236
93;04;03;13;237;Le Vernet;126;3;129;04237
93;04;02;02;240;Villars-Colmars;249;5;254;04240
93;04;04;11;241;Villemus;192;5;197;04241
93;04;04;10;242;Villeneuve;4323;78;4401;04242
93;04;03;03;244;Volonne;1641;37;1678;04244
93;04;04;08;245;Volx;3206;75;3281;04245
93;05;01;10;001;Abriès-Ristolas;383;6;389;05001
93;05;01;10;003;Aiguilles;397;11;408;05003
93;05;02;12;004;Ancelle;917;15;932;05004
93;05;01;01;006;L'Argentière-la-Bessée;2255;86;2341;05006
93;05;01;10;007;Arvieux;358;8;366;05007
93;05;02;13;008;Aspremont;369;5;374;05008
93;05;02;12;009;Aspres-lès-Corps;99;3;102;05009
93;05;02;13;010;Aspres-sur-BuÃ«ch;803;12;815;05010
93;05;02;14;011;Avançon;419;9;428;05011
93;05;02;05;012;Baratier;620;14;634;05012
93;05;02;14;013;Barcillonnette;127;5;132;05013
93;05;02;11;014;Barret-sur-Méouge;180;2;182;05014
93;05;02;13;016;La Bâtie-Montsaléon;256;2;258;05016
93;05;02;04;017;La Bâtie-Neuve;2562;57;2619;05017
93;05;02;14;018;La Bâtie-Vieille;325;10;335;05018
93;05;02;13;019;La Beaume;150;4;154;05019
93;05;02;13;021;Le Bersac;142;1;143;05021
93;05;02;04;022;Bréziers;239;3;242;05022
93;05;01;98;023;Briançon;11339;320;11659;05023
93;05;02;13;024;Valdoule;220;8;228;05024
93;05;02;12;025;Buissard;215;7;222;05025
93;05;01;10;026;Ceillac;285;3;288;05026
93;05;01;02;027;Cervières;199;4;203;05027
93;05;02;13;028;Chabestan;155;4;159;05028
93;05;02;12;029;Chabottes;887;25;912;05029
93;05;01;01;031;Champcella;188;1;189;05031
93;05;02;12;032;Champoléon;136;3;139;05032
93;05;02;13;033;Chanousse;40;0;40;05033
93;05;02;15;035;Châteauneuf-d'Oze;30;3;33;05035
93;05;02;05;036;Châteauroux-les-Alpes;1198;34;1232;05036
93;05;02;14;037;Châteauvieux;506;20;526;05037
93;05;01;10;038;Château-Ville-Vieille;319;17;336;05038
93;05;02;12;039;Aubessagne;705;12;717;05039
93;05;02;04;040;Chorges;3061;80;3141;05040
93;05;02;05;044;Crévoux;127;3;130;05044
93;05;02;05;045;Crots;1105;32;1137;05045
93;05;02;05;046;Embrun;6335;378;6713;05046
93;05;02;11;047;Eourres;125;4;129;05047
93;05;02;13;048;L'Epine;203;6;209;05048
93;05;02;14;049;Esparron;57;0;57;05049
93;05;02;04;050;Espinasses;821;9;830;05050
93;05;02;13;051;Etoile-Saint-Cyrice;29;1;30;05051
93;05;01;10;052;Eygliers;805;12;817;05052
93;05;02;13;053;Garde-Colombe;520;11;531;05053
93;05;02;12;054;La Fare-en-Champsaur;433;4;437;05054
93;05;02;13;055;La Faurie;328;4;332;05055
93;05;02;12;056;Forest-Saint-Julien;334;11;345;05056
93;05;02;14;057;Fouillouse;255;6;261;05057
93;05;01;01;058;Freissinières;217;5;222;05058
93;05;02;14;059;La Freissinouse;904;19;923;05059
93;05;02;15;060;Furmeyer;179;8;187;05060
93;05;02;99;061;Gap;40631;1545;42176;05061
93;05;02;12;062;Le Glaizil;160;1;161;05062
93;05;01;02;063;La Grave;479;10;489;05063
93;05;02;12;064;La Chapelle-en-Valgaudémar;105;3;108;05064
93;05;01;10;065;Guillestre;2312;85;2397;05065
93;05;02;13;066;La Haute-Beaume;8;0;8;05066
93;05;02;14;068;Jarjayes;460;13;473;05068
93;05;02;11;070;Laragne-Montéglin;3543;51;3594;05070
93;05;02;14;071;Lardier-et-Valença;338;19;357;05071
93;05;02;12;072;Laye;243;7;250;05072
93;05;02;11;073;Lazer;342;13;355;05073
93;05;02;14;074;Lettret;191;0;191;05074
93;05;02;15;075;Manteyer;427;7;434;05075
93;05;02;13;076;Méreuil;86;3;89;05076
93;05;01;10;077;Molines-en-Queyras;297;5;302;05077
93;05;02;11;078;Monêtier-Allemont;284;10;294;05078
93;05;01;02;079;Le Monêtier-les-Bains;1060;23;1083;05079
93;05;02;13;080;Montbrand;58;0;58;05080
93;05;02;13;081;Montclus;52;4;56;05081
93;05;01;10;082;Mont-Dauphin;173;2;175;05082
93;05;02;04;084;Montgardin;457;6;463;05084
93;05;01;03;085;Montgenèvre;454;14;468;05085
93;05;02;13;086;Montjay;104;2;106;05086
93;05;02;15;087;Montmaur;529;14;543;05087
93;05;02;13;089;Montrond;84;1;85;05089
93;05;02;12;090;La Motte-en-Champsaur;212;8;220;05090
93;05;02;13;091;Moydans;41;3;44;05091
93;05;02;14;092;Neffes;763;15;778;05092
93;05;01;03;093;Névache;359;10;369;05093
93;05;02;13;094;Nossage-et-Bénévent;15;1;16;05094
93;05;02;12;095;Le Noyer;301;2;303;05095
93;05;02;12;096;Orcières;674;18;692;05096
93;05;02;13;097;Orpierre;356;35;391;05097
93;05;02;05;098;Les Orres;543;13;556;05098
93;05;02;13;099;Oze;104;1;105;05099
93;05;02;14;100;Pelleautier;763;29;792;05100
93;05;01;01;101;Vallouise-Pelvoux;1154;40;1194;05101
93;05;02;13;102;La Piarre;93;2;95;05102
93;05;02;11;103;Le PoÃ«t;777;21;798;05103
93;05;02;12;104;Poligny;323;16;339;05104
93;05;02;04;106;Prunières;299;7;306;05106
93;05;01;02;107;Puy-Saint-André;453;23;476;05107
93;05;02;04;108;Puy-Saint-Eusèbe;167;5;172;05108
93;05;01;02;109;Puy-Saint-Pierre;524;20;544;05109
93;05;01;01;110;Puy-Saint-Vincent;301;5;306;05110
93;05;02;04;111;Puy-Sanières;273;9;282;05111
93;05;02;15;112;Rabou;87;0;87;05112
93;05;02;14;113;Rambaud;378;17;395;05113
93;05;02;04;114;Réallon;251;1;252;05114
93;05;02;04;115;Remollon;453;9;462;05115
93;05;01;10;116;Réotier;209;2;211;05116
93;05;02;13;117;Ribeyret;114;0;114;05117
93;05;02;11;118;Val BuÃ«ch-Méouge;1340;28;1368;05118
93;05;01;10;119;Risoul;655;18;673;05119
93;05;02;04;121;Rochebrune;175;4;179;05121
93;05;01;01;122;La Roche-de-Rame;808;27;835;05122
93;05;02;15;123;La Roche-des-Arnauds;1528;38;1566;05123
93;05;02;04;124;La Rochette;474;9;483;05124
93;05;02;13;126;Rosans;469;9;478;05126
93;05;02;04;127;Rousset;181;7;188;05127
93;05;02;05;128;Saint-André-d'Embrun;692;22;714;05128
93;05;02;13;129;Saint-André-de-Rosans;152;2;154;05129
93;05;02;04;130;Saint-Apollinaire;178;5;183;05130
93;05;02;13;131;Saint-Auban-d'Oze;81;4;85;05131
93;05;02;12;132;Saint-Bonnet-en-Champsaur;2063;75;2138;05132
93;05;01;02;133;Saint-Chaffrey;1531;45;1576;05133
93;05;01;10;134;Saint-Clément-sur-Durance;318;5;323;05134
93;05;02;13;135;Sainte-Colombe;51;0;51;05135
93;05;01;10;136;Saint-Crépin;737;15;752;05136
93;05;02;15;139;Dévoluy;916;27;943;05139
93;05;02;14;140;Saint-Etienne-le-Laus;286;7;293;05140
93;05;02;12;142;Saint-Firmin;443;17;460;05142
93;05;02;12;144;Saint-Jacques-en-Valgodemard;144;2;146;05144
93;05;02;12;145;Saint-Jean-Saint-Nicolas;1075;93;1168;05145
93;05;02;13;146;Saint-Julien-en-Beauchêne;136;1;137;05146
93;05;02;12;147;Saint-Julien-en-Champsaur;365;5;370;05147
93;05;02;12;148;Saint-Laurent-du-Cros;535;18;553;05148
93;05;02;12;149;Saint-Léger-les-Mélèzes;362;11;373;05149
93;05;01;01;151;Saint-Martin-de-Queyrières;1128;37;1165;05151
93;05;02;12;152;Saint-Maurice-en-Valgodemard;126;4;130;05152
93;05;02;12;153;Saint-Michel-de-Chaillol;352;13;365;05153
93;05;02;13;154;Saint-Pierre-d'Argençon;162;0;162;05154
93;05;02;11;155;Saint-Pierre-Avez;30;1;31;05155
93;05;02;05;156;Saint-Sauveur;516;11;527;05156
93;05;01;10;157;Saint-Véran;192;6;198;05157
93;05;02;13;158;Le Saix;117;1;118;05158
93;05;02;13;159;Saléon;87;3;90;05159
93;05;02;11;160;Salérans;85;0;85;05160
93;05;01;02;161;La Salle-les-Alpes;935;23;958;05161
93;05;02;14;162;La Saulce;1443;36;1479;05162
93;05;02;04;163;Le Sauze-du-Lac;144;4;148;05163
93;05;02;04;164;Savines-le-Lac;1076;42;1118;05164
93;05;02;13;165;Savournon;252;7;259;05165
93;05;02;13;166;Serres;1285;27;1312;05166
93;05;02;13;167;Sigottier;87;2;89;05167
93;05;02;14;168;Sigoyer;708;21;729;05168
93;05;02;13;169;Sorbiers;35;1;36;05169
93;05;02;14;170;Tallard;2285;52;2337;05170
93;05;02;04;171;Théus;214;4;218;05171
93;05;02;13;172;Trescléoux;310;5;315;05172
93;05;02;11;173;Upaix;457;10;467;05173
93;05;01;03;174;Val-des-Prés;615;22;637;05174
93;05;02;14;176;Valserres;267;4;271;05176
93;05;01;10;177;Vars;528;9;537;05177
93;05;02;11;178;Ventavon;584;40;624;05178
93;05;02;15;179;Veynes;3216;144;3360;05179
93;05;01;01;180;Les Vigneaux;542;14;556;05180
93;05;01;02;181;Villar-d'Arêne;294;13;307;05181
93;05;02;12;182;Villar-Loubière;42;3;45;05182
93;05;01;02;183;Villar-Saint-Pancrace;1477;53;1530;05183
93;05;02;14;184;Vitrolles;209;8;217;05184
93;06;01;26;001;Aiglun;94;0;94;06001
93;06;01;11;002;Amirat;54;0;54;06002
93;06;01;11;003;Andon;648;5;653;06003
93;06;01;94;004;Antibes;73438;1085;74523;06004
93;06;02;26;005;Ascros;175;0;175;06005
93;06;02;24;006;Aspremont;2272;32;2304;06006
93;06;01;13;007;Auribeau-sur-Siagne;3200;68;3268;06007
93;06;02;26;008;Auvare;31;2;33;06008
93;06;02;26;009;Bairols;109;1;110;06009
93;06;01;25;010;Le Bar-sur-Loup;2921;63;2984;06010
93;06;02;04;011;Beaulieu-sur-Mer;3755;28;3783;06011
93;06;02;04;012;Beausoleil;13358;130;13488;06012
93;06;02;24;013;Belvédère;690;11;701;06013
93;06;02;10;014;Bendejun;947;6;953;06014
93;06;02;10;015;Berre-les-Alpes;1240;21;1261;06015
93;06;02;26;016;Beuil;551;4;555;06016
93;06;01;26;017;Bézaudun-les-Alpes;254;4;258;06017
93;06;01;03;018;Biot;9668;351;10019;06018
93;06;02;10;019;Blausasc;1657;19;1676;06019
93;06;02;24;020;La Bollène-Vésubie;566;11;577;06020
93;06;02;26;021;Bonson;731;4;735;06021
93;06;01;26;022;Bouyon;554;6;560;06022
93;06;02;10;023;Breil-sur-Roya;2137;52;2189;06023
93;06;01;11;024;Briançonnet;217;2;219;06024
93;06;01;17;025;Le Broc;1414;7;1421;06025
93;06;01;11;026;Cabris;1380;27;1407;06026
93;06;01;95;027;Cagnes-sur-Mer;52178;491;52669;06027
93;06;01;11;028;Caille;411;4;415;06028
93;06;01;96;029;Cannes;74545;802;75347;06029
93;06;01;97;030;Le Cannet;41887;359;42246;06030
93;06;02;10;031;Cantaron;1300;11;1311;06031
93;06;02;04;032;Cap-d'Ail;4523;68;4591;06032
93;06;01;17;033;Carros;12550;136;12686;06033
93;06;02;24;034;Castagniers;1656;15;1671;06034
93;06;02;14;035;Castellar;1126;9;1135;06035
93;06;02;14;036;Castillon;400;4;404;06036
93;06;01;25;037;Caussols;298;3;301;06037
93;06;01;25;038;Châteauneuf-Grasse;3664;59;3723;06038
93;06;02;10;039;Châteauneuf-Villevieille;942;8;950;06039
93;06;02;26;040;Châteauneuf-d'Entraunes;63;0;63;06040
93;06;01;25;041;Cipières;401;6;407;06041
93;06;02;24;042;Clans;665;12;677;06042
93;06;02;10;043;Coaraze;822;4;826;06043
93;06;01;27;044;La Colle-sur-Loup;7898;157;8055;06044
93;06;01;11;045;Collongues;73;2;75;06045
93;06;02;24;046;Colomars;3482;41;3523;06046
93;06;01;26;047;Conségudes;95;1;96;06047
93;06;02;10;048;Contes;7437;81;7518;06048
93;06;01;25;049;Courmes;110;2;112;06049
93;06;01;26;050;Coursegoules;531;6;537;06050
93;06;02;26;051;La Croix-sur-Roudoule;98;2;100;06051
93;06;02;26;052;Cuébris;179;2;181;06052
93;06;02;26;053;Daluis;143;1;144;06053
93;06;02;10;054;Drap;5117;40;5157;06054
93;06;02;24;055;Duranus;150;3;153;06055
93;06;02;26;056;Entraunes;142;2;144;06056
93;06;02;10;057;L'Escarène;2554;18;2572;06057
93;06;01;11;058;Escragnolles;611;15;626;06058
93;06;02;04;059;Eze;2256;60;2316;06059
93;06;02;24;060;Falicon;1994;34;2028;06060
93;06;01;26;061;Les Ferres;96;3;99;06061
93;06;02;10;062;Fontan;317;1;318;06062
93;06;01;11;063;Gars;73;0;73;06063
93;06;01;17;064;Gattières;4173;56;4229;06064
93;06;01;06;065;La Gaude;7010;105;7115;06065
93;06;02;26;066;Gilette;1599;11;1610;06066
93;06;02;14;067;Gorbio;1493;13;1506;06067
93;06;01;25;068;Gourdon;373;10;383;06068
93;06;01;98;069;Grasse;48870;922;49792;06069
93;06;01;25;070;Gréolières;570;13;583;06070
93;06;02;26;071;Guillaumes;600;7;607;06071
93;06;02;24;072;Ilonse;162;1;163;06072
93;06;02;24;073;Isola;653;12;665;06073
93;06;02;24;074;Lantosque;1241;10;1251;06074
93;06;02;24;075;Levens;4761;46;4807;06075
93;06;02;26;076;Lieuche;47;3;50;06076
93;06;02;10;077;Lucéram;1294;12;1306;06077
93;06;02;26;078;Malaussène;321;7;328;06078
93;06;01;13;079;Mandelieu-la-Napoule;21998;283;22281;06079
93;06;02;24;080;Marie;106;4;110;06080
93;06;01;11;081;Le Mas;118;2;120;06081
93;06;02;26;082;Massoins;103;1;104;06082
93;06;02;14;083;Menton;30525;456;30981;06083
93;06;01;12;084;Mouans-Sartoux;9887;282;10169;06084
93;06;01;09;085;Mougins;19982;439;20421;06085
93;06;02;10;086;Moulinet;251;2;253;06086
93;06;01;11;087;Les Mujouls;44;0;44;06087
93;06;02;99;088;Nice;342669;2859;345528;06088
93;06;01;25;089;Opio;2295;74;2369;06089
93;06;01;13;090;Pégomas;7996;89;8085;06090
93;06;02;10;091;Peille;2370;18;2388;06091
93;06;02;10;092;Peillon;1465;13;1478;06092
93;06;02;26;093;La Penne;206;1;207;06093
93;06;02;26;094;Péone;783;9;792;06094
93;06;01;11;095;Peymeinade;8192;187;8379;06095
93;06;02;26;096;Pierlas;105;0;105;06096
93;06;02;26;097;Pierrefeu;335;0;335;06097
93;06;02;26;098;Puget-Rostang;126;1;127;06098
93;06;02;26;099;Puget-Théniers;1840;81;1921;06099
93;06;02;26;100;Revest-les-Roches;231;0;231;06100
93;06;02;26;101;Rigaud;184;2;186;06101
93;06;02;24;102;Rimplas;91;5;96;06102
93;06;02;24;103;Roquebillière;1833;49;1882;06103
93;06;02;14;104;Roquebrune-Cap-Martin;12839;202;13041;06104
93;06;01;27;105;Roquefort-les-Pins;7183;195;7378;06105
93;06;02;26;106;Roquestéron;577;8;585;06106
93;06;01;26;107;La Roque-en-Provence;68;1;69;06107
93;06;01;13;108;La Roquette-sur-Siagne;5385;94;5479;06108
93;06;02;24;109;La Roquette-sur-Var;950;4;954;06109
93;06;02;24;110;Roubion;120;3;123;06110
93;06;02;24;111;Roure;119;4;123;06111
93;06;01;25;112;Le Rouret;4072;122;4194;06112
93;06;02;14;113;Sainte-Agnès;1338;22;1360;06113
93;06;02;21;114;Saint-André-de-la-Roche;5695;29;5724;06114
93;06;02;26;115;Saint-Antonin;87;0;87;06115
93;06;01;11;116;Saint-Auban;215;3;218;06116
93;06;02;24;117;Saint-Blaise;1240;9;1249;06117
93;06;01;11;118;Saint-Cézaire-sur-Siagne;3903;100;4003;06118
93;06;02;24;119;Saint-Dalmas-le-Selvage;108;2;110;06119
93;06;02;24;120;Saint-Etienne-de-Tinée;1494;160;1654;06120
93;06;02;04;121;Saint-Jean-Cap-Ferrat;1492;8;1500;06121
93;06;01;26;122;Saint-Jeannet;4246;110;4356;06122
93;06;01;06;123;Saint-Laurent-du-Var;29169;183;29352;06123
93;06;02;26;124;Saint-Léger;49;0;49;06124
93;06;02;26;125;Saint-Martin-d'Entraunes;152;7;159;06125
93;06;02;24;126;Saint-Martin-du-Var;3095;19;3114;06126
93;06;02;24;127;Saint-Martin-Vésubie;1444;12;1456;06127
93;06;01;27;128;Saint-Paul-de-Vence;3252;70;3322;06128
93;06;02;24;129;Saint-Sauveur-sur-Tinée;306;82;388;06129
93;06;01;11;130;Saint-Vallier-de-Thiey;3654;104;3758;06130
93;06;01;26;131;Sallagriffon;48;2;50;06131
93;06;02;10;132;Saorge;458;10;468;06132
93;06;02;26;133;Sauze;71;1;72;06133
93;06;01;11;134;Séranon;540;8;548;06134
93;06;02;26;135;Sigale;197;2;199;06135
93;06;02;10;136;Sospel;3805;85;3890;06136
93;06;01;11;137;Spéracèdes;1161;24;1185;06137
93;06;01;13;138;Théoule-sur-Mer;1362;14;1376;06138
93;06;02;26;139;Thiéry;110;3;113;06139
93;06;01;11;140;Le Tignet;3066;53;3119;06140
93;06;02;26;141;Toudon;347;1;348;06141
93;06;02;10;142;TouÃ«t-de-l'Escarène;299;2;301;06142
93;06;02;26;143;TouÃ«t-sur-Var;664;11;675;06143
93;06;02;26;144;La Tour;553;4;557;06144
93;06;02;26;145;Tourette-du-Château;133;1;134;06145
93;06;02;26;146;Tournefort;155;1;156;06146
93;06;02;24;147;Tourrette-Levens;5013;46;5059;06147
93;06;01;25;148;Tourrettes-sur-Loup;4041;100;4141;06148
93;06;02;21;149;La Trinité;10115;65;10180;06149
93;06;02;04;150;La Turbie;2981;55;3036;06150
93;06;02;24;151;Utelle;867;1;868;06151
93;06;01;25;152;Valbonne;13486;554;14040;06152
93;06;02;24;153;Valdeblore;835;285;1120;06153
93;06;01;11;154;Valderoure;464;8;472;06154
93;06;01;01;155;Vallauris;27364;179;27543;06155
93;06;02;24;156;Venanson;161;1;162;06156
93;06;01;26;157;Vence;18940;302;19242;06157
93;06;02;26;158;Villars-sur-Var;776;3;779;06158
93;06;02;04;159;Villefranche-sur-Mer;5033;35;5068;06159
93;06;02;26;160;Villeneuve-d'Entraunes;89;2;91;06160
93;06;01;27;161;Villeneuve-Loubet;16285;236;16521;06161
93;06;02;10;162;La Brigue;696;10;706;06162
93;06;02;10;163;Tende;2166;49;2215;06163
84;07;03;06;001;Accons;376;12;388;07001
84;07;01;04;002;Ailhon;551;18;569;07002
84;07;01;03;003;Aizac;170;1;171;07003
84;07;02;10;004;Ajoux;81;1;82;07004
84;07;02;12;005;Alba-la-Romaine;1464;35;1499;07005
84;07;03;06;006;Albon-d'Ardèche;158;6;164;07006
84;07;03;08;007;Alboussière;989;14;1003;07007
84;07;02;10;008;Alissas;1458;52;1510;07008
84;07;03;11;009;Andance;1205;23;1228;07009
84;07;03;98;010;Annonay;16297;623;16920;07010
84;07;01;03;011;Vallées-d'Antraigues-Asperjoc;894;18;912;07011
84;07;03;06;012;Arcens;377;9;386;07012
84;07;03;08;013;Ardoix;1253;22;1275;07013
84;07;03;08;014;Arlebosc;326;7;333;07014
84;07;03;11;015;Arras-sur-Rhône;535;23;558;07015
84;07;01;16;017;Les Assions;763;16;779;07017
84;07;01;13;018;Astet;44;0;44;07018
84;07;01;99;019;Aubenas;12479;776;13255;07019
84;07;02;12;020;Aubignas;468;11;479;07020
84;07;02;09;022;Baix;1254;26;1280;07022
84;07;01;15;023;Balazuc;374;6;380;07023
84;07;01;16;024;Banne;661;22;683;07024
84;07;01;13;025;Barnas;206;2;208;07025
84;07;01;13;026;Le Béage;254;8;262;07026
84;07;02;17;027;Beauchastel;1844;30;1874;07027
84;07;01;16;028;Beaulieu;516;10;526;07028
84;07;01;16;029;Beaumont;251;3;254;07029
84;07;02;06;030;Beauvène;207;5;212;07030
84;07;01;16;031;Berrias-et-Casteljau;761;18;779;07031
84;07;01;12;032;Berzème;164;1;165;07032
84;07;01;15;033;Bessas;220;4;224;07033
84;07;02;05;034;Bidon;251;3;254;07034
84;07;03;17;035;Boffres;614;19;633;07035
84;07;03;11;036;Bogy;444;11;455;07036
84;07;01;06;037;Borée;146;3;149;07037
84;07;01;13;038;Borne;49;0;49;07038
84;07;03;08;039;Bozas;252;7;259;07039
84;07;03;14;040;Boucieu-le-Roi;259;5;264;07040
84;07;03;01;041;Boulieu-lès-Annonay;2376;65;2441;07041
84;07;02;05;042;Bourg-Saint-Andéol;7187;165;7352;07042
84;07;03;11;044;Brossainc;260;8;268;07044
84;07;01;13;045;Burzet;522;7;529;07045
84;07;01;13;047;Cellier-du-Luc;84;0;84;07047
84;07;02;06;048;Chalencon;336;7;343;07048
84;07;03;06;049;Le Chambon;54;3;57;07049
84;07;01;16;050;Chambonas;941;16;957;07050
84;07;03;11;051;Champagne;581;20;601;07051
84;07;03;08;052;Champis;616;10;626;07052
84;07;01;16;053;Chandolas;523;3;526;07053
84;07;03;06;054;Chanéac;254;9;263;07054
84;07;03;17;055;Charmes-sur-Rhône;2979;74;3053;07055
84;07;03;11;056;Charnas;913;18;931;07056
84;07;01;15;058;Chassiers;1039;35;1074;07058
84;07;03;07;059;Châteaubourg;240;7;247;07059
84;07;02;17;060;Châteauneuf-de-Vernoux;263;5;268;07060
84;07;01;15;061;Chauzon;415;12;427;07061
84;07;01;15;062;Chazeaux;150;3;153;07062
84;07;03;14;063;Cheminas;397;9;406;07063
84;07;03;06;064;Le Cheylard;2877;156;3033;07064
84;07;01;13;065;Chirols;236;3;239;07065
84;07;02;10;066;Chomérac;3015;173;3188;07066
84;07;03;11;067;Colombier-le-Cardinal;318;4;322;07067
84;07;03;14;068;Colombier-le-Jeune;572;6;578;07068
84;07;03;08;069;Colombier-le-Vieux;657;22;679;07069
84;07;03;07;070;Cornas;2311;49;2360;07070
84;07;01;13;071;Coucouron;790;13;803;07071
84;07;02;10;072;Coux;1662;42;1704;07072
84;07;03;08;073;Le Crestet;520;11;531;07073
84;07;02;10;074;Creysseilles;151;4;155;07074
84;07;01;13;075;Cros-de-Géorand;149;4;153;07075
84;07;02;09;076;Cruas;3063;66;3129;07076
84;07;01;12;077;Darbres;254;2;256;07077
84;07;03;01;078;Davézieux;3168;87;3255;07078
84;07;03;08;079;Désaignes;1162;21;1183;07079
84;07;03;06;080;Devesset;297;7;304;07080
84;07;01;16;081;Dompnac;58;1;59;07081
84;07;03;06;082;Dornas;205;12;217;07082
84;07;02;06;083;Dunière-sur-Eyrieux;434;10;444;07083
84;07;03;11;084;Eclassan;1028;37;1065;07084
84;07;03;08;085;Empurany;619;14;633;07085
84;07;03;14;086;Etables;931;19;950;07086
84;07;01;13;087;Fabras;433;8;441;07087
84;07;01;16;088;Faugères;97;2;99;07088
84;07;03;11;089;Félines;1713;48;1761;07089
84;07;02;10;090;Flaviac;1224;17;1241;07090
84;07;01;04;091;Fons;333;12;345;07091
84;07;02;10;092;Freyssenet;46;1;47;07092
84;07;01;03;093;Genestelle;275;8;283;07093
84;07;02;17;094;Gilhac-et-Bruzac;178;3;181;07094
84;07;03;08;095;Gilhoc-sur-Ormèze;460;3;463;07095
84;07;02;06;096;Gluiras;371;3;374;07096
84;07;03;14;097;Glun;693;18;711;07097
84;07;02;10;098;Gourdon;81;4;85;07098
84;07;02;05;099;Gras;633;18;651;07099
84;07;01;16;100;Gravières;499;19;518;07100
84;07;01;15;101;Grospierres;911;21;932;07101
84;07;03;07;102;Guilherand-Granges;10756;221;10977;07102
84;07;03;06;103;Saint-Julien-d'Intres;310;3;313;07103
84;07;03;06;104;Issamoulenc;87;2;89;07104
84;07;01;13;105;Issanlas;99;3;102;07105
84;07;01;13;106;Issarlès;132;1;133;07106
84;07;01;13;107;Jaujac;1273;23;1296;07107
84;07;03;06;108;Jaunac;119;8;127;07108
84;07;01;15;109;Joannas;297;6;303;07109
84;07;01;16;110;Joyeuse;1752;28;1780;07110
84;07;01;03;111;Juvinas;169;5;174;07111
84;07;01;03;112;Labastide-sur-Bésorgues;248;7;255;07112
84;07;01;15;113;Labastide-de-Virac;308;7;315;07113
84;07;03;08;114;Labatie-d'Andaure;201;2;203;07114
84;07;01;15;115;Labeaume;671;11;682;07115
84;07;01;03;116;Labégude;1358;22;1380;07116
84;07;01;16;117;Lablachère;2206;35;2241;07117
84;07;01;16;118;Laboule;145;6;151;07118
84;07;01;13;119;Le Lac-d'Issarlès;255;5;260;07119
84;07;01;03;120;Lachamp-RaphaÃ«l;61;0;61;07120
84;07;01;13;121;Lachapelle-Graillouse;192;0;192;07121
84;07;01;04;122;Lachapelle-sous-Aubenas;1657;46;1703;07122
84;07;03;06;123;Lachapelle-sous-Chanéac;165;3;168;07123
84;07;03;08;124;Lafarre;38;1;39;07124
84;07;01;15;126;Lagorce;1171;24;1195;07126
84;07;01;13;127;Lalevade-d'Ardèche;1118;13;1131;07127
84;07;03;08;128;Lalouvesc;379;5;384;07128
84;07;03;08;129;Lamastre;2349;44;2393;07129
84;07;01;13;130;Lanarce;205;5;210;07130
84;07;01;04;131;Lanas;452;42;494;07131
84;07;01;15;132;Largentière;1587;50;1637;07132
84;07;02;05;133;Larnas;243;3;246;07133
84;07;01;15;134;Laurac-en-Vivarais;1019;27;1046;07134
84;07;01;13;136;Laveyrune;104;1;105;07136
84;07;01;13;137;Lavillatte;44;0;44;07137
84;07;01;12;138;Lavilledieu;2226;46;2272;07138
84;07;01;03;139;Laviolle;105;0;105;07139
84;07;03;14;140;Lemps;797;24;821;07140
84;07;01;04;141;Lentillères;232;7;239;07141
84;07;01;13;142;Lespéron;318;8;326;07142
84;07;03;11;143;Limony;773;18;791;07143
84;07;01;16;144;Loubaresse;47;2;49;07144
84;07;01;12;145;Lussas;1160;21;1181;07145
84;07;02;10;146;Lyas;601;16;617;07146
84;07;01;16;147;Malarce-sur-la-Thines;242;5;247;07147
84;07;01;16;148;Malbosc;146;8;154;07148
84;07;02;06;149;Marcols-les-Eaux;284;5;289;07149
84;07;03;06;150;Mariac;556;20;576;07150
84;07;03;06;151;Mars;257;11;268;07151
84;07;03;14;152;Mauves;1183;26;1209;07152
84;07;01;13;153;Mayres;264;7;271;07153
84;07;01;13;154;Mazan-l'Abbaye;121;1;122;07154
84;07;01;04;155;Mercuer;1210;46;1256;07155
84;07;01;13;156;Meyras;931;29;960;07156
84;07;02;09;157;Meysse;1345;13;1358;07157
84;07;01;03;158;Mézilhac;99;0;99;07158
84;07;01;12;159;Mirabel;715;10;725;07159
84;07;03;02;160;Monestier;64;1;65;07160
84;07;01;13;161;Montpezat-sous-Bauzon;739;23;762;07161
84;07;01;15;162;Montréal;581;19;600;07162
84;07;01;16;163;Montselgues;81;7;88;07163
84;07;03;06;165;Belsentes;552;22;574;07165
84;07;03;08;166;Nozières;250;2;252;07166
84;07;02;06;167;Les Ollières-sur-Eyrieux;1006;19;1025;07167
84;07;01;15;168;Orgnac-l'Aven;597;17;614;07168
84;07;03;11;169;Ozon;381;1;382;07169
84;07;03;08;170;Pailharès;243;6;249;07170
84;07;01;16;171;Payzac;537;8;545;07171
84;07;03;11;172;Peaugres;2276;51;2327;07172
84;07;01;13;173;Péreyres;50;0;50;07173
84;07;03;11;174;Peyraud;482;6;488;07174
84;07;01;13;175;Le Plagnal;83;1;84;07175
84;07;01;16;176;Planzolles;153;2;155;07176
84;07;03;14;177;Plats;847;19;866;07177
84;07;01;13;178;Pont-de-Labeaume;588;12;600;07178
84;07;02;10;179;Pourchères;134;2;136;07179
84;07;02;09;181;Le Pouzin;2879;39;2918;07181
84;07;01;13;182;Prades;1186;31;1217;07182
84;07;01;15;183;Pradons;473;12;485;07183
84;07;02;10;184;Pranles;511;13;524;07184
84;07;03;08;185;Préaux;703;9;712;07185
84;07;02;10;186;Privas;8465;282;8747;07186
84;07;01;15;187;Prunet;135;4;139;07187
84;07;03;08;188;Quintenas;1686;38;1724;07188
84;07;01;16;189;Ribes;315;7;322;07189
84;07;01;15;190;Rochecolombe;216;7;223;07190
84;07;02;09;191;Rochemaure;2292;52;2344;07191
84;07;03;06;192;Rochepaule;242;8;250;07192
84;07;01;15;193;Rocher;276;4;280;07193
84;07;02;10;194;Rochessauve;457;9;466;07194
84;07;01;06;195;La Rochette;62;2;64;07195
84;07;01;16;196;Rocles;258;4;262;07196
84;07;03;02;197;Roiffieux;2746;84;2830;07197
84;07;02;09;198;Rompon;1126;30;1156;07198
84;07;01;16;199;Rosières;1249;25;1274;07199
84;07;01;13;200;Le Roux;59;1;60;07200
84;07;01;15;201;Ruoms;2276;29;2305;07201
84;07;01;16;202;Sablières;177;4;181;07202
84;07;01;13;203;Sagnes-et-Goudoulet;116;3;119;07203
84;07;03;06;204;Saint-Agrève;2377;63;2440;07204
84;07;03;08;205;Saint-Alban-d'Ay;1419;23;1442;07205
84;07;01;13;206;Saint-Alban-en-Montagne;77;3;80;07206
84;07;01;15;207;Saint-Alban-Auriolles;1084;17;1101;07207
84;07;01;12;208;Saint-Andéol-de-Berg;123;3;126;07208
84;07;03;06;209;Saint-Andéol-de-Fourchades;54;2;56;07209
84;07;01;03;210;Saint-Andéol-de-Vals;519;11;530;07210
84;07;01;16;211;Saint-André-de-Cruzières;461;14;475;07211
84;07;03;06;212;Saint-André-en-Vivarais;210;3;213;07212
84;07;01;16;213;Saint-André-Lachamp;149;1;150;07213
84;07;02;17;214;Saint-Apollinaire-de-Rias;206;2;208;07214
84;07;03;06;215;Saint-Barthélemy-le-Meil;199;6;205;07215
84;07;03;08;216;Saint-Barthélemy-Grozon;497;21;518;07216
84;07;03;14;217;Saint-Barthélemy-le-Plain;833;21;854;07217
84;07;03;08;218;Saint-Basile;346;10;356;07218
84;07;02;09;219;Saint-Bauzile;320;6;326;07219
84;07;03;06;220;Saint-Christol;107;0;107;07220
84;07;02;17;221;Saint-Cierge-la-Serre;248;9;257;07221
84;07;03;06;222;Saint-Cierge-sous-le-Cheylard;209;5;214;07222
84;07;01;13;223;Saint-Cirgues-de-Prades;139;2;141;07223
84;07;01;13;224;Saint-Cirgues-en-Montagne;217;13;230;07224
84;07;03;01;225;Saint-Clair;1187;45;1232;07225
84;07;03;06;226;Saint-Clément;88;0;88;07226
84;07;03;01;227;Saint-Cyr;1392;47;1439;07227
84;07;03;11;228;Saint-Désirat;844;23;867;07228
84;07;01;04;229;Saint-Didier-sous-Aubenas;926;25;951;07229
84;07;01;04;230;Saint-Etienne-de-Boulogne;413;14;427;07230
84;07;01;04;231;Saint-Etienne-de-Fontbellon;2833;83;2916;07231
84;07;01;13;232;Saint-Etienne-de-Lugdarès;413;9;422;07232
84;07;02;06;233;Saint-Etienne-de-Serre;211;4;215;07233
84;07;03;11;234;Saint-Etienne-de-Valoux;297;3;300;07234
84;07;01;13;235;Sainte-Eulalie;216;3;219;07235
84;07;03;08;236;Saint-Félicien;1147;19;1166;07236
84;07;02;17;237;Saint-Fortunat-sur-Eyrieux;777;13;790;07237
84;07;01;16;238;Saint-Genest-de-Beauzon;332;7;339;07238
84;07;03;06;239;Saint-Genest-Lachamp;110;2;112;07239
84;07;03;17;240;Saint-Georges-les-Bains;2405;45;2450;07240
84;07;01;12;241;Saint-Germain;711;17;728;07241
84;07;01;12;242;Saint-Gineys-en-Coiron;112;4;116;07242
84;07;03;11;243;Saint-Jacques-d'Atticieux;290;5;295;07243
84;07;02;17;244;Saint-Jean-Chambre;256;5;261;07244
84;07;03;14;245;Saint-Jean-de-Muzols;2508;69;2577;07245
84;07;01;12;247;Saint-Jean-le-Centenier;845;9;854;07247
84;07;03;06;248;Saint-Jean-Roure;247;11;258;07248
84;07;03;06;249;Saint-Jeure-d'Andaure;95;2;97;07249
84;07;03;08;250;Saint-Jeure-d'Ay;486;10;496;07250
84;07;01;03;251;Saint-Joseph-des-Bancs;173;3;176;07251
84;07;02;06;253;Saint-Julien-du-Gua;175;3;178;07253
84;07;01;03;254;Saint-Julien-du-Serre;872;19;891;07254
84;07;02;09;255;Saint-Julien-en-Saint-Alban;1461;38;1499;07255
84;07;02;17;257;Saint-Julien-le-Roux;114;3;117;07257
84;07;03;02;258;Saint-Julien-Vocance;223;2;225;07258
84;07;02;05;259;Saint-Just-d'Ardèche;1688;37;1725;07259
84;07;02;09;260;Saint-Lager-Bressac;950;17;967;07260
84;07;02;17;261;Saint-Laurent-du-Pape;1589;35;1624;07261
84;07;01;13;262;Saint-Laurent-les-Bains-Laval-d'Aurelle;172;2;174;07262
84;07;01;12;263;Saint-Laurent-sous-Coiron;111;3;114;07263
84;07;02;05;264;Saint-Marcel-d'Ardèche;2380;69;2449;07264
84;07;03;01;265;Saint-Marcel-lès-Annonay;1384;35;1419;07265
84;07;01;16;266;Sainte-Marguerite-Lafigère;113;2;115;07266
84;07;01;06;267;Saint-Martial;267;4;271;07267
84;07;02;05;268;Saint-Martin-d'Ardèche;949;12;961;07268
84;07;03;06;269;Saint-Martin-de-Valamas;1096;38;1134;07269
84;07;02;09;270;Saint-Martin-sur-Lavezon;432;12;444;07270
84;07;01;15;272;Saint-Maurice-d'Ardèche;313;13;326;07272
84;07;01;12;273;Saint-Maurice-d'Ibie;217;3;220;07273
84;07;02;06;274;Saint-Maurice-en-Chalencon;208;5;213;07274
84;07;01;16;275;Saint-Mélany;103;3;106;07275
84;07;03;06;276;Saint-Michel-d'Aurance;266;20;286;07276
84;07;01;04;277;Saint-Michel-de-Boulogne;149;5;154;07277
84;07;02;06;278;Saint-Michel-de-Chabrillanoux;389;9;398;07278
84;07;02;05;279;Saint-Montan;1897;43;1940;07279
84;07;01;16;280;Saint-Paul-le-Jeune;958;21;979;07280
84;07;03;07;281;Saint-Péray;7580;219;7799;07281
84;07;01;13;282;Saint-Pierre-de-Colombier;430;25;455;07282
84;07;02;09;283;Saint-Pierre-la-Roche;63;1;64;07283
84;07;01;16;284;Saint-Pierre-Saint-Jean;169;4;173;07284
84;07;03;08;285;Saint-Pierre-sur-Doux;109;1;110;07285
84;07;03;06;286;Saint-Pierreville;526;2;528;07286
84;07;01;12;287;Saint-Pons;296;15;311;07287
84;07;02;10;288;Saint-Priest;1280;44;1324;07288
84;07;01;04;289;Saint-Privat;1688;58;1746;07289
84;07;03;08;290;Saint-Prix;269;7;276;07290
84;07;01;15;291;Saint-Remèze;858;23;881;07291
84;07;03;08;292;Saint-Romain-d'Ay;1248;36;1284;07292
84;07;03;07;293;Saint-Romain-de-Lerps;900;18;918;07293
84;07;01;16;294;Saint-Sauveur-de-Cruzières;533;15;548;07294
84;07;02;06;295;Saint-Sauveur-de-Montagut;1106;24;1130;07295
84;07;01;04;296;Saint-Sernin;1748;48;1796;07296
84;07;03;08;297;Saint-Sylvestre;508;7;515;07297
84;07;02;09;298;Saint-Symphorien-sous-Chomérac;777;31;808;07298
84;07;03;08;299;Saint-Symphorien-de-Mahun;120;4;124;07299
84;07;02;12;300;Saint-Thomé;461;16;477;07300
84;07;03;08;301;Saint-Victor;950;15;965;07301
84;07;02;09;302;Saint-Vincent-de-Barrès;837;22;859;07302
84;07;02;06;303;Saint-Vincent-de-Durfort;254;4;258;07303
84;07;01;15;304;Salavas;704;12;716;07304
84;07;01;16;305;Les Salelles;372;8;380;07305
84;07;01;15;306;Sampzon;232;7;239;07306
84;07;01;15;307;Sanilhac;447;9;456;07307
84;07;03;11;308;Sarras;2228;35;2263;07308
84;07;03;08;309;Satillieu;1503;30;1533;07309
84;07;03;01;310;Savas;903;24;927;07310
84;07;01;12;311;Sceautres;146;7;153;07311
84;07;03;14;312;Sécheras;534;16;550;07312
84;07;03;11;313;Serrières;1137;17;1154;07313
84;07;02;17;314;Silhac;380;12;392;07314
84;07;01;13;315;La Souche;372;13;385;07315
84;07;03;17;316;Soyons;2284;49;2333;07316
84;07;03;02;317;Talencieux;1085;31;1116;07317
84;07;01;15;318;Tauriers;200;5;205;07318
84;07;02;12;319;Le Teil;8832;211;9043;07319
84;07;03;02;321;Thorrenc;239;6;245;07321
84;07;01;13;322;Thueyts;1216;25;1241;07322
84;07;03;17;323;Toulaud;1708;53;1761;07323
84;07;03;14;324;Tournon-sur-Rhône;10622;515;11137;07324
84;07;01;03;325;Ucel;2062;72;2134;07325
84;07;01;13;326;Usclades-et-Rieutord;117;0;117;07326
84;07;01;15;327;Uzer;412;12;424;07327
84;07;01;15;328;Vagnas;583;18;601;07328
84;07;01;16;329;Valgorge;417;8;425;07329
84;07;01;15;330;Vallon-Pont-d'Arc;2412;39;2451;07330
84;07;01;03;331;Vals-les-Bains;3530;65;3595;07331
84;07;02;12;332;Valvignères;447;13;460;07332
84;07;03;02;333;Vanosc;935;13;948;07333
84;07;01;16;334;Les Vans;2655;58;2713;07334
84;07;03;08;335;Vaudevant;207;2;209;07335
84;07;01;16;336;Vernon;225;7;232;07336
84;07;03;02;337;Vernosc-lès-Annonay;2614;85;2699;07337
84;07;02;17;338;Vernoux-en-Vivarais;1962;31;1993;07338
84;07;01;04;339;Vesseaux;1990;62;2052;07339
84;07;02;10;340;Veyras;1514;48;1562;07340
84;07;01;12;341;Villeneuve-de-Berg;3001;115;3116;07341
84;07;03;02;342;Villevocance;1184;28;1212;07342
84;07;01;04;343;Vinezac;1401;40;1441;07343
84;07;03;11;344;Vinzieux;466;3;469;07344
84;07;03;14;345;Vion;944;19;963;07345
84;07;02;05;346;Viviers;3689;66;3755;07346
84;07;03;02;347;Vocance;628;2;630;07347
84;07;01;15;348;VogÃ¼é;1097;25;1122;07348
84;07;02;17;349;La Voulte-sur-Rhône;4848;58;4906;07349
44;08;02;11;001;Acy-Romance;467;3;470;08001
44;08;01;18;003;Aiglemont;1637;35;1672;08003
44;08;02;08;004;Aire;236;1;237;08004
44;08;02;08;005;Alincourt;158;2;160;08005
44;08;04;01;006;Alland'Huy-et-Sausseuil;242;4;246;08006
44;08;02;11;008;Amagne;711;6;717;08008
44;08;02;11;010;Ambly-Fleury;133;5;138;08010
44;08;01;12;011;Anchamps;210;4;214;08011
44;08;03;19;013;Angecourt;390;3;393;08013
44;08;02;08;014;Annelles;140;6;146;08014
44;08;01;17;015;Antheny;101;5;106;08015
44;08;01;17;016;Aouste;205;2;207;08016
44;08;04;01;017;Apremont;117;3;120;08017
44;08;04;01;018;Ardeuil-et-Montfauxelles;73;2;75;08018
44;08;04;19;019;Les Grandes-Armoises;61;0;61;08019
44;08;04;19;020;Les Petites-Armoises;61;0;61;08020
44;08;02;11;021;Arnicourt;155;3;158;08021
44;08;01;05;022;Arreux;320;12;332;08022
44;08;03;19;023;Artaise-le-Vivier;65;1;66;08023
44;08;02;08;024;Asfeld;1088;19;1107;08024
44;08;04;01;025;Attigny;1119;28;1147;08025
44;08;01;17;026;Aubigny-les-Pothées;310;8;318;08026
44;08;02;17;027;Auboncourt-Vauzelles;97;3;100;08027
44;08;01;09;028;Aubrives;982;20;1002;08028
44;08;03;03;029;Auflance;87;3;90;08029
44;08;01;13;030;Auge;58;0;58;08030
44;08;04;01;031;Aure;43;4;47;08031
44;08;02;08;032;Aussonce;218;3;221;08032
44;08;04;19;033;Authe;90;4;94;08033
44;08;03;03;034;Autrecourt-et-Pourron;340;6;346;08034
44;08;04;19;035;Autruche;59;2;61;08035
44;08;04;01;036;Autry;114;8;122;08036
44;08;01;13;037;Auvillers-les-Forges;879;10;889;08037
44;08;02;08;038;Avançon;328;9;337;08038
44;08;02;08;039;Avaux;465;13;478;08039
44;08;01;10;040;Les Ayvelles;886;12;898;08040
44;08;01;10;041;Baâlons;206;8;214;08041
44;08;03;16;043;Balan;1622;30;1652;08043
44;08;02;08;044;Balham;163;1;164;08044
44;08;04;19;045;Ballay;268;11;279;08045
44;08;02;08;046;Banogne-Recouvrance;159;3;162;08046
44;08;01;17;047;Barbaise;106;0;106;08047
44;08;02;11;048;Barby;416;4;420;08048
44;08;04;19;049;Bar-lès-Buzancy;128;3;131;08049
44;08;04;19;052;Bayonville;82;5;87;08052
44;08;03;16;053;Bazeilles;2423;219;2642;08053
44;08;03;03;055;Beaumont-en-Argonne;428;7;435;08055
44;08;04;01;056;Beffu-et-le-Morthomme;45;0;45;08056
44;08;04;19;057;Belleville-et-Châtillon-sur-Bar;260;24;284;08057
44;08;01;04;058;Belval;222;6;228;08058
44;08;04;19;059;Belval-Bois-des-Dames;30;1;31;08059
44;08;02;08;060;Bergnicourt;293;1;294;08060
44;08;04;19;061;La Berlière;38;1;39;08061
44;08;02;11;062;Bertoncourt;126;6;132;08062
44;08;03;19;063;La Besace;136;1;137;08063
44;08;02;11;064;Biermes;307;5;312;08064
44;08;03;03;065;Bièvres;46;1;47;08065
44;08;02;08;066;Bignicourt;68;1;69;08066
44;08;03;03;067;Blagny;1121;17;1138;08067
44;08;01;17;069;Blanchefosse-et-Bay;145;2;147;08069
44;08;02;08;070;Blanzy-la-Salonnaise;369;6;375;08070
44;08;01;13;071;Blombay;138;2;140;08071
44;08;01;17;073;Bossus-lès-Rumigny;96;2;98;08073
44;08;04;01;074;Bouconville;56;3;59;08074
44;08;04;19;075;Boult-aux-Bois;137;3;140;08075
44;08;01;10;076;Boulzicourt;966;19;985;08076
44;08;04;01;077;Bourcq;51;1;52;08077
44;08;01;13;078;Bourg-Fidèle;853;15;868;08078
44;08;01;10;080;Bouvellemont;129;0;129;08080
44;08;01;02;081;Bogny-sur-Meuse;5018;74;5092;08081
44;08;04;01;082;Brécy-Brières;81;2;83;08082
44;08;03;03;083;Brévilly;353;7;360;08083
44;08;02;08;084;Brienne-sur-Aisne;271;2;273;08084
44;08;04;19;085;Brieulles-sur-Bar;226;7;233;08085
44;08;04;19;086;Briquenay;92;7;99;08086
44;08;01;13;087;Brognon;146;2;148;08087
44;08;03;19;088;Bulson;134;4;138;08088
44;08;04;19;089;Buzancy;370;9;379;08089
44;08;03;03;090;Carignan;2879;44;2923;08090
44;08;04;01;092;Cauroy;190;8;198;08092
44;08;01;17;094;Cernion;57;3;60;08094
44;08;01;10;095;Chagny;182;6;188;08095
44;08;01;10;096;Chalandry-Elaire;709;15;724;08096
44;08;04;01;097;Challerange;444;7;451;08097
44;08;04;01;098;Champigneulle;54;2;56;08098
44;08;01;10;099;Champigneul-sur-Vence;123;4;127;08099
44;08;01;17;100;Champlin;72;1;73;08100
44;08;03;15;101;La Chapelle;167;5;172;08101
44;08;02;17;102;Chappes;92;5;97;08102
44;08;04;01;103;Charbogne;222;3;225;08103
44;08;04;01;104;Chardeny;60;1;61;08104
44;08;01;98;105;Charleville-Mézières;46436;1090;47526;08105
44;08;01;09;106;Charnois;73;0;73;08106
44;08;02;08;107;Château-Porcien;1331;18;1349;08107
44;08;04;01;109;Chatel-Chéhéry;140;3;143;08109
44;08;01;13;110;Le Châtelet-sur-Sormonne;165;1;166;08110
44;08;02;08;111;Le Châtelet-sur-Retourne;782;2;784;08111
44;08;02;17;113;Chaumont-Porcien;497;11;508;08113
44;08;03;19;115;Chémery-Chéhéry;545;4;549;08115
44;08;04;19;116;Bairon et ses environs;1021;17;1038;08116
44;08;02;17;117;Chesnois-Auboncourt;159;0;159;08117
44;08;03;14;119;Cheveuges;455;7;462;08119
44;08;04;01;120;Chevières;45;2;47;08120
44;08;01;13;121;Chilly;138;5;143;08121
44;08;01;09;122;Chooz;754;15;769;08122
44;08;04;01;123;Chuffilly-Roche;72;1;73;08123
44;08;01;17;124;Clavy-Warby;345;9;354;08124
44;08;01;04;125;Cliron;402;9;411;08125
44;08;02;08;126;Condé-lès-Herpy;221;4;225;08126
44;08;04;01;128;Condé-lès-Autry;65;2;67;08128
44;08;04;01;130;Contreuve;83;3;86;08130
44;08;04;01;131;Cornay;64;3;67;08131
44;08;02;11;132;Corny-Machéroménil;189;2;191;08132
44;08;02;11;133;Coucy;508;5;513;08133
44;08;04;01;134;Coulommes-et-Marqueny;77;1;78;08134
44;08;04;19;135;La Croix-aux-Bois;151;3;154;08135
44;08;03;16;136;Daigny;349;8;357;08136
44;08;01;05;137;Damouzy;458;13;471;08137
44;08;03;03;138;Les Deux-Villes;255;3;258;08138
44;08;01;02;139;Deville;1041;10;1051;08139
44;08;01;10;140;Dom-le-Mesnil;1083;20;1103;08140
44;08;01;17;141;Dommery;181;4;185;08141
44;08;03;14;142;Donchery;2018;27;2045;08142
44;08;02;17;143;Doumely-Bégny;73;0;73;08143
44;08;02;11;144;Doux;102;1;103;08144
44;08;03;03;145;Douzy;2199;60;2259;08145
44;08;02;17;146;Draize;95;2;97;08146
44;08;04;01;147;Dricourt;84;9;93;08147
44;08;02;08;148;L'Ecaille;279;7;286;08148
44;08;01;17;149;L'Echelle;142;5;147;08149
44;08;02;08;150;Ecly;170;5;175;08150
44;08;04;01;151;Ecordal;306;12;318;08151
44;08;03;03;153;Escombres-et-le-Chesnois;347;5;352;08153
44;08;01;17;154;Estrebay;81;3;84;08154
44;08;01;13;155;Etalle;101;5;106;08155
44;08;01;13;156;Eteignières;508;3;511;08156
44;08;01;10;158;Etrépigny;299;8;307;08158
44;08;03;03;159;Euilly-et-Lombut;110;4;114;08159
44;08;01;10;160;Evigny;188;4;192;08160
44;08;04;01;161;Exermont;38;1;39;08161
44;08;01;04;162;Fagnon;350;6;356;08162
44;08;02;17;163;Faissault;255;4;259;08163
44;08;04;01;164;Falaise;336;9;345;08164
44;08;02;17;165;FALSE;58;1;59;08165
44;08;01;12;166;Fépin;268;2;270;08166
44;08;01;17;167;La Férée;74;2;76;08167
44;08;03;03;168;La Ferté-sur-Chiers;174;4;178;08168
44;08;01;17;169;Flaignes-Havys;104;8;112;08169
44;08;03;15;170;Fleigneux;215;3;218;08170
44;08;04;01;171;Fléville;95;4;99;08171
44;08;01;13;172;Fligny;188;1;189;08172
44;08;01;10;173;Flize;1722;52;1774;08173
44;08;03;15;174;Floing;2313;56;2369;08174
44;08;01;09;175;Foisches;238;8;246;08175
44;08;04;19;176;Fossé;53;1;54;08176
44;08;02;17;178;Fraillicourt;186;5;191;08178
44;08;03;16;179;Francheval;597;13;610;08179
44;08;01;07;180;La Francheville;1671;41;1712;08180
44;08;01;17;182;Le Fréty;54;0;54;08182
44;08;01;09;183;Fromelennes;1043;24;1067;08183
44;08;03;03;184;Fromy;82;2;84;08184
44;08;01;12;185;Fumay;3280;48;3328;08185
44;08;04;19;186;Germont;49;0;49;08186
44;08;01;18;187;Gernelle;311;8;319;08187
44;08;01;18;188;Gespunsart;1016;24;1040;08188
44;08;01;17;189;Girondelle;162;2;164;08189
44;08;01;09;190;Givet;6476;148;6624;08190
44;08;03;15;191;Givonne;1052;25;1077;08191
44;08;02;17;192;Givron;86;1;87;08192
44;08;04;01;193;Givry;271;6;277;08193
44;08;03;15;194;Glaire;845;13;858;08194
44;08;02;08;195;Gomont;326;3;329;08195
44;08;02;17;196;Grandchamp;104;0;104;08196
44;08;04;01;197;Grandham;38;2;40;08197
44;08;04;01;198;Grandpré;520;16;536;08198
44;08;01;18;199;La Grandville;796;17;813;08199
44;08;04;01;200;Grivy-Loisy;184;6;190;08200
44;08;01;17;201;Gruyères;100;2;102;08201
44;08;01;13;202;Gué-d'Hossus;517;10;527;08202
44;08;01;10;203;Guignicourt-sur-Vence;280;6;286;08203
44;08;04;01;204;Guincourt;82;1;83;08204
44;08;02;17;205;Hagnicourt;73;0;73;08205
44;08;01;13;206;Ham-les-Moines;371;5;376;08206
44;08;01;09;207;Ham-sur-Meuse;231;4;235;08207
44;08;01;17;208;Hannappes;137;1;138;08208
44;08;01;10;209;Hannogne-Saint-Martin;475;5;480;08209
44;08;02;08;210;Hannogne-Saint-Rémy;112;4;116;08210
44;08;03;19;211;Haraucourt;721;4;725;08211
44;08;01;13;212;Harcy;504;10;514;08212
44;08;01;12;214;Hargnies;488;3;491;08214
44;08;04;19;215;Harricourt;43;2;45;08215
44;08;01;04;216;Haudrecy;314;13;327;08216
44;08;01;02;217;Haulmé;88;0;88;08217
44;08;01;02;218;Les Hautes-Rivières;1446;24;1470;08218
44;08;02;08;219;Hauteville;117;1;118;08219
44;08;04;01;220;Hauviné;334;8;342;08220
44;08;01;12;222;Haybes;1847;47;1894;08222
44;08;03;03;223;Herbeuval;122;2;124;08223
44;08;02;08;225;Herpy-l'Arlésienne;205;6;211;08225
44;08;01;09;226;Hierges;170;4;174;08226
44;08;01;10;228;La Horgne;168;5;173;08228
44;08;02;08;229;Houdilcourt;131;7;138;08229
44;08;01;05;230;Houldizy;390;6;396;08230
44;08;03;15;232;Illy;412;9;421;08232
44;08;04;19;233;Imécourt;46;1;47;08233
44;08;02;08;234;Inaumont;104;0;104;08234
44;08;01;18;235;Issancourt-et-Rumel;374;12;386;08235
44;08;01;17;236;Jandun;297;10;307;08236
44;08;01;02;237;Joigny-sur-Meuse;655;20;675;08237
44;08;04;01;238;Jonval;102;1;103;08238
44;08;02;08;239;Juniville;1233;30;1263;08239
44;08;02;17;240;Justine-Herbigny;171;4;175;08240
44;08;01;02;242;Laifour;428;8;436;08242
44;08;01;17;243;Lalobbe;165;3;168;08243
44;08;04;01;244;Lametz;72;3;75;08244
44;08;04;01;245;Lançon;31;2;33;08245
44;08;04;19;246;Landres-et-Saint-Georges;74;1;75;08246
44;08;01;09;247;Landrichamps;131;2;133;08247
44;08;01;17;248;Launois-sur-Vence;686;9;695;08248
44;08;01;13;249;Laval-Morency;240;10;250;08249
44;08;04;01;250;Leffincourt;188;5;193;08250
44;08;01;17;251;Lépron-les-Vallées;75;2;77;08251
44;08;03;03;252;Létanne;118;2;120;08252
44;08;01;17;254;Liart;616;10;626;08254
44;08;03;03;255;Linay;224;3;227;08255
44;08;04;01;256;Liry;86;1;87;08256
44;08;01;17;257;Logny-Bogny;155;3;158;08257
44;08;04;01;259;Longwé;72;2;74;08259
44;08;01;13;260;Lonny;627;8;635;08260
44;08;02;17;262;Lucquy;572;34;606;08262
44;08;01;18;263;Lumes;1126;26;1152;08263
44;08;04;01;264;Machault;515;11;526;08264
44;08;03;19;268;Maisoncelle-et-Villers;69;4;73;08268
44;08;03;03;269;Malandry;79;1;80;08269
44;08;04;01;271;Manre;100;6;106;08271
44;08;01;17;272;Maranwez;57;0;57;08272
44;08;01;17;273;Marby;72;1;73;08273
44;08;04;01;274;Marcq;99;1;100;08274
44;08;03;03;275;Margny;207;4;211;08275
44;08;03;03;276;Margut;740;13;753;08276
44;08;01;17;277;Marlemont;131;4;135;08277
44;08;04;01;278;Marquigny;81;0;81;08278
44;08;04;01;279;Mars-sous-Bourcq;58;2;60;08279
44;08;04;01;280;Marvaux-Vieux;75;2;77;08280
44;08;03;03;281;Matton-et-Clémency;469;9;478;08281
44;08;01;13;282;Maubert-Fontaine;1033;72;1105;08282
44;08;01;10;283;Mazerny;127;1;128;08283
44;08;01;02;284;Les Mazures;885;23;908;08284
44;08;02;08;286;Ménil-Annelles;113;5;118;08286
44;08;02;08;287;Ménil-Lépinois;133;2;135;08287
44;08;02;17;288;Mesmont;90;1;91;08288
44;08;03;03;289;Messincourt;604;8;612;08289
44;08;03;03;291;Mogues;245;5;250;08291
44;08;03;03;293;Moiry;143;5;148;08293
44;08;03;16;294;La Moncelle;135;4;139;08294
44;08;01;10;295;Mondigny;185;4;189;08295
44;08;04;01;296;Montcheutin;115;7;122;08296
44;08;01;02;297;Montcornet;299;8;307;08297
44;08;01;06;298;Montcy-Notre-Dame;1578;45;1623;08298
44;08;03;19;300;Le Mont-Dieu;15;0;15;08300
44;08;04;19;301;Montgon;69;4;73;08301
44;08;01;02;302;Monthermé;2237;84;2321;08302
44;08;04;01;303;Monthois;385;10;395;08303
44;08;01;12;304;Montigny-sur-Meuse;81;2;83;08304
44;08;01;10;305;Montigny-sur-Vence;255;5;260;08305
44;08;02;11;306;Mont-Laurent;56;3;59;08306
44;08;02;17;307;Montmeillant;82;1;83;08307
44;08;04;01;308;Mont-Saint-Martin;87;0;87;08308
44;08;04;01;309;Mont-Saint-Remy;57;1;58;08309
44;08;04;01;310;Mouron;69;5;74;08310
44;08;03;03;311;Mouzon;2226;40;2266;08311
44;08;01;13;312;Murtin-et-Bogny;186;7;193;08312
44;08;02;11;313;Nanteuil-sur-Aisne;145;4;149;08313
44;08;02;08;314;Neuflize;800;23;823;08314
44;08;01;17;315;Neufmaison;74;2;76;08315
44;08;01;18;316;Neufmanil;1006;15;1021;08316
44;08;03;19;317;La Neuville-Ã -Maire;115;4;119;08317
44;08;01;13;318;La Neuville-aux-Joûtes;357;8;365;08318
44;08;01;13;319;Neuville-lez-Beaulieu;333;8;341;08319
44;08;02;08;320;La Neuville-en-Tourne-Ã -Fuy;555;16;571;08320
44;08;04;01;321;Neuville-Day;168;4;172;08321
44;08;01;13;322;Neuville-lès-This;373;14;387;08322
44;08;02;17;323;La Neuville-lès-Wasigny;160;1;161;08323
44;08;02;17;324;Neuvizy;114;2;116;08324
44;08;04;19;325;Noirval;26;1;27;08325
44;08;04;19;326;Nouart;121;2;123;08326
44;08;01;10;327;Nouvion-sur-Meuse;2241;37;2278;08327
44;08;01;05;328;Nouzonville;5689;109;5798;08328
44;08;02;17;329;Novion-Porcien;497;11;508;08329
44;08;02;11;330;Novy-Chevrières;765;9;774;08330
44;08;03;14;331;Noyers-Pont-Maugis;669;14;683;08331
44;08;04;19;332;Oches;44;4;48;08332
44;08;04;01;333;Olizy-Primat;237;9;246;08333
44;08;01;10;334;Omicourt;38;2;40;08334
44;08;01;10;335;Omont;81;1;82;08335
44;08;03;03;336;Osnes;230;3;233;08336
44;08;04;01;338;Pauvres;188;3;191;08338
44;08;02;08;339;Perthes;307;4;311;08339
44;08;02;08;340;Poilcourt-Sydney;176;4;180;08340
44;08;01;10;341;Poix-Terron;864;40;904;08341
44;08;03;16;342;Pouru-aux-Bois;245;5;250;08342
44;08;03;16;343;Pouru-Saint-Remy;1144;23;1167;08343
44;08;01;17;344;Prez;134;2;136;08344
44;08;01;04;346;Prix-lès-Mézières;1350;36;1386;08346
44;08;03;03;347;Puilly-et-Charbeaux;220;5;225;08347
44;08;02;17;348;Puiseux;113;3;116;08348
44;08;03;03;349;Pure;576;6;582;08349
44;08;04;19;350;Quatre-Champs;237;3;240;08350
44;08;04;01;351;Quilly;84;0;84;08351
44;08;01;17;352;Raillicourt;199;4;203;08352
44;08;01;09;353;Rancennes;723;22;745;08353
44;08;03;19;354;Raucourt-et-Flaba;824;13;837;08354
44;08;01;13;355;Regniowez;387;7;394;08355
44;08;02;17;356;Remaucourt;177;1;178;08356
44;08;03;19;357;Remilly-Aillicourt;784;15;799;08357
44;08;01;13;358;Remilly-les-Pothées;251;4;255;08358
44;08;02;17;360;Renneville;199;5;204;08360
44;08;01;02;361;Renwez;1652;58;1710;08361
44;08;02;11;362;Rethel;7467;297;7764;08362
44;08;01;12;363;Revin;5836;124;5960;08363
44;08;04;01;364;Rilly-sur-Aisne;132;2;134;08364
44;08;01;13;365;Rimogne;1342;21;1363;08365
44;08;02;17;366;Rocquigny;682;11;693;08366
44;08;01;13;367;Rocroi;2283;29;2312;08367
44;08;02;08;368;Roizy;220;3;223;08368
44;08;02;17;369;La Romagne;131;3;134;08369
44;08;01;17;370;Rouvroy-sur-Audry;572;6;578;08370
44;08;02;17;372;Rubigny;67;0;67;08372
44;08;01;17;373;Rumigny;293;4;297;08373
44;08;04;01;374;La Sabotterie;121;0;121;08374
44;08;03;03;375;Sachy;178;5;183;08375
44;08;03;03;376;Sailly;251;5;256;08376
44;08;03;14;377;Saint-Aignan;156;2;158;08377
44;08;04;01;378;Saint-Clément-Ã -Arnes;108;1;109;08378
44;08;04;01;379;Saint-Etienne-Ã -Arnes;243;10;253;08379
44;08;02;08;380;Saint-Fergeux;216;4;220;08380
44;08;02;08;381;Saint-Germainmont;821;12;833;08381
44;08;02;17;382;Saint-Jean-aux-Bois;99;3;102;08382
44;08;04;01;383;Saint-Juvin;102;4;106;08383
44;08;04;01;384;Saint-Lambert-et-Mont-de-Jeux;144;3;147;08384
44;08;01;18;385;Saint-Laurent;1071;171;1242;08385
44;08;02;08;386;Saint-Loup-en-Champagne;344;7;351;08386
44;08;04;01;387;Saint-Loup-Terrier;182;6;188;08387
44;08;01;10;388;Saint-Marceau;344;11;355;08388
44;08;01;13;389;Saint-Marcel;335;7;342;08389
44;08;04;01;390;Sainte-Marie;79;4;83;08390
44;08;03;15;391;Saint-Menges;947;16;963;08391
44;08;04;01;392;Saint-Morel;197;11;208;08392
44;08;04;01;393;Saint-Pierre-Ã -Arnes;66;1;67;08393
44;08;04;19;394;Saint-Pierremont;72;3;75;08394
44;08;01;10;395;Saint-Pierre-sur-Vence;136;4;140;08395
44;08;02;08;396;Saint-Quentin-le-Petit;122;0;122;08396
44;08;02;08;397;Saint-Remy-le-Petit;50;0;50;08397
44;08;04;01;398;Sainte-Vaubourg;89;2;91;08398
44;08;03;03;399;Sapogne-sur-Marche;139;3;142;08399
44;08;01;10;400;Sapogne-et-Feuchères;515;10;525;08400
44;08;04;01;401;Saulces-Champenoises;231;3;234;08401
44;08;02;17;402;Saulces-Monclin;831;9;840;08402
44;08;02;11;403;Sault-lès-Rethel;1916;16;1932;08403
44;08;02;08;404;Sault-Saint-Remy;218;3;221;08404
44;08;04;19;405;Sauville;235;8;243;08405
44;08;04;01;406;Savigny-sur-Aisne;373;12;385;08406
44;08;04;01;407;Séchault;59;0;59;08407
44;08;01;05;408;Sécheval;561;10;571;08408
44;08;03;99;409;Sedan;16092;337;16429;08409
44;08;04;01;410;Semide;178;15;193;08410
44;08;04;01;411;Semuy;89;0;89;08411
44;08;04;01;412;Senuc;159;4;163;08412
44;08;02;08;413;Seraincourt;264;3;267;08413
44;08;02;17;415;Sery;338;12;350;08415
44;08;02;11;416;Seuil;170;6;176;08416
44;08;01;13;417;Sévigny-la-Forêt;278;8;286;08417
44;08;02;08;418;Sévigny-Waleppe;224;3;227;08418
44;08;01;17;419;Signy-l'Abbaye;1354;28;1382;08419
44;08;01;13;420;Signy-le-Petit;1194;22;1216;08420
44;08;03;03;421;Signy-Montlibert;94;0;94;08421
44;08;01;10;422;Singly;135;4;139;08422
44;08;04;19;424;Sommauthe;123;2;125;08424
44;08;04;01;425;Sommerance;43;1;44;08425
44;08;02;08;426;Son;98;0;98;08426
44;08;02;11;427;Sorbon;205;1;206;08427
44;08;02;17;428;Sorcy-Bauthémont;146;2;148;08428
44;08;01;13;429;Sormonne;536;14;550;08429
44;08;03;19;430;Stonne;39;2;41;08430
44;08;04;01;431;Sugny;100;6;106;08431
44;08;01;13;432;Sury;110;4;114;08432
44;08;04;01;433;Suzanne;61;2;63;08433
44;08;04;19;434;Sy;52;2;54;08434
44;08;02;08;435;Tagnon;879;13;892;08435
44;08;01;13;436;Taillette;407;7;414;08436
44;08;04;19;437;Tailly;174;6;180;08437
44;08;02;08;438;Taizy;104;2;106;08438
44;08;04;19;439;Tannay;150;9;159;08439
44;08;01;13;440;Tarzy;130;2;132;08440
44;08;03;03;444;Tétaigne;129;4;133;08444
44;08;03;14;445;Thelonne;419;2;421;08445
44;08;04;19;446;Thénorgues;79;0;79;08446
44;08;01;02;448;Thilay;1043;12;1055;08448
44;08;01;17;449;Thin-le-Moutier;640;15;655;08449
44;08;01;13;450;This;225;9;234;08450
44;08;02;08;451;Le Thour;378;8;386;08451
44;08;02;11;452;Thugny-Trugny;273;0;273;08452
44;08;04;19;453;Toges;103;3;106;08453
44;08;01;10;454;Touligny;86;2;88;08454
44;08;04;01;455;Tourcelles-Chaumont;92;1;93;08455
44;08;01;02;456;Tournavaux;232;4;236;08456
44;08;01;04;457;Tournes;1067;27;1094;08457
44;08;04;01;458;Tourteron;180;4;184;08458
44;08;03;03;459;Tremblois-lès-Carignan;149;3;152;08459
44;08;01;13;460;Tremblois-lès-Rocroi;153;0;153;08460
44;08;04;19;461;Vandy;206;1;207;08461
44;08;04;01;462;Vaux-Champagne;128;4;132;08462
44;08;04;19;463;Vaux-en-Dieulet;55;1;56;08463
44;08;04;01;464;Vaux-lès-Mouron;80;3;83;08464
44;08;02;17;465;Vaux-lès-Rubigny;44;3;47;08465
44;08;03;03;466;Vaux-lès-Mouzon;70;2;72;08466
44;08;02;17;467;Vaux-Montreuil;108;0;108;08467
44;08;01;17;468;Vaux-Villaine;193;0;193;08468
44;08;01;10;469;Vendresse;478;12;490;08469
44;08;04;19;470;Verpel;66;1;67;08470
44;08;04;19;471;Verrières;31;2;33;08471
44;08;02;17;472;Viel-Saint-Remy;297;2;299;08472
44;08;02;08;473;Vieux-lès-Asfeld;305;7;312;08473
44;08;02;08;476;Villers-devant-le-Thour;418;7;425;08476
44;08;03;03;477;Villers-devant-Mouzon;108;0;108;08477
44;08;01;10;478;Villers-le-Tilleul;237;3;240;08478
44;08;02;17;479;Villers-le-Tourneur;196;2;198;08479
44;08;01;18;480;Villers-Semeuse;3568;71;3639;08480
44;08;03;14;481;Villers-sur-Bar;253;5;258;08481
44;08;01;10;482;Villers-sur-le-Mont;105;3;108;08482
44;08;01;18;483;Ville-sur-Lumes;524;13;537;08483
44;08;02;08;484;Ville-sur-Retourne;82;1;83;08484
44;08;03;03;485;Villy;204;11;215;08485
44;08;01;09;486;Vireux-Molhain;1467;31;1498;08486
44;08;01;09;487;Vireux-Wallerand;1954;55;2009;08487
44;08;01;18;488;Vivier-au-Court;2918;83;3001;08488
44;08;04;01;489;Voncq;218;3;221;08489
44;08;04;19;490;Vouziers;4320;150;4470;08490
44;08;03;14;491;Vrigne aux Bois;3572;76;3648;08491
44;08;01;10;492;Vrigne-Meuse;319;8;327;08492
44;08;03;14;494;Wadelincourt;459;5;464;08494
44;08;02;17;496;Wagnon;131;1;132;08496
44;08;01;04;497;Warcq;1197;25;1222;08497
44;08;01;10;498;Warnécourt;385;16;401;08498
44;08;02;17;499;Wasigny;321;3;324;08499
44;08;02;17;500;Wignicourt;57;1;58;08500
44;08;03;03;501;Williers;41;3;44;08501
44;08;03;03;502;Yoncq;93;3;96;08502
44;08;01;10;503;Yvernaumont;127;1;128;08503
76;09;03;03;001;Aigues-Juntes;60;1;61;09001
76;09;02;06;002;Aigues-Vives;645;20;665;09002
76;09;02;09;003;L'Aiguillon;397;9;406;09003
76;09;01;01;004;Albiès;121;7;128;09004
76;09;03;03;005;Aleu;131;2;133;09005
76;09;01;12;006;Alliat;54;0;54;09006
76;09;03;03;007;Allières;72;0;72;09007
76;09;03;03;008;Alos;122;2;124;09008
76;09;03;03;009;Alzen;267;13;280;09009
76;09;03;04;011;Antras;71;1;72;09011
76;09;01;01;012;Appy;27;1;28;09012
76;09;01;13;013;Arabaux;81;2;83;09013
76;09;03;04;014;Argein;192;7;199;09014
76;09;01;12;015;Arignac;692;8;700;09015
76;09;01;12;016;Arnave;218;8;226;09016
76;09;03;04;017;Arrien-en-Bethmale;111;2;113;09017
76;09;03;04;018;Arrout;90;4;94;09018
76;09;03;02;019;Artigat;562;10;572;09019
76;09;01;01;020;Artigues;42;0;42;09020
76;09;01;07;021;Artix;121;3;124;09021
76;09;02;08;022;Arvigna;215;0;215;09022
76;09;01;01;023;Ascou;120;1;121;09023
76;09;01;01;024;Aston;207;5;212;09024
76;09;03;04;025;Aucazein;55;3;58;09025
76;09;03;04;026;Audressein;147;1;148;09026
76;09;03;04;027;Augirein;79;2;81;09027
76;09;03;03;029;Aulus-les-Bains;160;6;166;09029
76;09;01;12;030;Auzat;469;10;479;09030
76;09;01;01;031;Axiat;42;1;43;09031
76;09;01;01;032;Ax-les-Thermes;1288;66;1354;09032
76;09;03;11;033;Bagert;37;1;38;09033
76;09;03;04;034;Balacet;34;2;36;09034
76;09;03;04;035;Balaguères;196;2;198;09035
76;09;03;11;037;Barjac;42;0;42;09037
76;09;03;02;038;La Bastide-de-Besplas;383;7;390;09038
76;09;02;06;039;La Bastide-de-Bousignac;340;13;353;09039
76;09;02;10;040;La Bastide-de-Lordat;287;7;294;09040
76;09;03;11;041;La Bastide-du-Salat;203;7;210;09041
76;09;03;03;042;La Bastide-de-Sérou;980;14;994;09042
76;09;02;06;043;La Bastide-sur-l'Hers;670;13;683;09043
76;09;01;13;044;Baulou;169;3;172;09044
76;09;01;12;045;Bédeilhac-et-Aynat;199;1;200;09045
76;09;03;11;046;Bédeille;67;3;70;09046
76;09;02;09;047;Bélesta;1072;19;1091;09047
76;09;02;06;048;Belloc;80;1;81;09048
76;09;01;13;049;Bénac;179;3;182;09049
76;09;02;07;050;Benagues;527;7;534;09050
76;09;02;09;051;Bénaix;152;4;156;09051
76;09;02;06;052;Besset;162;8;170;09052
76;09;01;01;053;Bestiac;19;3;22;09053
76;09;03;11;054;Betchat;350;5;355;09054
76;09;03;04;055;Bethmale;93;0;93;09055
76;09;02;07;056;Bézac;394;10;404;09056
76;09;03;03;057;Biert;317;5;322;09057
76;09;01;12;058;Bompas;192;5;197;09058
76;09;03;04;059;Bonac-Irazein;121;4;125;09059
76;09;02;10;060;Bonnac;751;10;761;09060
76;09;03;02;061;Les Bordes-sur-Arize;505;6;511;09061
76;09;03;04;062;Bordes-Uchentein;199;5;204;09062
76;09;01;13;063;Le Bosc;109;2;111;09063
76;09;01;01;064;Bouan;39;0;39;09064
76;09;03;03;065;Boussenac;213;1;214;09065
76;09;01;13;066;Brassac;620;10;630;09066
76;09;02;10;067;Brie;214;3;217;09067
76;09;01;13;068;Burret;42;0;42;09068
76;09;03;04;069;Buzan;26;0;26;09069
76;09;01;01;070;Les Cabannes;337;8;345;09070
76;09;03;03;071;Cadarcet;223;8;231;09071
76;09;01;13;072;Calzan;34;0;34;09072
76;09;03;02;073;Camarade;194;1;195;09073
76;09;02;06;074;Camon;147;1;148;09074
76;09;03;02;075;Campagne-sur-Arize;285;8;293;09075
76;09;02;10;076;Canté;204;7;211;09076
76;09;01;12;077;Capoulet-et-Junac;183;1;184;09077
76;09;01;01;078;Carcanières;75;2;77;09078
76;09;03;02;079;Carla-Bayle;796;14;810;09079
76;09;02;09;080;Carla-de-Roquefort;176;2;178;09080
76;09;02;08;081;Le Carlaret;275;11;286;09081
76;09;03;03;082;Castelnau-Durban;453;8;461;09082
76;09;03;02;083;Castéras;22;0;22;09083
76;09;03;02;084;Castex;93;1;94;09084
76;09;03;04;085;Castillon-en-Couserans;401;5;406;09085
76;09;03;11;086;Caumont;332;5;337;09086
76;09;01;01;087;Caussou;47;0;47;09087
76;09;01;01;088;Caychax;15;0;15;09088
76;09;02;06;089;Cazals-des-Baylès;57;2;59;09089
76;09;01;13;090;Cazaux;37;6;43;09090
76;09;03;11;091;Cazavet;204;3;207;09091
76;09;01;12;092;Cazenave-Serres-et-Allens;60;3;63;09092
76;09;01;12;093;Celles;157;0;157;09093
76;09;03;11;094;Cérizols;137;9;146;09094
76;09;03;04;095;Cescau;148;1;149;09095
76;09;01;01;096;Château-Verdun;42;3;45;09096
76;09;03;03;097;Clermont;115;0;115;09097
76;09;03;11;098;Contrazy;68;2;70;09098
76;09;01;05;099;Cos;394;19;413;09099
76;09;03;03;100;Couflens;90;1;91;09100
76;09;01;13;101;Coussa;282;3;285;09101
76;09;02;06;102;Coutens;171;2;173;09102
76;09;01;13;103;Crampagna;864;17;881;09103
76;09;01;13;104;Dalou;770;19;789;09104
76;09;03;02;105;Daumazan-sur-Arize;708;11;719;09105
76;09;02;09;106;Dreuilhe;358;16;374;09106
76;09;02;06;107;Dun;619;15;634;09107
76;09;03;03;108;Durban-sur-Arize;178;4;182;09108
76;09;03;02;109;Durfort;171;3;174;09109
76;09;03;03;110;Encourtiech;90;4;94;09110
76;09;03;04;111;Engomer;304;4;308;09111
76;09;03;03;113;Ercé;562;3;565;09113
76;09;03;03;114;Erp;130;2;132;09114
76;09;02;06;115;Esclagne;133;2;135;09115
76;09;02;07;116;Escosse;386;3;389;09116
76;09;02;10;117;Esplas;107;6;113;09117
76;09;03;03;118;Esplas-de-Sérou;184;4;188;09118
76;09;03;04;119;Eycheil;546;6;552;09119
76;09;03;11;120;Fabas;349;4;353;09120
76;09;01;05;121;Ferrières-sur-Ariège;753;100;853;09121
76;09;01;05;122;Foix;9493;325;9818;09122
76;09;03;02;123;Fornex;113;1;114;09123
76;09;03;02;124;Le Fossat;1046;14;1060;09124
76;09;02;09;125;Fougax-et-Barrineuf;432;5;437;09125
76;09;02;09;126;Freychenet;85;3;88;09126
76;09;03;02;127;Gabre;125;4;129;09127
76;09;03;11;128;Gajan;308;10;318;09128
76;09;03;04;129;Galey;115;0;115;09129
76;09;01;05;130;Ganac;726;9;735;09130
76;09;01;01;131;Garanou;147;0;147;09131
76;09;02;10;132;Gaudiès;250;3;253;09132
76;09;01;12;133;Génat;22;1;23;09133
76;09;01;12;134;Gestiès;32;1;33;09134
76;09;01;12;136;Gourbit;74;3;77;09136
76;09;01;13;137;Gudas;202;4;206;09137
76;09;01;13;138;L'Herm;196;26;222;09138
76;09;01;01;139;L'Hospitalet-près-l'Andorre;102;0;102;09139
76;09;01;01;140;Ignaux;119;6;125;09140
76;09;03;04;141;Illartein;73;0;73;09141
76;09;02;09;142;Ilhat;120;0;120;09142
76;09;01;12;143;Illier-et-Laramade;33;0;33;09143
76;09;02;08;145;Les Issards;243;9;252;09145
76;09;02;10;146;Justiniac;57;0;57;09146
76;09;02;10;147;Labatut;176;1;177;09147
76;09;03;11;148;Lacave;124;5;129;09148
76;09;03;03;149;Lacourt;193;4;197;09149
76;09;02;06;150;Lagarde;201;6;207;09150
76;09;03;02;151;Lanoux;51;1;52;09151
76;09;01;12;152;Lapège;23;1;24;09152
76;09;02;06;153;Lapenne;120;4;124;09153
76;09;03;03;154;Larbont;59;2;61;09154
76;09;01;01;155;Larcat;47;0;47;09155
76;09;01;01;156;Larnat;20;0;20;09156
76;09;02;06;157;Laroque-d'Olmes;2405;53;2458;09157
76;09;03;11;158;Lasserre;251;7;258;09158
76;09;01;01;159;Lassur;97;0;97;09159
76;09;02;09;160;Lavelanet;6031;165;6196;09160
76;09;02;06;161;Léran;610;15;625;09161
76;09;01;12;162;Lercoul;16;0;16;09162
76;09;02;07;163;Lescousse;79;0;79;09163
76;09;03;03;164;Lescure;493;23;516;09164
76;09;02;09;165;Lesparrou;233;1;234;09165
76;09;02;09;166;Leychert;99;6;105;09166
76;09;03;02;167;Lézat-sur-Lèze;2348;40;2388;09167
76;09;02;09;168;Lieurac;185;9;194;09168
76;09;02;06;169;Limbrassac;125;3;128;09169
76;09;02;10;170;Lissac;255;6;261;09170
76;09;01;01;171;Lordat;70;0;70;09171
76;09;03;02;172;Loubaut;26;0;26;09172
76;09;01;13;173;Loubens;281;5;286;09173
76;09;01;13;174;Loubières;355;13;368;09174
76;09;02;08;175;Ludiès;94;4;98;09175
76;09;01;01;176;Luzenac;521;9;530;09176
76;09;02;07;177;Madière;241;6;247;09177
76;09;02;06;178;Malegoude;45;4;49;09178
76;09;01;13;179;Malléon;78;1;79;09179
76;09;02;06;180;Manses;120;1;121;09180
76;09;03;02;181;Le Mas-d'Azil;1145;9;1154;09181
76;09;03;03;182;Massat;709;10;719;09182
76;09;03;11;183;Mauvezin-de-Prat;102;4;106;09183
76;09;03;11;184;Mauvezin-de-Sainte-Croix;45;1;46;09184
76;09;02;10;185;Mazères;3873;83;3956;09185
76;09;03;02;186;Méras;104;0;104;09186
76;09;03;11;187;Mercenac;355;10;365;09187
76;09;01;12;188;Mercus-Garrabet;1203;24;1227;09188
76;09;01;01;189;Mérens-les-Vals;168;4;172;09189
76;09;03;11;190;Mérigon;114;1;115;09190
76;09;01;12;192;Miglos;114;3;117;09192
76;09;01;01;193;Mijanès;61;0;61;09193
76;09;02;06;194;Mirepoix;3102;124;3226;09194
76;09;03;02;195;Monesple;30;0;30;09195
76;09;03;03;196;Montagagne;80;1;81;09196
76;09;01;01;197;Montaillou;17;0;17;09197
76;09;03;11;198;Montardit;207;4;211;09198
76;09;02;10;199;Montaut;696;18;714;09199
76;09;02;06;200;Montbel;99;2;101;09200
76;09;03;04;201;Montégut-en-Couserans;78;1;79;09201
76;09;01;13;202;Montégut-Plantaurel;335;9;344;09202
76;09;03;03;203;Montels;156;9;165;09203
76;09;03;11;204;Montesquieu-Avantès;250;10;260;09204
76;09;03;02;205;Montfa;81;2;83;09205
76;09;02;09;206;Montferrier;534;13;547;09206
76;09;01;05;207;Montgaillard;1484;31;1515;09207
76;09;03;11;208;Montgauch;125;0;125;09208
76;09;03;11;209;Montjoie-en-Couserans;1034;21;1055;09209
76;09;01;12;210;Montoulieu;408;7;415;09210
76;09;02;09;211;Montségur;117;2;119;09211
76;09;03;03;212;Montseron;103;1;104;09212
76;09;02;06;213;Moulin-Neuf;243;3;246;09213
76;09;03;04;214;Moulis;757;12;769;09214
76;09;02;09;215;Nalzen;122;4;126;09215
76;09;03;03;216;Nescus;62;1;63;09216
76;09;01;12;217;Niaux;154;2;156;09217
76;09;01;01;218;Orgeix;88;1;89;09218
76;09;03;04;219;Orgibet;195;4;199;09219
76;09;01;01;220;Orlu;164;3;167;09220
76;09;01;01;221;Ornolac-Ussat-les-Bains;243;3;246;09221
76;09;01;12;222;Orus;26;0;26;09222
76;09;03;03;223;Oust;555;7;562;09223
76;09;03;02;224;Pailhès;474;8;482;09224
76;09;02;99;225;Pamiers;15659;478;16137;09225
76;09;01;01;226;Pech;37;0;37;09226
76;09;02;09;227;Péreille;199;3;202;09227
76;09;01;01;228;Perles-et-Castelet;224;5;229;09228
76;09;02;06;229;Le Peyrat;465;8;473;09229
76;09;01;01;230;Le Pla;60;0;60;09230
76;09;03;03;231;Le Port;164;1;165;09231
76;09;01;01;232;Prades;32;0;32;09232
76;09;02;06;233;Pradettes;47;1;48;09233
76;09;01;13;234;Pradières;119;3;122;09234
76;09;03;11;235;Prat-Bonrepaux;864;16;880;09235
76;09;01;12;236;Prayols;368;16;384;09236
76;09;01;01;237;Le Puch;30;1;31;09237
76;09;02;08;238;Les Pujols;831;17;848;09238
76;09;01;01;239;Quérigut;136;1;137;09239
76;09;01;12;240;Quié;297;3;300;09240
76;09;01;12;241;Rabat-les-Trois-Seigneurs;366;5;371;09241
76;09;02;09;242;Raissac;53;1;54;09242
76;09;02;06;243;Régat;84;3;87;09243
76;09;02;06;244;Rieucros;712;12;724;09244
76;09;01;07;245;Rieux-de-Pelleport;1284;35;1319;09245
76;09;03;03;246;Rimont;529;20;549;09246
76;09;03;03;247;Rivèrenert;163;9;172;09247
76;09;02;09;249;Roquefixade;147;4;151;09249
76;09;02;09;250;Roquefort-les-Cascades;93;2;95;09250
76;09;02;06;251;Roumengoux;166;8;174;09251
76;09;01;01;252;Rouze;88;0;88;09252
76;09;03;02;253;Sabarat;384;6;390;09253
76;09;02;08;254;Saint-Amadou;241;6;247;09254
76;09;02;07;255;Saint-Amans;43;0;43;09255
76;09;01;07;256;Saint-Bauzeil;58;0;58;09256
76;09;03;11;257;Sainte-Croix-Volvestre;620;16;636;09257
76;09;01;13;258;Saint-Félix-de-Rieutord;464;9;473;09258
76;09;02;06;259;Saint-Félix-de-Tournegat;152;4;156;09259
76;09;02;06;260;Sainte-Foi;29;0;29;09260
76;09;03;04;261;Saint-Girons;6418;401;6819;09261
76;09;02;09;262;Saint-Jean-d'Aigues-Vives;382;6;388;09262
76;09;03;04;263;Saint-Jean-du-Castillonnais;22;1;23;09263
76;09;01;13;264;Saint-Jean-de-Verges;1275;18;1293;09264
76;09;02;07;265;Saint-Jean-du-Falga;2859;63;2922;09265
76;09;02;06;266;Saint-Julien-de-Gras-Capou;66;2;68;09266
76;09;03;04;267;Saint-Lary;127;2;129;09267
76;09;03;11;268;Saint-Lizier;1365;31;1396;09268
76;09;01;13;269;Saint-Martin-de-Caralp;363;11;374;09269
76;09;02;07;270;Saint-Martin-d'Oydes;220;5;225;09270
76;09;02;07;271;Saint-Michel;81;2;83;09271
76;09;01;12;272;Saint-Paul-de-Jarrat;1330;27;1357;09272
76;09;01;05;273;Saint-Pierre-de-Rivière;665;23;688;09273
76;09;02;06;274;Saint-Quentin-la-Tour;337;6;343;09274
76;09;02;10;275;Saint-Quirc;371;8;379;09275
76;09;02;07;276;Saint-Victor-Rouzaud;220;10;230;09276
76;09;03;02;277;Saint-Ybars;690;11;701;09277
76;09;03;04;279;Salsein;47;2;49;09279
76;09;01;12;280;Saurat;641;9;650;09280
76;09;02;09;281;Sautel;121;2;123;09281
76;09;02;10;282;Saverdun;4828;158;4986;09282
76;09;01;01;283;Savignac-les-Ormeaux;389;15;404;09283
76;09;01;13;284;Ségura;187;6;193;09284
76;09;03;03;285;Seix;708;14;722;09285
76;09;01;01;287;Senconac;13;0;13;09287
76;09;03;11;289;Lorp-Sentaraille;1491;35;1526;09289
76;09;03;04;290;Sentein;155;3;158;09290
76;09;03;03;291;Sentenac-d'Oust;105;3;108;09291
76;09;03;03;292;Sentenac-de-Sérou;56;0;56;09292
76;09;01;13;293;Serres-sur-Arget;680;10;690;09293
76;09;03;02;294;Sieuras;103;1;104;09294
76;09;01;12;295;Siguer;95;0;95;09295
76;09;01;01;296;Aulos-Sinsat;152;2;154;09296
76;09;03;04;297;Sor;28;0;28;09297
76;09;01;01;298;Sorgeat;80;2;82;09298
76;09;03;03;299;Soueix-Rogalle;426;7;433;09299
76;09;01;09;300;Soula;174;7;181;09300
76;09;03;03;301;Soulan;376;2;378;09301
76;09;01;12;303;Surba;322;8;330;09303
76;09;03;03;304;Suzan;14;1;15;09304
76;09;02;06;305;Tabre;354;8;362;09305
76;09;01;12;306;Tarascon-sur-Ariège;3024;32;3056;09306
76;09;03;11;307;Taurignan-Castet;158;2;160;09307
76;09;03;11;308;Taurignan-Vieux;208;8;216;09308
76;09;02;06;309;Teilhet;152;2;154;09309
76;09;03;02;310;Thouars-sur-Arize;47;2;49;09310
76;09;01;01;311;Tignac;22;0;22;09311
76;09;02;08;312;La Tour-du-Crieu;3218;68;3286;09312
76;09;03;11;313;Tourtouse;155;7;162;09313
76;09;02;06;314;Tourtrol;274;15;289;09314
76;09;02;10;315;Trémoulet;129;0;129;09315
76;09;02;06;316;Troye-d'Ariège;101;1;102;09316
76;09;01;01;318;Unac;125;1;126;09318
76;09;02;07;319;Unzent;117;4;121;09319
76;09;01;01;320;Urs;29;1;30;09320
76;09;01;01;321;Ussat;317;4;321;09321
76;09;03;03;322;Ustou;272;10;282;09322
76;09;02;06;323;Vals;92;1;93;09323
76;09;01;13;324;Varilhes;3495;55;3550;09324
76;09;01;01;325;Vaychis;29;0;29;09325
76;09;01;01;326;Vèbre;124;1;125;09326
76;09;01;13;327;Ventenac;234;2;236;09327
76;09;01;01;328;Verdun;216;9;225;09328
76;09;01;13;329;Vernajoul;673;21;694;09329
76;09;01;01;330;Vernaux;28;0;28;09330
76;09;02;10;331;Le Vernet;718;6;724;09331
76;09;01;13;332;Verniolle;2252;68;2320;09332
76;09;01;12;334;Val-de-Sos;561;64;625;09334
76;09;03;04;335;Villeneuve;39;0;39;09335
76;09;02;09;336;Villeneuve-d'Olmes;965;19;984;09336
76;09;03;02;338;Villeneuve-du-Latou;155;4;159;09338
76;09;02;10;339;Villeneuve-du-Paréage;769;15;784;09339
76;09;01;13;340;Vira;156;4;160;09340
76;09;02;06;341;Viviès;146;0;146;09341
76;09;03;02;342;Sainte-Suzanne;239;2;241;09342
44;10;01;03;002;Ailleville;237;5;242;10002
44;10;03;01;003;Aix-Villemaur-Pâlis;3546;38;3584;10003
44;10;03;02;004;Allibaudières;207;2;209;10004
44;10;01;17;005;Amance;255;12;267;10005
44;10;03;02;006;Arcis-sur-Aube;2803;81;2884;10006
44;10;01;03;007;Arconville;104;2;106;10007
44;10;01;17;008;Argançon;113;1;114;10008
44;10;03;08;009;Arrelles;87;2;89;10009
44;10;01;05;010;Arrembécourt;47;2;49;10010
44;10;01;03;011;Arrentières;210;1;211;10011
44;10;01;03;012;Arsonval;306;5;311;10012
44;10;03;08;013;Assenay;145;2;147;10013
44;10;03;05;014;Assencières;181;1;182;10014
44;10;03;02;015;Aubeterre;376;6;382;10015
44;10;01;05;017;Aulnay;130;3;133;10017
44;10;03;01;018;Auxon;1023;10;1033;10018
44;10;03;05;019;Val-d'Auzon;379;5;384;10019
44;10;02;11;020;Avant-lès-Marcilly;505;10;515;10020
44;10;03;02;021;Avant-lès-Ramerupt;157;4;161;10021
44;10;03;08;022;Avirey-Lingey;200;12;212;10022
44;10;02;11;023;Avon-la-Pèze;187;7;194;10023
44;10;03;08;024;Avreuil;169;3;172;10024
44;10;03;08;025;Bagneux-la-Fosse;171;4;175;10025
44;10;01;05;026;Bailly-le-Franc;36;0;36;10026
44;10;01;05;027;Balignicourt;60;5;65;10027
44;10;03;08;028;Balnot-la-Grange;120;0;120;10028
44;10;03;08;029;Balnot-sur-Laignes;155;2;157;10029
44;10;03;11;030;Barberey-Saint-Sulpice;1530;30;1560;10030
44;10;02;07;031;Barbuise;471;8;479;10031
44;10;01;03;032;Baroville;302;9;311;10032
44;10;01;03;033;Bar-sur-Aube;4787;193;4980;10033
44;10;03;04;034;Bar-sur-Seine;2961;196;3157;10034
44;10;01;03;035;Bayel;751;9;760;10035
44;10;03;01;037;Bercenay-en-Othe;447;10;457;10037
44;10;02;11;038;Bercenay-le-Hayer;194;2;196;10038
44;10;01;03;039;Bergères;117;5;122;10039
44;10;03;08;040;Bernon;164;8;172;10040
44;10;03;04;041;Bertignolles;50;1;51;10041
44;10;03;01;042;Bérulle;206;4;210;10042
44;10;02;06;043;Bessy;127;3;130;10043
44;10;01;05;044;Bétignicourt;34;0;34;10044
44;10;01;17;045;Beurey;182;9;191;10045
44;10;01;05;046;Blaincourt-sur-Aube;114;2;116;10046
44;10;01;05;047;Blignicourt;41;1;42;10047
44;10;01;03;048;Bligny;161;4;165;10048
44;10;03;08;049;Les Bordes-Aumont;531;9;540;10049
44;10;01;17;050;Bossancourt;198;3;201;10050
44;10;03;08;051;Bouilly;1087;47;1134;10051
44;10;02;06;052;Boulages;216;4;220;10052
44;10;03;17;053;Bouranton;594;9;603;10053
44;10;02;11;054;Bourdenay;113;1;114;10054
44;10;03;04;055;Bourguignons;266;12;278;10055
44;10;03;05;056;Bouy-Luxembourg;240;1;241;10056
44;10;02;07;057;Bouy-sur-Orvin;53;1;54;10057
44;10;03;08;058;Bragelogne-Beauvoir;242;9;251;10058
44;10;01;05;059;Braux;112;5;117;10059
44;10;03;17;060;Bréviandes;2851;56;2907;10060
44;10;03;05;061;Brévonnes;673;12;685;10061
44;10;03;04;062;Briel-sur-Barse;201;2;203;10062
44;10;01;05;063;Brienne-la-Vieille;411;13;424;10063
44;10;01;05;064;Brienne-le-Château;2772;26;2798;10064
44;10;03;02;065;Brillecourt;85;1;86;10065
44;10;03;01;066;Bucey-en-Othe;436;10;446;10066
44;10;03;17;067;Buchères;1827;28;1855;10067
44;10;03;04;068;Buxeuil;125;6;131;10068
44;10;03;04;069;Buxières-sur-Arce;116;0;116;10069
44;10;03;04;070;Celles-sur-Ource;490;19;509;10070
44;10;03;04;071;Chacenay;51;2;53;10071
44;10;01;03;072;La Chaise;34;0;34;10072
44;10;01;05;073;Chalette-sur-Voire;127;2;129;10073
44;10;03;01;074;Chamoy;507;8;515;10074
44;10;02;06;075;Champfleury;96;6;102;10075
44;10;01;03;076;Champignol-lez-Mondeville;264;7;271;10076
44;10;03;02;077;Champigny-sur-Aube;110;2;112;10077
44;10;01;17;078;Champ-sur-Barse;27;0;27;10078
44;10;03;08;079;Channes;129;2;131;10079
44;10;03;08;080;Chaource;1038;10;1048;10080
44;10;03;14;081;La Chapelle-Saint-Luc;11741;92;11833;10081
44;10;02;06;082;Chapelle-Vallon;245;4;249;10082
44;10;03;04;083;Chappes;338;6;344;10083
44;10;03;02;084;Charmont-sous-Barbuise;1019;28;1047;10084
44;10;02;11;085;Charmoy;65;0;65;10085
44;10;02;06;086;Charny-le-Bachot;264;8;272;10086
44;10;03;08;087;Chaserey;53;1;54;10087
44;10;02;06;089;Châtres;698;13;711;10089
44;10;02;06;090;Chauchigny;232;2;234;10090
44;10;03;02;091;Chaudrey;141;4;145;10091
44;10;03;04;092;Chauffour-lès-Bailly;128;0;128;10092
44;10;01;03;093;Chaumesnil;103;2;105;10093
44;10;01;05;094;Chavanges;588;12;600;10094
44;10;03;02;095;Le Chêne;289;5;294;10095
44;10;03;01;096;Chennegy;433;8;441;10096
44;10;03;04;097;Chervey;161;4;165;10097
44;10;03;08;098;Chesley;322;9;331;10098
44;10;03;01;099;Chessy-les-Prés;519;14;533;10099
44;10;03;17;100;Clérey;1127;23;1150;10100
44;10;03;02;101;Coclois;173;3;176;10101
44;10;01;03;102;Colombé-la-Fosse;189;4;193;10102
44;10;01;03;103;Colombé-le-Sec;153;1;154;10103
44;10;03;08;104;Cormost;306;3;309;10104
44;10;01;05;105;Courcelles-sur-Voire;26;1;27;10105
44;10;02;07;106;Courceroy;136;5;141;10106
44;10;03;01;107;Coursan-en-Othe;104;0;104;10107
44;10;03;01;108;Courtaoult;82;0;82;10108
44;10;03;04;109;Courtenot;232;8;240;10109
44;10;03;17;110;Courteranges;559;11;570;10110
44;10;03;04;111;Courteron;105;5;110;10111
44;10;03;08;112;Coussegrey;177;2;179;10112
44;10;01;03;113;Couvignon;199;6;205;10113
44;10;02;09;114;Crancey;706;14;720;10114
44;10;03;06;115;Creney-près-Troyes;1982;34;2016;10115
44;10;03;08;116;Crésantignes;316;4;320;10116
44;10;01;03;117;Crespy-le-Neuf;158;7;165;10117
44;10;03;01;118;Les Croûtes;93;4;97;10118
44;10;03;04;119;Cunfin;174;4;178;10119
44;10;03;08;120;Cussangy;213;2;215;10120
44;10;03;02;121;Dampierre;322;8;330;10121
44;10;03;01;122;Davrey;225;4;229;10122
44;10;01;05;123;Dienville;873;16;889;10123
44;10;02;11;124;Dierrey-Saint-Julien;262;13;275;10124
44;10;03;11;125;Dierrey-Saint-Pierre;307;5;312;10125
44;10;01;17;126;Dolancourt;133;4;137;10126
44;10;03;02;127;Dommartin-le-Coq;58;0;58;10127
44;10;01;05;128;Donnement;73;1;74;10128
44;10;03;05;129;Dosches;299;9;308;10129
44;10;03;02;130;Dosnon;101;6;107;10130
44;10;02;06;131;Droupt-Saint-Basle;360;4;364;10131
44;10;02;06;132;Droupt-Sainte-Marie;234;5;239;10132
44;10;03;01;133;Eaux-Puiseaux;260;11;271;10133
44;10;02;11;134;Echemines;88;6;94;10134
44;10;01;03;135;Eclance;101;3;104;10135
44;10;03;04;136;Eguilly-sous-Bois;117;1;118;10136
44;10;01;03;137;Engente;33;0;33;10137
44;10;01;05;138;Epagne;142;2;144;10138
44;10;01;03;139;Epothémont;166;4;170;10139
44;10;03;01;140;Ervy-le-Châtel;1142;9;1151;10140
44;10;03;04;141;Essoyes;721;12;733;10141
44;10;03;01;142;Estissac;1851;19;1870;10142
44;10;03;08;143;Etourvy;169;5;174;10143
44;10;02;06;144;Etrelles-sur-Aube;154;3;157;10144
44;10;02;11;145;Faux-Villecerf;212;7;219;10145
44;10;02;11;146;Fay-lès-Marcilly;90;3;93;10146
44;10;03;08;147;Fays-la-Chapelle;126;4;130;10147
44;10;02;07;148;Ferreux-Quincey;410;10;420;10148
44;10;03;02;149;Feuges;333;4;337;10149
44;10;01;03;150;Fontaine;253;5;258;10150
44;10;02;06;151;Fontaine-les-Grès;877;9;886;10151
44;10;02;07;153;Fontaine-Mâcon;621;14;635;10153
44;10;02;07;154;Fontenay-de-Bossery;71;1;72;10154
44;10;03;04;155;Fontette;190;6;196;10155
44;10;03;01;156;Fontvannes;706;8;714;10156
44;10;02;11;157;La Fosse-Corduan;215;6;221;10157
44;10;03;04;158;Fouchères;535;16;551;10158
44;10;03;04;159;Fralignes;88;1;89;10159
44;10;01;03;160;Fravaux;37;1;38;10160
44;10;01;03;161;Fresnay;49;3;52;10161
44;10;03;17;162;Fresnoy-le-Château;287;6;293;10162
44;10;01;03;163;Fuligny;43;2;45;10163
44;10;02;09;164;Gélannes;735;10;745;10164
44;10;03;05;165;Géraudot;337;6;343;10165
44;10;02;06;166;Les Grandes-Chapelles;398;6;404;10166
44;10;03;02;167;Grandville;91;0;91;10167
44;10;03;08;168;Les Granges;79;1;80;10168
44;10;02;07;169;Gumery;220;8;228;10169
44;10;03;04;170;Gyé-sur-Seine;490;9;499;10170
44;10;01;05;171;Hampigny;231;9;240;10171
44;10;03;02;172;Herbisse;155;1;156;10172
44;10;03;17;173;Isle-Aumont;462;8;470;10173
44;10;03;02;174;Isle-Aubigny;169;3;172;10174
44;10;01;05;175;Jasseines;177;3;180;10175
44;10;01;03;176;Jaucourt;164;7;171;10176
44;10;03;08;177;Javernant;148;7;155;10177
44;10;01;17;178;Jessains;263;6;269;10178
44;10;03;08;179;Jeugny;472;10;482;10179
44;10;01;05;180;Joncreuil;96;4;100;10180
44;10;03;04;181;Jully-sur-Sarce;221;12;233;10181
44;10;01;03;182;Juvancourt;119;1;120;10182
44;10;01;05;183;Juvanzé;35;1;36;10183
44;10;01;03;184;Juzanvigny;128;1;129;10184
44;10;03;08;185;Lagesse;209;4;213;10185
44;10;03;08;186;Laines-aux-Bois;529;16;545;10186
44;10;03;04;187;Landreville;400;10;410;10187
44;10;03;08;188;Lantages;215;7;222;10188
44;10;01;05;189;Lassicourt;59;0;59;10189
44;10;03;17;190;Laubressel;569;6;575;10190
44;10;03;06;191;Lavau;910;10;920;10191
44;10;01;05;192;Lentilles;127;1;128;10192
44;10;01;05;193;Lesmont;303;7;310;10193
44;10;01;03;194;Lévigny;95;2;97;10194
44;10;03;02;195;Lhuître;296;4;300;10195
44;10;03;08;196;Lignières;209;1;210;10196
44;10;01;03;197;Lignol-le-Château;180;11;191;10197
44;10;03;08;198;Lirey;99;3;102;10198
44;10;03;04;199;Loches-sur-Ource;349;6;355;10199
44;10;01;17;200;La Loge-aux-Chèvres;91;3;94;10200
44;10;03;08;201;La Loge-Pomblin;69;0;69;10201
44;10;03;08;202;Les Loges-Margueron;218;80;298;10202
44;10;01;03;203;Longchamp-sur-Aujon;390;14;404;10203
44;10;03;08;204;Longeville-sur-Mogne;147;3;150;10204
44;10;01;17;205;Longpré-le-Sec;93;2;95;10205
44;10;03;02;206;Longsols;126;1;127;10206
44;10;02;06;207;Longueville-sur-Aube;128;1;129;10207
44;10;02;07;208;La Louptière-Thénard;290;12;302;10208
44;10;03;17;209;Lusigny-sur-Barse;2207;54;2261;10209
44;10;03;02;210;Luyères;455;13;468;10210
44;10;03;11;211;Macey;971;15;986;10211
44;10;03;08;212;Machy;116;4;120;10212
44;10;03;04;213;Magnant;160;3;163;10213
44;10;01;05;214;Magnicourt;87;1;88;10214
44;10;01;17;215;Magny-Fouchard;261;4;265;10215
44;10;03;02;216;Mailly-le-Camp;1933;25;1958;10216
44;10;01;17;217;Maison-des-Champs;32;0;32;10217
44;10;03;08;218;Maisons-lès-Chaource;164;1;165;10218
44;10;01;03;219;Maisons-lès-Soulaines;67;3;70;10219
44;10;02;09;220;Maizières-la-Grande-Paroisse;1498;43;1541;10220
44;10;01;05;221;Maizières-lès-Brienne;162;0;162;10221
44;10;03;01;222;Maraye-en-Othe;438;7;445;10222
44;10;02;11;223;Marcilly-le-Hayer;727;9;736;10223
44;10;02;11;224;Marigny-le-Châtel;1757;33;1790;10224
44;10;02;07;225;Marnay-sur-Seine;234;7;241;10225
44;10;03;04;226;Marolles-lès-Bailly;112;2;114;10226
44;10;03;01;227;Marolles-sous-Lignières;329;5;334;10227
44;10;01;05;228;Mathaux;198;2;200;10228
44;10;03;08;229;Maupas;105;2;107;10229
44;10;03;06;230;Mergey;680;10;690;10230
44;10;02;07;231;Le Mériot;621;10;631;10231
44;10;03;04;232;Merrey-sur-Arce;325;5;330;10232
44;10;02;06;233;Méry-sur-Seine;1511;49;1560;10233
44;10;02;06;234;Mesgrigny;277;1;278;10234
44;10;03;02;235;Mesnil-la-Comtesse;47;0;47;10235
44;10;03;02;236;Mesnil-Lettre;57;1;58;10236
44;10;02;11;237;Mesnil-Saint-Loup;591;29;620;10237
44;10;03;17;238;Mesnil-Saint-Père;458;9;467;10238
44;10;03;05;239;Mesnil-Sellières;587;24;611;10239
44;10;03;01;240;Messon;466;11;477;10240
44;10;03;08;241;Metz-Robert;64;0;64;10241
44;10;01;03;242;Meurville;160;3;163;10242
44;10;01;05;243;Molins-sur-Aube;105;5;110;10243
44;10;03;17;245;Montaulin;809;28;837;10245
44;10;03;08;246;Montceaux-lès-Vaudes;264;16;280;10246
44;10;03;01;247;Montfey;124;4;128;10247
44;10;03;11;248;Montgueux;388;11;399;10248
44;10;03;17;249;Montiéramey;403;7;410;10249
44;10;01;03;250;Montier-en-l'Isle;224;6;230;10250
44;10;03;01;251;Montigny-les-Monts;253;9;262;10251
44;10;01;17;252;Montmartin-le-Haut;60;2;62;10252
44;10;01;05;253;Montmorency-Beaufort;141;1;142;10253
44;10;02;07;254;Montpothier;328;9;337;10254
44;10;03;17;255;Montreuil-sur-Barse;291;5;296;10255
44;10;03;02;256;Montsuzain;407;4;411;10256
44;10;03;02;257;Morembert;30;0;30;10257
44;10;01;03;258;Morvilliers;283;7;290;10258
44;10;02;07;259;La Motte-Tilly;364;3;367;10259
44;10;03;17;260;Moussey;643;16;659;10260
44;10;03;04;261;Mussy-sur-Seine;1017;15;1032;10261
44;10;03;04;262;Neuville-sur-Seine;415;8;423;10262
44;10;03;01;263;Neuville-sur-Vanne;435;5;440;10263
44;10;03;04;264;Noé-les-Mallets;117;2;119;10264
44;10;03;13;265;Les NoÃ«s-près-Troyes;3280;33;3313;10265
44;10;03;01;266;Nogent-en-Othe;47;3;50;10266
44;10;03;02;267;Nogent-sur-Aube;312;4;316;10267
44;10;02;07;268;Nogent-sur-Seine;5966;118;6084;10268
44;10;03;02;269;Nozay;150;4;154;10269
44;10;03;05;270;Onjon;258;6;264;10270
44;10;02;11;271;Origny-le-Sec;595;11;606;10271
44;10;03;02;272;Ormes;180;3;183;10272
44;10;03;02;273;Ortillon;24;0;24;10273
44;10;02;11;274;Orvilliers-Saint-Julien;312;4;316;10274
44;10;02;11;275;Ossey-les-Trois-Maisons;594;7;601;10275
44;10;03;01;276;Paisy-Cosdon;334;6;340;10276
44;10;03;08;278;Pargues;137;4;141;10278
44;10;01;05;279;Pars-lès-Chavanges;53;1;54;10279
44;10;02;09;280;Pars-lès-Romilly;817;9;826;10280
44;10;03;11;281;Le Pavillon-Sainte-Julie;291;8;299;10281
44;10;03;11;282;Payns;1374;19;1393;10282
44;10;01;05;283;Pel-et-Der;130;2;132;10283
44;10;02;07;284;Périgny-la-Rose;148;3;151;10284
44;10;01;05;285;Perthes-lès-Brienne;73;0;73;10285
44;10;01;03;286;Petit-Mesnil;206;7;213;10286
44;10;03;05;287;Piney;1483;16;1499;10287
44;10;03;04;288;Plaines-Saint-Lange;263;4;267;10288
44;10;02;06;289;Plancy-l'Abbaye;968;17;985;10289
44;10;03;01;290;Planty;235;3;238;10290
44;10;02;07;291;Plessis-Barbuise;187;7;194;10291
44;10;03;02;293;Poivres;159;2;161;10293
44;10;03;04;294;Poligny;62;2;64;10294
44;10;03;04;295;Polisot;323;6;329;10295
44;10;03;04;296;Polisy;190;9;199;10296
44;10;03;15;297;Pont-Sainte-Marie;5154;92;5246;10297
44;10;02;07;298;Pont-sur-Seine;1159;20;1179;10298
44;10;03;02;299;Pouan-les-Vallées;522;17;539;10299
44;10;03;02;300;Pougy;290;2;292;10300
44;10;02;11;301;Pouy-sur-Vannes;173;4;177;10301
44;10;03;08;302;Praslin;87;2;89;10302
44;10;01;05;303;Précy-Notre-Dame;81;2;83;10303
44;10;01;05;304;Précy-Saint-Martin;185;2;187;10304
44;10;02;06;305;Prémierfait;86;3;89;10305
44;10;01;03;306;Proverville;239;6;245;10306
44;10;03;01;307;Prugny;367;10;377;10307
44;10;02;11;308;Prunay-Belleville;211;8;219;10308
44;10;03;08;309;Prusy;95;2;97;10309
44;10;01;17;310;Puits-et-Nuisement;216;5;221;10310
44;10;03;01;312;Racines;168;5;173;10312
44;10;01;05;313;Radonvilliers;371;2;373;10313
44;10;03;02;314;Ramerupt;409;4;413;10314
44;10;01;05;315;Rances;45;2;47;10315
44;10;02;06;316;Rhèges;221;4;225;10316
44;10;03;08;317;Les Riceys;1212;23;1235;10317
44;10;02;11;318;Rigny-la-Nonneuse;161;2;163;10318
44;10;03;01;319;Rigny-le-Ferron;325;7;332;10319
44;10;02;06;320;Rilly-Sainte-Syre;233;5;238;10320
44;10;03;10;321;La Rivière-de-Corps;3591;113;3704;10321
44;10;02;09;323;Romilly-sur-Seine;14480;318;14798;10323
44;10;03;08;324;Roncenay;159;2;161;10324
44;10;03;10;325;Rosières-près-Troyes;4521;347;4868;10325
44;10;01;05;326;Rosnay-l'Hôpital;171;8;179;10326
44;10;01;03;327;La Rothière;114;1;115;10327
44;10;03;05;328;Rouilly-Sacey;388;4;392;10328
44;10;03;17;329;Rouilly-Saint-Loup;513;45;558;10329
44;10;01;03;330;Rouvres-les-Vignes;110;1;111;10330
44;10;03;04;331;Rumilly-lès-Vaudes;557;10;567;10331
44;10;03;17;332;Ruvigny;497;11;508;10332
44;10;03;10;333;Saint-André-les-Vergers;12784;190;12974;10333
44;10;02;07;334;Saint-Aubin;589;8;597;10334
44;10;03;01;335;Saint-Benoist-sur-Vanne;241;6;247;10335
44;10;03;06;336;Saint-Benoît-sur-Seine;395;5;400;10336
44;10;01;05;337;Saint-Christophe-Dodinicourt;33;1;34;10337
44;10;03;02;338;Saint-Etienne-sous-Barbuise;177;3;180;10338
44;10;02;11;339;Saint-Flavy;291;6;297;10339
44;10;03;10;340;Saint-Germain;2275;48;2323;10340
44;10;02;09;341;Saint-Hilaire-sous-Romilly;357;9;366;10341
44;10;03;08;342;Saint-Jean-de-Bonneval;404;8;412;10342
44;10;03;15;343;Saint-Julien-les-Villas;6765;145;6910;10343
44;10;03;17;344;Saint-Léger-près-Troyes;902;15;917;10344
44;10;01;05;345;Saint-Léger-sous-Brienne;383;11;394;10345
44;10;01;05;346;Saint-Léger-sous-Margerie;54;1;55;10346
44;10;02;11;347;Saint-Loup-de-Buffigny;208;6;214;10347
44;10;02;11;348;Saint-Lupien;231;4;235;10348
44;10;03;11;349;Saint-Lyé;2885;62;2947;10349
44;10;03;01;350;Saint-Mards-en-Othe;638;11;649;10350
44;10;02;11;351;Saint-Martin-de-Bossenay;366;5;371;10351
44;10;03;06;352;Sainte-Maure;1715;294;2009;10352
44;10;02;06;353;Saint-Mesmin;886;10;896;10353
44;10;03;02;354;Saint-Nabord-sur-Aube;137;4;141;10354
44;10;02;07;355;Saint-Nicolas-la-Chapelle;67;0;67;10355
44;10;02;06;356;Saint-Oulph;299;8;307;10356
44;10;03;15;357;Saint-Parres-aux-Tertres;3167;49;3216;10357
44;10;03;04;358;Saint-Parres-lès-Vaudes;1043;18;1061;10358
44;10;03;01;359;Saint-Phal;513;11;524;10359
44;10;03;08;360;Saint-Pouange;953;230;1183;10360
44;10;03;02;361;Saint-Remy-sous-Barbuise;241;4;245;10361
44;10;03;13;362;Sainte-Savine;10508;388;10896;10362
44;10;03;17;363;Saint-Thibault;550;3;553;10363
44;10;03;04;364;Saint-Usage;73;2;75;10364
44;10;02;06;365;Salon;123;0;123;10365
44;10;01;03;366;Saulcy;65;2;67;10366
44;10;02;07;367;La Saulsotte;689;9;698;10367
44;10;02;06;368;Savières;999;11;1010;10368
44;10;03;02;369;Semoine;193;6;199;10369
44;10;02;07;370;Soligny-les-Etangs;246;6;252;10370
44;10;03;08;371;Sommeval;308;5;313;10371
44;10;01;03;372;Soulaines-Dhuys;417;6;423;10372
44;10;03;08;373;Souligny;379;20;399;10373
44;10;01;03;374;Spoy;161;1;162;10374
44;10;03;17;375;Thennelières;332;10;342;10375
44;10;03;04;376;Thieffrain;154;3;157;10376
44;10;01;03;377;Thil;112;9;121;10377
44;10;01;03;378;Thors;69;3;72;10378
44;10;03;02;379;Torcy-le-Grand;456;9;465;10379
44;10;03;02;380;Torcy-le-Petit;80;5;85;10380
44;10;03;10;381;Torvilliers;988;18;1006;10381
44;10;02;07;382;Traînel;1047;13;1060;10382
44;10;02;11;383;Trancault;185;3;188;10383
44;10;01;17;384;Trannes;217;7;224;10384
44;10;03;02;386;Trouans;224;7;231;10386
44;10;03;99;387;Troyes;61957;1130;63087;10387
44;10;03;08;388;Turgy;44;1;45;10388
44;10;01;05;389;Unienville;116;4;120;10389
44;10;01;03;390;Urville;122;2;124;10390
44;10;03;06;391;Vailly;294;1;295;10391
44;10;02;06;392;Vallant-Saint-Georges;400;9;409;10392
44;10;01;05;393;Vallentigny;177;3;180;10393
44;10;03;08;394;Vallières;165;1;166;10394
44;10;03;08;395;Vanlay;295;4;299;10395
44;10;03;01;396;Vauchassis;500;5;505;10396
44;10;01;17;397;Vauchonvilliers;164;2;166;10397
44;10;03;02;398;Vaucogne;76;4;80;10398
44;10;03;04;399;Vaudes;720;8;728;10399
44;10;03;02;400;Vaupoisson;117;5;122;10400
44;10;01;17;401;Vendeuvre-sur-Barse;2315;39;2354;10401
44;10;03;08;402;La Vendue-Mignot;245;5;250;10402
44;10;01;03;403;Vernonvilliers;54;1;55;10403
44;10;03;04;404;Verpillières-sur-Ource;109;2;111;10404
44;10;03;02;405;Verricourt;56;0;56;10405
44;10;03;17;406;Verrières;1858;37;1895;10406
44;10;02;06;408;Viâpres-le-Petit;132;5;137;10408
44;10;03;06;409;Villacerf;602;4;606;10409
44;10;02;11;410;Villadin;107;4;111;10410
44;10;01;03;411;La Ville-aux-Bois;27;0;27;10411
44;10;03;06;412;Villechétif;942;20;962;10412
44;10;03;11;414;Villeloup;124;5;129;10414
44;10;03;08;416;Villemereuil;245;9;254;10416
44;10;03;01;417;Villemoiron-en-Othe;204;6;210;10417
44;10;03;04;418;Villemorien;201;9;210;10418
44;10;03;04;419;Villemoyenne;753;13;766;10419
44;10;02;07;420;Villenauxe-la-Grande;2726;30;2756;10420
44;10;02;07;421;La Villeneuve-au-Châtelot;148;4;152;10421
44;10;03;01;422;Villeneuve-au-Chemin;184;2;186;10422
44;10;01;17;423;La Villeneuve-au-Chêne;417;15;432;10423
44;10;01;05;424;Villeret;63;2;65;10424
44;10;03;08;425;Villery;272;3;275;10425
44;10;01;03;426;Ville-sous-la-Ferté;960;12;972;10426
44;10;03;04;427;Ville-sur-Arce;204;7;211;10427
44;10;01;03;428;Ville-sur-Terre;100;5;105;10428
44;10;03;02;429;Villette-sur-Aube;248;3;251;10429
44;10;03;02;430;Villiers-Herbisse;85;2;87;10430
44;10;03;08;431;Villiers-le-Bois;101;1;102;10431
44;10;03;08;432;Villiers-sous-Praslin;71;1;72;10432
44;10;03;04;433;Villy-en-Trodes;251;8;259;10433
44;10;03;08;434;Villy-le-Bois;56;1;57;10434
44;10;03;08;435;Villy-le-Maréchal;186;4;190;10435
44;10;03;02;436;Vinets;170;7;177;10436
44;10;03;04;437;Virey-sous-Bar;605;10;615;10437
44;10;03;04;438;Vitry-le-Croisé;221;5;226;10438
44;10;03;04;439;Viviers-sur-Artaut;125;3;128;10439
44;10;01;03;440;Voigny;146;6;152;10440
44;10;03;01;441;Vosnon;232;2;234;10441
44;10;03;02;442;Voué;686;9;695;10442
44;10;03;08;443;Vougrey;45;1;46;10443
44;10;03;01;444;Vulaines;227;3;230;10444
44;10;01;05;445;Yèvres-le-Petit;54;9;63;10445
76;11;01;15;001;Aigues-Vives;563;11;574;11001
76;11;01;05;002;Airoux;168;2;170;11002
76;11;02;09;003;Ajac;196;3;199;11003
76;11;02;01;004;Alaigne;333;5;338;11004
76;11;01;04;005;Alairac;1313;33;1346;11005
76;11;03;07;006;Albas;79;2;81;11006
76;11;03;07;007;Albières;121;4;125;11007
76;11;02;09;008;Alet-les-Bains;386;3;389;11008
76;11;01;10;009;Alzonne;1582;22;1604;11009
76;11;02;14;010;Antugnac;258;7;265;11010
76;11;01;19;011;Aragon;456;14;470;11011
76;11;03;16;012;Argeliers;2189;32;2221;11012
76;11;03;08;013;Argens-Minervois;355;6;361;11013
76;11;03;06;014;Armissan;1513;30;1543;11014
76;11;02;14;015;Arques;262;3;265;11015
76;11;01;18;016;Arquettes-en-Val;80;3;83;11016
76;11;02;14;017;Artigues;74;1;75;11017
76;11;01;10;018;Arzens;1220;33;1253;11018
76;11;02;14;019;Aunat;64;0;64;11019
76;11;03;07;020;Auriac;38;0;38;11020
76;11;02;14;021;Axat;535;11;546;11021
76;11;01;15;022;Azille;1113;23;1136;11022
76;11;01;18;023;Badens;760;14;774;11023
76;11;03;12;024;Bages;784;15;799;11024
76;11;01;15;025;Bagnoles;306;3;309;11025
76;11;01;01;026;Baraigne;175;3;178;11026
76;11;01;18;027;Barbaira;777;20;797;11027
76;11;02;14;028;Belcaire;382;7;389;11028
76;11;02;09;029;Belcastel-et-Buc;60;3;63;11029
76;11;01;01;030;Belflou;118;6;124;11030
76;11;02;14;031;Belfort-sur-Rebenty;23;2;25;11031
76;11;02;01;032;Bellegarde-du-Razès;245;2;247;11032
76;11;01;01;033;Belpech;1317;27;1344;11033
76;11;02;01;034;Belvèze-du-Razès;857;7;864;11034
76;11;02;14;035;Belvianes-et-Cavirac;243;6;249;11035
76;11;02;14;036;Belvis;162;2;164;11036
76;11;01;18;037;Berriac;966;10;976;11037
76;11;02;14;038;Bessède-de-Sault;46;0;46;11038
76;11;02;09;039;La Bezole;47;1;48;11039
76;11;03;11;040;Bizanet;1746;28;1774;11040
76;11;03;16;041;Bize-Minervois;1225;15;1240;11041
76;11;01;18;042;Blomac;228;6;234;11042
76;11;01;18;043;Bouilhonnac;223;6;229;11043
76;11;03;07;044;Bouisse;105;0;105;11044
76;11;02;09;045;Bouriège;141;1;142;11045
76;11;02;09;046;Bourigeole;55;0;55;11046
76;11;02;14;047;Le Bousquet;47;1;48;11047
76;11;03;07;048;Boutenac;727;16;743;11048
76;11;01;01;049;Bram;3208;81;3289;11049
76;11;01;01;051;Brézilhac;181;4;185;11051
76;11;01;10;052;Brousses-et-Villaret;343;5;348;11052
76;11;02;01;053;Brugairolles;283;5;288;11053
76;11;01;10;054;Les Brunels;271;11;282;11054
76;11;02;14;055;Bugarach;240;4;244;11055
76;11;01;15;056;Cabrespine;171;4;175;11056
76;11;01;01;057;Cahuzac;29;0;29;11057
76;11;02;01;058;Cailhau;256;8;264;11058
76;11;02;01;059;Cailhavel;138;1;139;11059
76;11;02;14;060;Cailla;49;1;50;11060
76;11;02;01;061;Cambieure;303;4;307;11061
76;11;02;14;062;Campagna-de-Sault;19;0;19;11062
76;11;02;14;063;Campagne-sur-Aude;603;5;608;11063
76;11;03;07;064;Camplong-d'Aude;371;4;375;11064
76;11;02;14;065;Camps-sur-l'Agly;53;1;54;11065
76;11;02;14;066;Camurac;102;0;102;11066
76;11;03;16;067;Canet;1826;18;1844;11067
76;11;01;18;068;Capendu;1473;41;1514;11068
76;11;01;98;069;Carcassonne;46825;1291;48116;11069
76;11;01;10;070;Carlipa;337;5;342;11070
76;11;03;07;071;Cascastel-des-Corbières;224;7;231;11071
76;11;01;01;072;La Cassaigne;165;8;173;11072
76;11;02;14;073;Cassaignes;59;0;59;11073
76;11;01;05;074;Les Cassés;302;2;304;11074
76;11;01;15;075;Castans;133;2;135;11075
76;11;01;05;076;Castelnaudary;12187;507;12694;11076
76;11;03;08;077;Castelnau-d'Aude;503;9;512;11077
76;11;02;09;078;Castelreng;207;7;214;11078
76;11;01;19;079;Caudebronde;206;3;209;11079
76;11;02;14;080;Val de Lambronne;170;2;172;11080
76;11;01;15;081;Caunes-Minervois;1621;30;1651;11081
76;11;02;09;082;Caunette-sur-Lauquet;8;0;8;11082
76;11;01;18;083;Caunettes-en-Val;52;0;52;11083
76;11;01;10;084;Caux-et-Sauzens;1003;23;1026;11084
76;11;01;03;085;Cavanac;954;39;993;11085
76;11;03;17;086;Caves;906;13;919;11086
76;11;01;01;087;Cazalrenoux;93;1;94;11087
76;11;01;03;088;Cazilhac;1652;50;1702;11088
76;11;01;10;089;Cenne-Monestiés;407;7;414;11089
76;11;02;09;090;Cépie;623;17;640;11090
76;11;02;14;091;Chalabre;1132;12;1144;11091
76;11;01;15;092;Citou;87;1;88;11092
76;11;02;14;093;Le Clat;28;2;30;11093
76;11;02;09;094;Clermont-sur-Lauquet;26;0;26;11094
76;11;01;18;095;Comigne;303;8;311;11095
76;11;02;14;096;Comus;36;2;38;11096
76;11;03;08;098;Conilhac-Corbières;905;19;924;11098
76;11;01;19;099;Conques-sur-Orbiel;2581;55;2636;11099
76;11;02;14;100;Corbières;26;1;27;11100
76;11;02;14;101;Coudons;52;1;53;11101
76;11;01;03;102;Couffoulens;587;8;595;11102
76;11;02;14;103;Couiza;1118;21;1139;11103
76;11;02;14;104;Counozouls;50;0;50;11104
76;11;02;09;105;Cournanel;726;10;736;11105
76;11;03;06;106;Coursan;5825;96;5921;11106
76;11;02;14;107;Courtauly;76;1;77;11107
76;11;02;01;108;La Courtète;46;1;47;11108
76;11;02;14;109;Coustaussa;52;1;53;11109
76;11;03;07;110;Coustouge;118;0;118;11110
76;11;03;08;111;Cruscades;933;9;942;11111
76;11;02;14;112;Cubières-sur-Cinoble;84;1;85;11112
76;11;03;07;113;Cucugnan;116;5;121;11113
76;11;01;01;114;Cumiès;39;0;39;11114
76;11;01;10;115;Cuxac-Cabardès;897;24;921;11115
76;11;03;06;116;Cuxac-d'Aude;4033;71;4104;11116
76;11;03;07;117;Davejean;115;2;117;11117
76;11;03;07;118;Dernacueillette;44;1;45;11118
76;11;02;09;119;La Digne-d'Amont;295;7;302;11119
76;11;02;09;120;La Digne-d'Aval;530;13;543;11120
76;11;02;01;121;Donazac;110;1;111;11121
76;11;01;18;122;Douzens;765;12;777;11122
76;11;03;07;123;Duilhac-sous-Peyrepertuse;146;3;149;11123
76;11;03;07;124;Durban-Corbières;654;11;665;11124
76;11;03;07;125;Embres-et-Castelmaure;153;0;153;11125
76;11;03;08;126;Escales;477;4;481;11126
76;11;02;14;127;Escouloubre;71;3;74;11127
76;11;02;01;128;Escueillens-et-Saint-Just-de-Bélengard;148;2;150;11128
76;11;02;14;129;Espéraza;1729;32;1761;11129
76;11;02;14;130;Espezel;227;5;232;11130
76;11;02;14;131;Val-du-Faby;573;13;586;11131
76;11;03;07;132;Fabrezan;1256;16;1272;11132
76;11;01;18;133;Fajac-en-Val;42;0;42;11133
76;11;01;01;134;Fajac-la-Relenque;50;4;54;11134
76;11;02;14;135;La Fajolle;12;1;13;11135
76;11;01;01;136;Fanjeaux;849;89;938;11136
76;11;03;07;137;Félines-Termenès;127;5;132;11137
76;11;01;05;138;Fendeille;526;16;542;11138
76;11;01;01;139;Fenouillet-du-Razès;79;0;79;11139
76;11;03;07;140;Ferrals-les-Corbières;1235;21;1256;11140
76;11;01;01;141;Ferran;120;1;121;11141
76;11;02;09;142;Festes-et-Saint-André;198;5;203;11142
76;11;03;17;143;Feuilla;110;0;110;11143
76;11;03;17;144;Fitou;1069;12;1081;11144
76;11;03;06;145;Fleury;3758;62;3820;11145
76;11;01;18;146;Floure;406;8;414;11146
76;11;02;14;147;Fontanès-de-Sault;5;0;5;11147
76;11;03;07;148;Fontcouverte;552;10;562;11148
76;11;01;01;149;Fonters-du-Razès;79;1;80;11149
76;11;01;10;150;Fontiers-Cabardès;450;50;500;11150
76;11;01;18;151;Fontiès-d'Aude;514;11;525;11151
76;11;03;07;152;Fontjoncouse;127;4;131;11152
76;11;01;01;153;La Force;241;7;248;11153
76;11;01;19;154;Fournes-Cabardès;49;0;49;11154
76;11;02;14;155;Fourtou;78;1;79;11155
76;11;01;10;156;Fraisse-Cabardès;105;2;107;11156
76;11;03;07;157;Fraissé-des-Corbières;213;5;218;11157
76;11;02;09;158;Gaja-et-Villedieu;291;11;302;11158
76;11;01;01;159;Gaja-la-Selve;138;2;140;11159
76;11;02;14;160;Galinagues;36;0;36;11160
76;11;02;09;161;Gardie;127;3;130;11161
76;11;01;01;162;Generville;58;1;59;11162
76;11;02;14;163;Gincla;46;0;46;11163
76;11;03;16;164;Ginestas;1499;21;1520;11164
76;11;02;14;165;Ginoles;303;9;312;11165
76;11;01;01;166;Gourvieille;81;0;81;11166
76;11;02;01;167;Gramazie;124;2;126;11167
76;11;02;14;168;Granès;95;0;95;11168
76;11;02;09;169;Greffeil;86;5;91;11169
76;11;03;12;170;Gruissan;5087;80;5167;11170
76;11;03;08;172;Homps;594;11;605;11172
76;11;01;01;173;Hounoux;132;3;135;11173
76;11;01;19;174;Les Ilhes;55;0;55;11174
76;11;01;05;175;Issel;476;9;485;11175
76;11;03;07;176;Jonquières;59;2;61;11176
76;11;02;14;177;Joucou;32;0;32;11177
76;11;01;05;178;Labastide-d'Anjou;1284;15;1299;11178
76;11;01;18;179;Labastide-en-Val;91;2;93;11179
76;11;01;19;180;Labastide-Esparbairenque;64;0;64;11180
76;11;01;10;181;Labécède-Lauragais;399;8;407;11181
76;11;01;10;182;Lacombe;175;3;178;11182
76;11;02;09;183;Ladern-sur-Lauquet;267;9;276;11183
76;11;01;01;184;Lafage;92;3;95;11184
76;11;03;07;185;Lagrasse;540;9;549;11185
76;11;03;07;186;Lairière;55;2;57;11186
76;11;03;07;187;Lanet;57;1;58;11187
76;11;03;17;188;La Palme;1704;31;1735;11188
76;11;01;10;189;Laprade;106;1;107;11189
76;11;01;15;190;La Redorte;1227;20;1247;11190
76;11;03;07;191;Laroque-de-Fa;151;7;158;11191
76;11;01;05;192;Lasbordes;788;30;818;11192
76;11;01;01;193;Lasserre-de-Prouille;278;3;281;11193
76;11;01;19;194;Lastours;157;3;160;11194
76;11;01;01;195;Laurabuc;402;9;411;11195
76;11;01;01;196;Laurac;180;8;188;11196
76;11;02;01;197;Lauraguel;604;16;620;11197
76;11;01;15;198;Laure-Minervois;1022;15;1037;11198
76;11;01;04;199;Lavalette;1513;26;1539;11199
76;11;01;15;200;Lespinassière;134;7;141;11200
76;11;01;03;201;Leuc;865;15;880;11201
76;11;03;17;202;Leucate;4612;58;4670;11202
76;11;03;08;203;Lézignan-Corbières;11317;220;11537;11203
76;11;02;01;204;Lignairolles;48;0;48;11204
76;11;01;15;205;Limousis;134;2;136;11205
76;11;02;09;206;Limoux;10012;509;10521;11206
76;11;02;09;207;Loupia;239;5;244;11207
76;11;01;01;208;La Louvière-Lauragais;80;3;83;11208
76;11;02;14;209;Luc-sur-Aude;246;7;253;11209
76;11;03;07;210;Luc-sur-Orbieu;1138;10;1148;11210
76;11;02;09;211;Magrie;534;5;539;11211
76;11;03;16;212;Mailhac;574;12;586;11212
76;11;03;07;213;Maisons;47;0;47;11213
76;11;02;09;214;Malras;422;12;434;11214
76;11;01;19;215;Malves-en-Minervois;864;26;890;11215
76;11;02;01;216;Malviès;368;12;380;11216
76;11;03;16;217;Marcorignan;1314;27;1341;11217
76;11;01;01;218;Marquein;83;0;83;11218
76;11;02;14;219;Marsa;19;0;19;11219
76;11;01;18;220;Marseillette;703;13;716;11220
76;11;01;19;221;Les Martys;299;5;304;11221
76;11;01;19;222;Mas-Cabardès;178;5;183;11222
76;11;01;03;223;Mas-des-Cours;25;1;26;11223
76;11;03;07;224;Massac;27;1;28;11224
76;11;01;05;225;Mas-Saintes-Puelles;927;22;949;11225
76;11;01;01;226;Mayreville;81;1;82;11226
76;11;01;18;227;Mayronnes;38;1;39;11227
76;11;02;01;228;Mazerolles-du-Razès;151;4;155;11228
76;11;02;14;229;Mazuby;25;1;26;11229
76;11;02;14;230;Mérial;32;0;32;11230
76;11;01;01;231;Mézerville;97;3;100;11231
76;11;01;19;232;Miraval-Cabardès;46;0;46;11232
76;11;03;16;233;Mirepeisset;758;13;771;11233
76;11;01;01;234;Mireval-Lauragais;185;5;190;11234
76;11;02;14;235;Missègre;60;2;62;11235
76;11;01;01;236;Molandier;242;2;244;11236
76;11;01;01;238;Molleville;138;6;144;11238
76;11;01;01;239;Montauriol;83;2;85;11239
76;11;02;14;240;Montazels;556;9;565;11240
76;11;03;08;241;Montbrun-des-Corbières;329;1;330;11241
76;11;01;04;242;Montclar;173;0;173;11242
76;11;01;05;243;Montferrand;602;10;612;11243
76;11;02;14;244;Montfort-sur-Boulzane;90;3;93;11244
76;11;03;07;245;Montgaillard;38;0;38;11245
76;11;02;01;246;Montgradail;46;0;46;11246
76;11;02;01;247;Monthaut;38;0;38;11247
76;11;01;18;248;Montirat;69;1;70;11248
76;11;02;14;249;Montjardin;82;1;83;11249
76;11;03;07;250;Montjoi;36;1;37;11250
76;11;01;18;251;Val-de-Dagne;741;10;751;11251
76;11;01;05;252;Montmaur;304;9;313;11252
76;11;01;10;253;Montolieu;836;14;850;11253
76;11;01;10;254;Montréal;1900;173;2073;11254
76;11;03;11;255;Montredon-des-Corbières;1485;15;1500;11255
76;11;03;07;256;Montséret;614;12;626;11256
76;11;01;18;257;Monze;230;3;233;11257
76;11;03;16;258;Moussan;2030;48;2078;11258
76;11;01;10;259;Moussoulens;1005;30;1035;11259
76;11;03;07;260;Mouthoumet;106;3;109;11260
76;11;03;18;261;Moux;701;8;709;11261
76;11;03;99;262;Narbonne;55516;1184;56700;11262
76;11;02;14;263;Nébias;260;5;265;11263
76;11;03;11;264;Névian;1289;32;1321;11264
76;11;02;14;265;Niort-de-Sault;38;1;39;11265
76;11;03;17;266;Port-la-Nouvelle;5795;68;5863;11266
76;11;03;08;267;Ornaisons;1127;25;1152;11267
76;11;01;01;268;Orsans;113;0;113;11268
76;11;03;16;269;Ouveillan;2564;50;2614;11269
76;11;03;07;270;Padern;137;1;138;11270
76;11;03;07;271;Palairac;33;0;33;11271
76;11;01;03;272;Palaja;2398;101;2499;11272
76;11;03;16;273;Paraza;673;12;685;11273
76;11;02;09;274;Pauligne;369;15;384;11274
76;11;01;01;275;Payra-sur-l'Hers;205;3;208;11275
76;11;03;07;276;Paziols;526;17;543;11276
76;11;01;01;277;Pécharic-et-le-Py;28;2;30;11277
76;11;01;01;278;Pech-Luna;74;1;75;11278
76;11;01;19;279;Pennautier;2634;60;2694;11279
76;11;01;15;280;Pépieux;1087;30;1117;11280
76;11;01;01;281;Pexiora;1230;19;1249;11281
76;11;02;14;282;Peyrefitte-du-Razès;52;2;54;11282
76;11;01;01;283;Peyrefitte-sur-l'Hers;77;5;82;11283
76;11;01;05;284;Peyrens;476;16;492;11284
76;11;03;17;285;Peyriac-de-Mer;1132;23;1155;11285
76;11;01;15;286;Peyriac-Minervois;1166;20;1186;11286
76;11;02;14;287;Peyrolles;87;2;89;11287
76;11;01;10;288;Pezens;1577;155;1732;11288
76;11;02;09;289;Pieusse;967;17;984;11289
76;11;01;01;290;Plaigne;116;1;117;11290
76;11;01;01;291;Plavilla;108;4;112;11291
76;11;01;05;292;La Pomarède;165;1;166;11292
76;11;02;09;293;Pomas;899;23;922;11293
76;11;02;01;294;Pomy;58;1;59;11294
76;11;03;17;295;Portel-des-Corbières;1339;19;1358;11295
76;11;03;16;296;Pouzols-Minervois;565;9;574;11296
76;11;01;19;297;Pradelles-Cabardès;142;1;143;11297
76;11;01;04;299;Preixan;623;14;637;11299
76;11;01;05;300;Puginier;154;0;154;11300
76;11;01;15;301;Puichéric;1184;17;1201;11301
76;11;02;14;302;Puilaurens;265;9;274;11302
76;11;02;14;303;Puivert;441;15;456;11303
76;11;02;14;304;Quillan;3212;108;3320;11304
76;11;03;07;305;Quintillan;50;0;50;11305
76;11;02;14;306;Quirbajou;52;2;54;11306
76;11;03;16;307;Raissac-d'Aude;262;5;267;11307
76;11;01;10;308;Raissac-sur-Lampy;451;9;460;11308
76;11;02;14;309;Rennes-le-Château;93;4;97;11309
76;11;02;14;310;Rennes-les-Bains;201;1;202;11310
76;11;03;07;311;Ribaute;270;4;274;11311
76;11;01;01;312;Ribouisse;111;5;116;11312
76;11;01;05;313;Ricaud;302;7;309;11313
76;11;01;18;314;Rieux-en-Val;85;7;92;11314
76;11;01;15;315;Rieux-Minervois;1949;26;1975;11315
76;11;02;14;316;Rivel;210;3;213;11316
76;11;02;14;317;Rodome;113;1;114;11317
76;11;03;18;318;Roquecourbe-Minervois;136;6;142;11318
76;11;01;19;319;Roquefère;80;1;81;11319
76;11;02;14;320;Roquefeuil;294;4;298;11320
76;11;02;14;321;Roquefort-de-Sault;83;0;83;11321
76;11;03;17;322;Roquefort-des-Corbières;990;18;1008;11322
76;11;02;14;323;Roquetaillade-et-Conilhac;275;2;277;11323
76;11;03;16;324;Roubia;505;13;518;11324
76;11;01;04;325;Rouffiac-d'Aude;452;11;463;11325
76;11;03;07;326;Rouffiac-des-Corbières;80;1;81;11326
76;11;01;04;327;Roullens;472;13;485;11327
76;11;02;01;328;Routier;241;3;244;11328
76;11;01;15;330;Rustiques;506;12;518;11330
76;11;01;01;331;Saint-Amans;61;3;64;11331
76;11;03;07;332;Saint-André-de-Roquelongue;1369;16;1385;11332
76;11;02;14;333;Saint-Benoît;107;3;110;11333
76;11;01;01;334;Sainte-Camelle;117;2;119;11334
76;11;02;14;335;Sainte-Colombe-sur-Guette;45;0;45;11335
76;11;02;14;336;Sainte-Colombe-sur-l'Hers;436;7;443;11336
76;11;03;18;337;Saint-Couat-d'Aude;387;4;391;11337
76;11;02;09;338;Saint-Couat-du-Razès;41;1;42;11338
76;11;01;10;339;Saint-Denis;504;12;516;11339
76;11;01;10;340;Sainte-Eulalie;525;10;535;11340
76;11;02;14;341;Saint-Ferriol;112;2;114;11341
76;11;01;15;342;Saint-Frichoux;242;4;246;11342
76;11;01;01;343;Saint-Gaudéric;120;2;122;11343
76;11;02;09;344;Saint-Hilaire;713;16;729;11344
76;11;03;07;345;Saint-Jean-de-Barrou;262;0;262;11345
76;11;02;14;346;Saint-Jean-de-Paracol;127;3;130;11346
76;11;02;14;347;Saint-Julia-de-Bec;104;2;106;11347
76;11;01;01;348;Saint-Julien-de-Briola;88;1;89;11348
76;11;02;14;350;Saint-Just-et-le-Bézu;51;3;54;11350
76;11;03;07;351;Saint-Laurent-de-la-Cabrerisse;724;26;750;11351
76;11;02;14;352;Saint-Louis-et-Parahou;51;2;53;11352
76;11;03;16;353;Saint-Marcel-sur-Aude;2020;46;2066;11353
76;11;03;07;354;Saint-Martin-des-Puits;27;0;27;11354
76;11;02;09;355;Saint-Martin-de-Villereglan;361;8;369;11355
76;11;01;05;356;Saint-Martin-Lalande;1121;20;1141;11356
76;11;01;10;357;Saint-Martin-le-Vieil;217;7;224;11357
76;11;02;14;358;Saint-Martin-Lys;24;2;26;11358
76;11;01;01;359;Saint-Michel-de-Lanès;475;6;481;11359
76;11;03;16;360;Saint-Nazaire-d'Aude;2069;35;2104;11360
76;11;01;05;361;Saint-Papoul;883;20;903;11361
76;11;01;05;362;Saint-Paulet;201;4;205;11362
76;11;03;07;363;Saint-Pierre-des-Champs;182;5;187;11363
76;11;02;09;364;Saint-Polycarpe;143;2;145;11364
76;11;01;01;365;Saint-Sernin;41;2;43;11365
76;11;03;16;366;Sainte-Valière;537;10;547;11366
76;11;01;10;367;Saissac;922;23;945;11367
76;11;01;15;368;Sallèles-Cabardès;119;3;122;11368
76;11;03;16;369;Sallèles-d'Aude;3024;43;3067;11369
76;11;03;06;370;Salles-d'Aude;3254;76;3330;11370
76;11;01;01;371;Salles-sur-l'Hers;707;13;720;11371
76;11;01;19;372;Salsigne;379;5;384;11372
76;11;02;14;373;Salvezines;72;1;73;11373
76;11;03;07;374;Salza;16;0;16;11374
76;11;02;01;375;Seignalens;30;1;31;11375
76;11;02;14;376;La Serpent;95;4;99;11376
76;11;02;14;377;Serres;76;0;76;11377
76;11;01;18;378;Serviès-en-Val;203;6;209;11378
76;11;03;17;379;Sigean;5533;96;5629;11379
76;11;02;14;380;Sonnac-sur-l'Hers;130;3;133;11380
76;11;02;14;381;Sougraigne;122;7;129;11381
76;11;01;05;382;Souilhanels;362;58;420;11382
76;11;01;05;383;Souilhe;324;10;334;11383
76;11;03;07;384;Soulatgé;126;0;126;11384
76;11;01;05;385;Soupex;236;7;243;11385
76;11;03;07;386;Talairan;483;7;490;11386
76;11;01;18;387;Taurize;111;1;112;11387
76;11;03;07;388;Termes;47;0;47;11388
76;11;02;14;389;Terroles;16;0;16;11389
76;11;03;07;390;Thézan-des-Corbières;556;10;566;11390
76;11;01;19;391;La Tourette-Cabardès;24;2;26;11391
76;11;03;07;392;Tournissan;270;4;274;11392
76;11;03;08;393;Tourouzelle;487;7;494;11393
76;11;02;09;394;Tourreilles;131;0;131;11394
76;11;01;15;395;Trassanel;30;0;30;11395
76;11;01;15;396;Trausse;597;3;600;11396
76;11;01;18;397;Trèbes;5502;128;5630;11397
76;11;03;17;398;Treilles;255;5;260;11398
76;11;01;05;399;Tréville;106;5;111;11399
76;11;02;14;400;Tréziers;103;1;104;11400
76;11;03;07;401;Tuchan;793;11;804;11401
76;11;02;14;402;Valmigère;23;0;23;11402
76;11;01;19;404;Ventenac-Cabardès;956;33;989;11404
76;11;03;16;405;Ventenac-en-Minervois;574;10;584;11405
76;11;02;09;406;Véraza;33;2;35;11406
76;11;01;10;407;Verdun-en-Lauragais;280;6;286;11407
76;11;01;03;408;Verzeille;504;8;512;11408
76;11;03;07;409;Vignevieille;105;1;106;11409
76;11;01;19;410;Villalier;986;17;1003;11410
76;11;01;19;411;Villanière;135;1;136;11411
76;11;02;09;412;Villardebelle;55;0;55;11412
76;11;01;19;413;Villardonnel;503;11;514;11413
76;11;01;18;414;Villar-en-Val;24;1;25;11414
76;11;02;09;415;Villar-Saint-Anselme;124;0;124;11415
76;11;01;15;416;Villarzel-Cabardès;249;5;254;11416
76;11;02;01;417;Villarzel-du-Razès;98;0;98;11417
76;11;01;01;418;Villasavary;1211;39;1250;11418
76;11;01;01;419;Villautou;63;0;63;11419
76;11;02;09;420;Villebazy;135;3;138;11420
76;11;03;11;421;Villedaigne;534;8;542;11421
76;11;01;18;422;Villedubert;348;15;363;11422
76;11;01;03;423;Villefloure;159;4;163;11423
76;11;02;14;424;Villefort;85;1;86;11424
76;11;01;19;425;Villegailhenc;1684;54;1738;11425
76;11;01;15;426;Villegly;1177;23;1200;11426
76;11;02;09;427;Villelongue-d'Aude;302;8;310;11427
76;11;01;10;428;Villemagne;252;7;259;11428
76;11;01;19;429;Villemoustaussou;4469;80;4549;11429
76;11;01;05;430;Villeneuve-la-Comptal;1359;42;1401;11430
76;11;03;07;431;Villeneuve-les-Corbières;248;7;255;11431
76;11;01;10;432;Villeneuve-lès-Montréal;322;10;332;11432
76;11;01;15;433;Villeneuve-Minervois;976;17;993;11433
76;11;01;01;434;Villepinte;1276;25;1301;11434
76;11;03;07;435;Villerouge-Termenès;154;6;160;11435
76;11;03;07;436;Villesèque-des-Corbières;370;2;372;11436
76;11;01;10;437;Villesèquelande;911;17;928;11437
76;11;01;01;438;Villesiscle;388;6;394;11438
76;11;01;10;439;Villespy;400;8;408;11439
76;11;01;18;440;Villetritouls;35;3;38;11440
76;11;03;06;441;Vinassan;2658;53;2711;11441
76;12;01;03;001;Agen-d'Aveyron;1069;32;1101;12001
76;12;01;12;002;Aguessac;869;29;898;12002
76;12;03;08;003;Les Albres;343;7;350;12003
76;12;03;07;004;Almont-les-Junies;445;20;465;12004
76;12;01;15;006;Alrance;351;11;362;12006
76;12;03;23;007;Ambeyrac;176;8;184;12007
76;12;03;06;008;Anglars-Saint-Félix;885;19;904;12008
76;12;01;04;009;Arnac-sur-Dourdou;36;1;37;12009
76;12;01;15;010;Arques;153;2;155;12010
76;12;01;13;011;Arvieu;775;28;803;12011
76;12;03;08;012;Asprières;746;9;755;12012
76;12;03;06;013;Aubin;3741;113;3854;12013
76;12;01;13;015;Auriac-Lagast;228;3;231;12015
76;12;03;06;016;Auzits;824;26;850;12016
76;12;01;15;017;Ayssènes;216;5;221;12017
76;12;03;08;018;Balaguier-d'Olt;181;7;188;12018
76;12;01;04;019;Balaguier-sur-Rance;89;4;93;12019
76;12;03;02;021;Le Bas Ségala;1558;55;1613;12021
76;12;01;19;022;La Bastide-Pradines;109;0;109;12022
76;12;01;04;023;La Bastide-Solages;106;1;107;12023
76;12;03;06;024;Belcastel;195;3;198;12024
76;12;01;04;025;Belmont-sur-Rance;972;12;984;12025
76;12;02;09;026;Bertholène;1054;20;1074;12026
76;12;02;10;027;Bessuéjouls;202;10;212;12027
76;12;03;07;028;Boisse-Penchot;518;9;527;12028
76;12;03;02;029;Bor-et-Bar;201;4;205;12029
76;12;03;08;030;Bouillac;379;15;394;12030
76;12;03;06;031;Bournazel;356;5;361;12031
76;12;03;05;032;Boussac;595;14;609;12032
76;12;02;03;033;Bozouls;2923;66;2989;12033
76;12;03;23;034;Brandonnet;303;7;310;12034
76;12;01;04;035;Brasc;172;8;180;12035
76;12;02;01;036;Brommat;637;8;645;12036
76;12;01;15;037;Broquiès;608;16;624;12037
76;12;01;15;038;Brousse-le-Château;164;4;168;12038
76;12;01;04;039;Brusque;264;5;269;12039
76;12;03;05;041;Cabanès;264;6;270;12041
76;12;01;19;042;Calmels-et-le-Viala;208;11;219;12042
76;12;03;13;043;Calmont;2166;76;2242;12043
76;12;01;04;044;Camarès;1028;32;1060;12044
76;12;03;05;045;Camboulazet;388;12;400;12045
76;12;03;05;046;Camjac;573;16;589;12046
76;12;02;20;047;Campagnac;451;6;457;12047
76;12;02;01;048;Campouriez;345;9;354;12048
76;12;02;10;049;Campuac;451;10;461;12049
76;12;01;15;050;Canet-de-Salars;442;12;454;12050
76;12;02;01;051;Cantoin;310;2;312;12051
76;12;03;08;052;Capdenac-Gare;4419;115;4534;12052
76;12;03;23;053;La Capelle-Balaguier;327;6;333;12053
76;12;03;02;054;La Capelle-Bleys;351;8;359;12054
76;12;02;20;055;La Capelle-Bonance;83;0;83;12055
76;12;03;05;056;Baraqueville;3150;84;3234;12056
76;12;03;13;057;Cassagnes-Bégonhès;925;34;959;12057
76;12;02;01;058;Cassuéjouls;106;5;111;12058
76;12;03;05;059;Castanet;517;24;541;12059
76;12;03;02;060;Castelmary;114;4;118;12060
76;12;02;09;061;Castelnau-de-Mandailles;575;11;586;12061
76;12;01;20;062;Castelnau-Pégayrols;343;3;346;12062
76;12;01;04;063;La Cavalerie;1939;29;1968;12063
76;12;02;10;064;Le Cayrol;268;6;274;12064
76;12;03;05;065;Centrès;461;14;475;12065
76;12;02;21;066;Clairvaux-d'Aveyron;1148;28;1176;12066
76;12;01;04;067;Le Clapier;76;0;76;12067
76;12;03;05;068;Colombiès;878;26;904;12068
76;12;01;04;069;Combret;265;7;272;12069
76;12;01;12;070;Compeyre;522;26;548;12070
76;12;03;23;071;Compolibat;334;7;341;12071
76;12;01;11;072;Comprégnac;232;7;239;12072
76;12;01;13;073;Comps-la-Grand-Ville;625;19;644;12073
76;12;02;01;074;Condom-d'Aubrac;295;14;309;12074
76;12;01;13;075;Connac;106;2;108;12075
76;12;02;07;076;Conques-en-Rouergue;1615;57;1672;12076
76;12;01;04;077;Cornus;513;12;525;12077
76;12;01;15;078;Les Costes-Gozon;185;2;187;12078
76;12;02;10;079;Coubisou;491;18;509;12079
76;12;01;04;080;Coupiac;373;9;382;12080
76;12;01;04;082;La Couvertoirade;189;2;191;12082
76;12;03;06;083;Cransac;1473;52;1525;12083
76;12;01;11;084;Creissels;1569;57;1626;12084
76;12;03;02;085;Crespin;315;0;315;12085
76;12;01;20;086;La Cresse;324;16;340;12086
76;12;02;01;088;Curières;228;4;232;12088
76;12;03;07;089;Decazeville;5323;206;5529;12089
76;12;02;21;090;Druelle Balsac;3205;94;3299;12090
76;12;03;23;091;Drulhe;455;11;466;12091
76;12;01;13;092;Durenque;523;10;533;12092
76;12;02;10;093;Le Fel;176;1;177;12093
76;12;02;10;094;Entraygues-sur-Truyère;985;17;1002;12094
76;12;03;06;095;Escandolières;240;6;246;12095
76;12;02;10;096;Espalion;4601;149;4750;12096
76;12;02;10;097;Espeyrac;248;3;251;12097
76;12;02;10;098;Estaing;461;21;482;12098
76;12;01;04;099;Fayet;241;4;245;12099
76;12;03;06;100;Firmi;2372;67;2439;12100
76;12;03;07;101;Flagnac;1072;35;1107;12101
76;12;01;14;102;Flavin;2359;51;2410;12102
76;12;02;01;103;Florentin-la-Capelle;282;8;290;12103
76;12;03;08;104;Foissac;488;10;498;12104
76;12;03;02;105;La Fouillade;1108;25;1133;12105
76;12;02;03;106;Gabriac;534;11;545;12106
76;12;02;09;107;Gaillac-d'Aveyron;318;5;323;12107
76;12;03;08;108;Galgan;375;5;380;12108
76;12;01;04;109;Gissac;99;2;101;12109
76;12;02;10;110;Golinhac;325;16;341;12110
76;12;03;06;111;Goutrens;495;18;513;12111
76;12;03;05;113;Gramond;506;7;513;12113
76;12;01;04;115;L'Hospitalet-du-Larzac;290;3;293;12115
76;12;02;01;116;Huparlac;266;8;274;12116
76;12;02;01;118;Lacroix-Barrez;522;13;535;12118
76;12;02;01;119;Laguiole;1234;28;1262;12119
76;12;02;09;120;Laissac-Sévérac l'Eglise;2147;104;2251;12120
76;12;03;23;121;Lanuéjouls;723;16;739;12121
76;12;01;04;122;Lapanouse-de-Cernon;124;8;132;12122
76;12;02;09;124;Lassouts;306;9;315;12124
76;12;01;04;125;Laval-Roquecezière;278;4;282;12125
76;12;01;13;127;Lédergues;636;20;656;12127
76;12;03;02;128;Lescure-Jaoul;220;6;226;12128
76;12;01;15;129;Lestrade-et-Thouels;463;14;477;12129
76;12;03;07;130;Livinhac-le-Haut;1127;32;1159;12130
76;12;02;03;131;La Loubière;1512;47;1559;12131
76;12;02;14;133;Luc-la-Primaube;6005;166;6171;12133
76;12;03;08;134;Lugan;347;10;357;12134
76;12;03;02;135;Lunac;441;14;455;12135
76;12;03;23;136;Maleville;938;17;955;12136
76;12;03;05;137;Manhac;838;11;849;12137
76;12;02;21;138;Marcillac-Vallon;1729;50;1779;12138
76;12;01;04;139;Marnhagues-et-Latour;139;1;140;12139
76;12;03;23;140;Martiel;988;24;1012;12140
76;12;01;04;141;Martrin;222;7;229;12141
76;12;03;06;142;Mayran;637;15;652;12142
76;12;01;04;143;Mélagues;62;0;62;12143
76;12;03;05;144;Meljac;125;2;127;12144
76;12;01;98;145;Millau;21979;680;22659;12145
76;12;02;17;146;Le Monastère;2284;77;2361;12146
76;12;01;04;147;Montagnol;138;1;139;12147
76;12;03;08;148;Montbazens;1407;39;1446;12148
76;12;01;04;149;Montclar;154;5;159;12149
76;12;03;02;150;Monteils;502;89;591;12150
76;12;02;01;151;Montézic;214;8;222;12151
76;12;01;04;152;Montfranc;127;2;129;12152
76;12;01;20;153;Montjaux;421;7;428;12153
76;12;01;04;154;Montlaur;619;26;645;12154
76;12;01;04;155;Fondamente;334;9;343;12155
76;12;02;01;156;Montpeyroux;532;13;545;12156
76;12;02;03;157;Montrozier;1693;49;1742;12157
76;12;03;23;158;Montsalès;327;8;335;12158
76;12;03;02;159;Morlhon-le-Haut;561;24;585;12159
76;12;01;20;160;Mostuéjouls;317;5;322;12160
76;12;02;21;161;Mouret;545;15;560;12161
76;12;03;05;162;Moyrazès;1080;28;1108;12162
76;12;01;04;163;Murasson;210;4;214;12163
76;12;02;01;164;Mur-de-Barrez;701;14;715;12164
76;12;02;21;165;Muret-le-Château;363;16;379;12165
76;12;02;01;166;Murols;115;1;116;12166
76;12;03;02;167;Najac;699;22;721;12167
76;12;01;12;168;Nant;998;18;1016;12168
76;12;03;05;169;Naucelle;2007;146;2153;12169
76;12;03;08;170;Naussac;370;8;378;12170
76;12;02;21;171;Nauviale;584;19;603;12171
76;12;02;10;172;Le Nayrac;530;12;542;12172
76;12;02;14;174;Olemps;3439;99;3538;12174
76;12;03;23;175;Ols-et-Rinhodes;178;2;180;12175
76;12;02;18;176;Onet-le-Château;11665;594;12259;12176
76;12;02;09;177;Palmas d'Aveyron;1017;15;1032;12177
76;12;01;12;178;Paulhe;373;9;382;12178
76;12;01;04;179;Peux-et-Couffouleux;84;1;85;12179
76;12;01;20;180;Peyreleau;73;2;75;12180
76;12;03;08;181;Peyrusse-le-Roc;214;5;219;12181
76;12;02;09;182;Pierrefiche;279;5;284;12182
76;12;01;04;183;Plaisance;218;6;224;12183
76;12;02;09;184;Pomayrols;120;6;126;12184
76;12;01;15;185;Pont-de-Salars;1639;68;1707;12185
76;12;01;04;186;Pousthomy;211;2;213;12186
76;12;02;09;187;Prades-d'Aubrac;354;4;358;12187
76;12;01;15;188;Prades-Salars;316;10;326;12188
76;12;03;05;189;Pradinas;354;6;360;12189
76;12;03;02;190;Prévinquières;295;9;304;12190
76;12;03;23;191;Privezac;322;9;331;12191
76;12;01;04;192;Mounes-Prohencoux;185;4;189;12192
76;12;02;21;193;Pruines;286;13;299;12193
76;12;03;05;194;Quins;848;21;869;12194
76;12;01;04;195;Rebourguil;274;3;277;12195
76;12;01;13;197;Réquista;1983;78;2061;12197
76;12;03;02;198;Rieupeyroux;1949;72;2021;12198
76;12;03;06;199;Rignac;1991;142;2133;12199
76;12;01;20;200;Rivière-sur-Tarn;1039;27;1066;12200
76;12;02;03;201;Rodelle;1067;45;1112;12201
76;12;02;99;202;Rodez;24475;1935;26410;12202
76;12;01;19;203;Roquefort-sur-Soulzon;554;15;569;12203
76;12;01;20;204;La Roque-Sainte-Marguerite;178;4;182;12204
76;12;03;22;205;La Rouquette;775;16;791;12205
76;12;03;08;206;Roussennac;637;15;652;12206
76;12;01;13;207;Rullac-Saint-Cirq;345;14;359;12207
76;12;01;19;208;Saint-Affrique;8023;635;8658;12208
76;12;02;01;209;Saint-Amans-des-Cots;749;13;762;12209
76;12;03;02;210;Saint-André-de-Najac;454;5;459;12210
76;12;01;20;211;Saint-André-de-Vézines;134;1;135;12211
76;12;01;04;212;Saint-Beaulize;88;7;95;12212
76;12;01;20;213;Saint-Beauzély;616;15;631;12213
76;12;02;01;214;Saint-Chély-d'Aubrac;521;13;534;12214
76;12;02;21;215;Saint-Christophe-Vallon;1160;48;1208;12215
76;12;02;09;216;Saint-Côme-d'Olt;1400;37;1437;12216
76;12;03;23;217;Sainte-Croix;745;18;763;12217
76;12;02;09;219;Sainte-Eulalie-d'Olt;376;9;385;12219
76;12;01;04;220;Sainte-Eulalie-de-Cernon;288;2;290;12220
76;12;02;07;221;Saint-Félix-de-Lunel;339;10;349;12221
76;12;01;19;222;Saint-Félix-de-Sorgues;195;4;199;12222
76;12;02;01;223;Argences en Aubrac;1600;38;1638;12223
76;12;02;09;224;Saint Geniez d'Olt et d'Aubrac;2211;40;2251;12224
76;12;01;11;225;Saint-Georges-de-Luzençon;1617;44;1661;12225
76;12;02;10;226;Saint-Hippolyte;427;13;440;12226
76;12;03;23;227;Saint-Igest;182;5;187;12227
76;12;01;19;228;Saint-Izaire;303;8;311;12228
76;12;01;19;229;Saint-Jean-d'Alcapiès;254;7;261;12229
76;12;01;13;230;Saint-Jean-Delnous;403;16;419;12230
76;12;01;12;231;Saint-Jean-du-Bruel;715;8;723;12231
76;12;01;04;232;Saint-Jean-et-Saint-Paul;279;8;287;12232
76;12;01;04;233;Saint-Juéry;293;3;296;12233
76;12;03;13;234;Sainte-Juliette-sur-Viaur;613;8;621;12234
76;12;03;05;235;Saint-Just-sur-Viaur;206;7;213;12235
76;12;01;15;236;Saint-Laurent-de-Lévézou;154;5;159;12236
76;12;02;20;237;Saint-Laurent-d'Olt;645;81;726;12237
76;12;01;15;238;Saint-Léons;416;14;430;12238
76;12;02;20;239;Saint-Martin-de-Lenne;315;13;328;12239
76;12;03;07;240;Saint-Parthem;403;10;413;12240
76;12;02;14;241;Sainte-Radegonde;1751;65;1816;12241
76;12;03;23;242;Saint-Rémy;306;15;321;12242
76;12;01;19;243;Saint-Rome-de-Cernon;948;13;961;12243
76;12;01;15;244;Saint-Rome-de-Tarn;883;10;893;12244
76;12;03;07;246;Saint-Santin;538;15;553;12246
76;12;02;20;247;Saint-Saturnin-de-Lenne;284;7;291;12247
76;12;01;04;248;Saint-Sernin-sur-Rance;611;104;715;12248
76;12;01;04;249;Saint-Sever-du-Moustier;194;8;202;12249
76;12;02;01;250;Saint-Symphorien-de-Thénières;205;2;207;12250
76;12;01;15;251;Saint-Victor-et-Melvieu;336;7;343;12251
76;12;03;08;252;Salles-Courbatiès;418;9;427;12252
76;12;01;15;253;Salles-Curan;1013;30;1043;12253
76;12;02;21;254;Salles-la-Source;2265;75;2340;12254
76;12;01;13;255;Salmiech;766;28;794;12255
76;12;03;23;256;Salvagnac-Cajarc;371;10;381;12256
76;12;03;08;257;Causse-et-Diège;788;18;806;12257
76;12;03;02;258;La Salvetat-Peyralès;982;15;997;12258
76;12;03;02;259;Sanvensa;648;17;665;12259
76;12;01;04;260;Sauclières;171;2;173;12260
76;12;03;23;261;Saujac;122;4;126;12261
76;12;03;05;262;Sauveterre-de-Rouergue;711;14;725;12262
76;12;03;23;263;Savignac;732;23;755;12263
76;12;02;03;264;Sébazac-Concourès;3256;92;3348;12264
76;12;02;10;265;Sébrazac;521;14;535;12265
76;12;01;15;266;Ségur;548;5;553;12266
76;12;01;13;267;La Selve;627;12;639;12267
76;12;02;07;268;Sénergues;421;18;439;12268
76;12;01;04;269;La Serre;126;3;129;12269
76;12;02;20;270;Sévérac d'Aveyron;4069;122;4191;12270
76;12;03;08;272;Sonnac;519;13;532;12272
76;12;02;01;273;Soulages-Bonneval;291;8;299;12273
76;12;01;04;274;Sylvanès;112;2;114;12274
76;12;01;04;275;Tauriac-de-Camarès;36;1;37;12275
76;12;03;05;276;Tauriac-de-Naucelle;362;13;375;12276
76;12;02;01;277;Taussac;530;4;534;12277
76;12;03;02;278;Tayrac;183;2;185;12278
76;12;02;01;280;Thérondels;407;6;413;12280
76;12;03;23;281;Toulonjac;740;22;762;12281
76;12;01;19;282;Tournemire;425;8;433;12282
76;12;01;15;283;Trémouilles;485;15;500;12283
76;12;01;15;284;Le Truel;345;1;346;12284
76;12;01;19;286;Vabres-l'Abbaye;1206;31;1237;12286
76;12;03;22;287;Vailhourles;636;22;658;12287
76;12;02;21;288;Valady;1593;38;1631;12288
76;12;03;08;289;Valzergues;206;8;214;12289
76;12;03;23;290;Vaureilles;489;10;499;12290
76;12;01;20;291;Verrières;403;9;412;12291
76;12;01;19;292;Versols-et-Lapeyre;417;14;431;12292
76;12;01;20;293;Veyreau;137;1;138;12293
76;12;01;15;294;Vézins-de-Lévézou;656;18;674;12294
76;12;01;04;295;Viala-du-Pas-de-Jaux;98;2;100;12295
76;12;01;20;296;Viala-du-Tarn;529;13;542;12296
76;12;01;15;297;Le Vibal;510;19;529;12297
76;12;02;10;298;Villecomtal;415;8;423;12298
76;12;01;15;299;Villefranche-de-Panat;692;26;718;12299
76;12;03;22;300;Villefranche-de-Rouergue;11602;551;12153;12300
76;12;03;23;301;Villeneuve;1988;46;2034;12301
76;12;02;09;303;Vimenet;249;5;254;12303
76;12;03;07;305;Viviez;1243;22;1265;12305
76;12;01;15;307;Curan;295;15;310;12307
93;13;01;97;001;Aix-en-Provence;145133;3203;148336;13001
93;13;03;03;002;Allauch;21372;225;21597;13002
93;13;01;25;003;Alleins;2626;54;2680;13003
93;13;02;04;004;Arles;50454;789;51243;13004
93;13;03;05;005;Aubagne;47535;451;47986;13005
93;13;02;26;006;Aureille;1545;26;1571;13006
93;13;03;03;007;Auriol;12922;162;13084;13007
93;13;01;25;008;Aurons;563;16;579;13008
93;13;01;25;009;La Barben;828;33;861;13009
93;13;02;07;010;Barbentane;4192;162;4354;13010
93;13;02;26;011;Les Baux-de-Provence;342;7;349;13011
93;13;01;28;012;Beaurecueil;593;55;648;13012
93;13;03;03;013;Belcodène;1916;35;1951;13013
93;13;04;06;014;Berre-l'Etang;13660;77;13737;13014
93;13;01;29;015;Bouc-Bel-Air;14838;305;15143;13015
93;13;03;03;016;La Bouilladisse;6270;83;6353;13016
93;13;02;07;017;Boulbon;1509;18;1527;13017
93;13;02;07;018;Cabannes;4439;59;4498;13018
93;13;01;29;019;Cabriès;9918;324;10242;13019
93;13;03;03;020;Cadolive;2168;44;2212;13020
93;13;04;11;021;Carry-le-Rouet;5690;127;5817;13021
93;13;03;08;022;Cassis;6905;108;7013;13022
93;13;03;08;023;Ceyreste;4729;109;4838;13023
93;13;01;25;024;Charleval;2669;36;2705;13024
93;13;01;28;025;Châteauneuf-le-Rouge;2380;76;2456;13025
93;13;04;11;026;Châteauneuf-les-Martigues;17606;61;17667;13026
93;13;02;07;027;Châteaurenard;16063;252;16315;13027
93;13;03;08;028;La Ciotat;35993;381;36374;13028
93;13;04;06;029;Cornillon-Confoux;1437;23;1460;13029
93;13;03;08;030;Cuges-les-Pins;5244;55;5299;13030
93;13;03;03;031;La Destrousse;3768;44;3812;13031
93;13;01;25;032;Eguilles;8030;143;8173;13032
93;13;04;11;033;Ensuès-la-Redonne;5783;99;5882;13033
93;13;02;26;034;Eygalières;1740;28;1768;13034
93;13;01;26;035;Eyguières;6844;161;7005;13035
93;13;02;07;036;Eyragues;4496;128;4624;13036
93;13;01;06;037;La Fare-les-Oliviers;8744;104;8848;13037
93;13;02;26;038;Fontvieille;3544;71;3615;13038
93;13;04;10;039;Fos-sur-Mer;15687;183;15870;13039
93;13;01;28;040;Fuveau;10161;188;10349;13040
93;13;01;09;041;Gardanne;21521;338;21859;13041
93;13;03;08;042;Gémenos;6635;128;6763;13042
93;13;04;11;043;Gignac-la-Nerthe;9887;90;9977;13043
93;13;04;27;044;Grans;5196;84;5280;13044
93;13;02;07;045;Graveson;4856;73;4929;13045
93;13;01;03;046;Gréasque;4271;78;4349;13046
93;13;04;10;047;Istres;43626;657;44283;13047
93;13;01;28;048;Jouques;4406;98;4504;13048
93;13;01;26;049;Lamanon;2037;41;2078;13049
93;13;01;25;050;Lambesc;9909;266;10175;13050
93;13;01;06;051;Lançon-Provence;8941;120;9061;13051
93;13;02;07;052;Maillane;2667;33;2700;13052
93;13;01;25;053;Mallemort;6134;156;6290;13053
93;13;04;11;054;Marignane;32384;228;32612;13054
93;13;04;24;056;Martigues;48574;516;49090;13056
93;13;02;26;057;Mas-Blanc-des-Alpilles;517;11;528;13057
93;13;02;26;058;Maussane-les-Alpilles;2362;50;2412;13058
93;13;01;28;059;Meyrargues;3855;53;3908;13059
93;13;01;28;060;Meyreuil;5821;91;5912;13060
93;13;02;07;061;Saint-Pierre-de-Mézoargues;215;5;220;13061
93;13;01;09;062;Mimet;4213;74;4287;13062
93;13;04;27;063;Miramas;26428;400;26828;13063
93;13;02;07;064;Mollégès;2656;29;2685;13064
93;13;02;26;065;Mouriès;3410;49;3459;13065
93;13;02;07;066;Noves;5847;68;5915;13066
93;13;02;26;067;Orgon;2821;34;2855;13067
93;13;02;26;068;Paradou;2110;36;2146;13068
93;13;01;25;069;Pélissanne;10487;267;10754;13069
93;13;03;05;070;La Penne-sur-Huveaune;6519;61;6580;13070
93;13;01;09;071;Les Pennes-Mirabeau;21623;287;21910;13071
93;13;01;28;072;Peynier;3540;94;3634;13072
93;13;03;03;073;Peypin;5598;78;5676;13073
93;13;01;28;074;Peyrolles-en-Provence;5134;89;5223;13074
93;13;03;03;075;Plan-de-Cuques;11649;103;11752;13075
93;13;02;07;076;Plan-d'Orgon;3515;49;3564;13076
93;13;04;24;077;Port-de-Bouc;16651;127;16778;13077
93;13;04;04;078;Port-Saint-Louis-du-Rhône;8424;80;8504;13078
93;13;01;28;079;Puyloubier;1783;103;1886;13079
93;13;01;28;080;Le Puy-Sainte-Réparade;5882;90;5972;13080
93;13;04;06;081;Rognac;12086;123;12209;13081
93;13;01;25;082;Rognes;4637;126;4763;13082
93;13;02;07;083;Rognonas;4058;58;4116;13083
93;13;01;25;084;La Roque-d'Anthéron;5426;120;5546;13084
93;13;03;08;085;Roquefort-la-Bédoule;6015;74;6089;13085
93;13;03;05;086;Roquevaire;8713;124;8837;13086
93;13;01;28;087;Rousset;4918;140;5058;13087
93;13;04;11;088;Le Rove;5145;48;5193;13088
93;13;02;07;089;Saint-Andiol;3346;51;3397;13089
93;13;01;28;090;Saint-Antonin-sur-Bayon;123;4;127;13090
93;13;01;25;091;Saint-Cannat;5638;114;5752;13091
93;13;04;06;092;Saint-Chamas;8591;129;8720;13092
93;13;01;25;093;Saint-Estève-Janson;379;8;387;13093
93;13;02;26;094;Saint-Etienne-du-Grès;2497;45;2542;13094
93;13;01;28;095;Saint-Marc-Jaumegarde;1236;68;1304;13095
93;13;02;04;096;Saintes-Maries-de-la-Mer;2144;21;2165;13096
93;13;02;27;097;Saint-Martin-de-Crau;13413;299;13712;13097
93;13;04;10;098;Saint-Mitre-les-Remparts;5820;110;5930;13098
93;13;01;28;099;Saint-Paul-lès-Durance;885;13;898;13099
93;13;02;26;100;Saint-Rémy-de-Provence;9769;223;9992;13100
93;13;03;03;101;Saint-Savournin;3443;59;3502;13101
93;13;04;29;102;Saint-Victoret;6631;52;6683;13102
93;13;01;99;103;Salon-de-Provence;45386;584;45970;13103
93;13;04;11;104;Sausset-les-Pins;7581;144;7725;13104
93;13;01;26;105;Sénas;6894;86;6980;13105
93;13;03;09;106;Septèmes-les-Vallons;11196;95;11291;13106
93;13;01;09;107;Simiane-Collongue;5808;122;5930;13107
93;13;02;07;108;Tarascon;15811;142;15953;13108
93;13;01;28;109;Le Tholonet;2271;56;2327;13109
93;13;01;28;110;Trets;10303;150;10453;13110
93;13;01;28;111;Vauvenargues;1007;20;1027;13111
93;13;01;06;112;Velaux;8582;151;8733;13112
93;13;01;28;113;Venelles;8400;184;8584;13113
93;13;01;06;114;Ventabren;5407;137;5544;13114
93;13;01;25;115;Vernègues;2028;40;2068;13115
93;13;02;07;116;Verquières;819;17;836;13116
93;13;04;29;117;Vitrolles;33333;368;33701;13117
93;13;01;06;118;Coudoux;3702;52;3754;13118
93;13;03;08;119;Carnoux-en-Provence;6498;84;6582;13119
93;13;03;12;201;Marseille 1er Arrondissement;39893;200;40093;13201
93;13;03;13;202;Marseille 2e Arrondissement;25217;58;25275;13202
93;13;03;98;203;Marseille 3e Arrondissement;51792;194;51986;13203
93;13;03;98;204;Marseille 4e Arrondissement;49296;303;49599;13204
93;13;03;98;205;Marseille 5e Arrondissement;46152;279;46431;13205
93;13;03;98;206;Marseille 6e Arrondissement;42135;406;42541;13206
93;13;03;23;207;Marseille 7e Arrondissement;34697;313;35010;13207
93;13;03;98;208;Marseille 8e Arrondissement;81436;1254;82690;13208
93;13;03;98;209;Marseille 9e Arrondissement;76633;654;77287;13209
93;13;03;98;210;Marseille 10e Arrondissement;58491;340;58831;13210
93;13;03;98;211;Marseille 11e Arrondissement;57278;443;57721;13211
93;13;03;98;212;Marseille 12e Arrondissement;61406;552;61958;13212
93;13;03;98;213;Marseille 13e Arrondissement;91358;717;92075;13213
93;13;03;98;214;Marseille 14e Arrondissement;61702;252;61954;13214
93;13;03;98;215;Marseille 15e Arrondissement;77243;299;77542;13215
93;13;03;14;216;Marseille 16e Arrondissement;16002;100;16102;13216
28;14;03;15;001;Ablon;1212;45;1257;14001
28;14;01;02;003;Agy;304;7;311;14003
28;14;02;24;005;Valambray;1723;38;1761;14005
28;14;02;12;006;Amayé-sur-Orne;1046;21;1067;14006
28;14;04;01;007;Amayé-sur-Seulles;231;4;235;14007
28;14;03;04;009;Amfreville;1356;19;1375;14009
28;14;04;01;011;Aurseulles;1894;38;1932;14011
28;14;03;04;012;Angerville;192;1;193;14012
28;14;02;11;014;Colomby-Anguerny;1206;34;1240;14014
28;14;02;11;015;Anisy;738;22;760;14015
28;14;03;04;016;Annebault;484;14;498;14016
28;14;01;02;019;Arganchy;219;3;222;14019
28;14;02;24;020;Argences;3795;30;3825;14020
28;14;01;11;021;Arromanches-les-Bains;473;11;484;14021
28;14;01;11;022;Asnelles;584;8;592;14022
28;14;01;23;023;Asnières-en-Bessin;68;1;69;14023
28;14;03;04;024;Auberville;591;12;603;14024
28;14;02;13;025;Aubigny;308;3;311;14025
28;14;01;03;026;Audrieu;1109;20;1129;14026
28;14;04;89;027;Les Monts d'Aunay;4595;67;4662;14027
28;14;02;06;030;Authie;1696;49;1745;14030
28;14;03;21;032;Les Authieux-sur-Calonne;275;11;286;14032
28;14;03;19;033;Auvillars;216;2;218;14033
28;14;02;12;034;Avenay;569;2;571;14034
28;14;01;23;035;Balleroy-sur-Drôme;1374;57;1431;14035
28;14;02;24;036;Banneville-la-Campagne;172;1;173;14036
28;14;04;01;037;Malherbe-sur-Ajon;565;13;578;14037
28;14;01;11;038;Banville;789;9;798;14038
28;14;02;22;039;Barbery;824;18;842;14039
28;14;01;02;040;Barbeville;189;3;192;14040
28;14;03;15;041;Barneville-la-Bertran;124;2;126;14041
28;14;02;12;042;Baron-sur-Odon;975;21;996;14042
28;14;02;13;043;Barou-en-Auge;70;0;70;14043
28;14;02;11;044;Basly;1073;18;1091;14044
28;14;03;04;045;Basseneville;252;2;254;14045
28;14;03;04;046;Bavent;1923;14;1937;14046
28;14;01;02;047;Bayeux;12682;329;13011;14047
28;14;01;11;049;Bazenville;139;2;141;14049
28;14;01;23;050;La Bazoque;181;2;183;14050
28;14;02;13;053;Beaumais;172;3;175;14053
28;14;04;25;054;Beaumesnil;200;3;203;14054
28;14;03;21;055;Beaumont-en-Auge;405;9;414;14055
28;14;02;24;057;Bellengreville;1477;8;1485;14057
28;14;03;21;059;Benerville-sur-Mer;414;32;446;14059
28;14;02;20;060;Bénouville;2042;26;2068;14060
28;14;04;10;061;Souleuvre en Bocage;8950;157;9107;14061
28;14;01;03;062;Bény-sur-Mer;447;7;454;14062
28;14;01;23;063;Bernesq;214;1;215;14063
28;14;02;13;064;Bernières-d'Ailly;224;7;231;14064
28;14;02;11;066;Bernières-sur-Mer;2274;35;2309;14066
28;14;02;20;068;Biéville-Beuville;3561;85;3646;14068
28;14;03;17;069;Beuvillers;1338;27;1365;14069
28;14;03;19;070;Beuvron-en-Auge;194;2;196;14070
28;14;02;20;076;Blainville-sur-Orne;5855;73;5928;14076
28;14;03;21;077;Blangy-le-Château;719;55;774;14077
28;14;01;23;078;Blay;370;4;374;14078
28;14;03;21;079;Blonville-sur-Mer;1553;35;1588;14079
28;14;02;22;080;Le Bô;124;5;129;14080
28;14;03;19;082;La Boissière;189;9;198;14082
28;14;03;19;083;Bonnebosq;666;15;681;14083
28;14;04;01;084;Bonnemaison;403;9;412;14084
28;14;03;21;085;Bonneville-la-Louvet;795;21;816;14085
28;14;03;21;086;Bonneville-sur-Touques;325;13;338;14086
28;14;02;13;087;BonnÅ“il;125;1;126;14087
28;14;02;13;088;Bons-Tassilly;406;7;413;14088
28;14;02;12;089;Bougy;394;9;403;14089
28;14;02;22;090;Boulon;736;6;742;14090
28;14;03;04;091;Bourgeauville;102;1;103;14091
28;14;02;12;092;Bourguébus;2186;24;2210;14092
28;14;03;04;093;Branville;198;5;203;14093
28;14;04;01;096;Brémoy;226;6;232;14096
28;14;02;22;097;Bretteville-le-Rabet;305;4;309;14097
28;14;02;03;098;Thue et Mue;6120;100;6220;14098
28;14;02;22;100;Bretteville-sur-Laize;1913;24;1937;14100
28;14;02;05;101;Bretteville-sur-Odon;4005;72;4077;14101
28;14;03;21;102;Le Breuil-en-Auge;1012;23;1035;14102
28;14;01;23;103;Le Breuil-en-Bessin;408;7;415;14103
28;14;03;21;104;Le Brévedent;166;4;170;14104
28;14;03;04;106;Bréville-les-Monts;660;6;666;14106
28;14;01;23;107;Bricqueville;164;0;164;14107
28;14;03;04;110;Brucourt;125;2;127;14110
28;14;01;03;111;Bucéels;438;6;444;14111
28;14;02;22;116;Le Bû-sur-Rouvres;109;5;114;14116
28;14;03;04;117;Cabourg;3558;31;3589;14117
28;14;02;99;118;Caen;106230;2174;108404;14118
28;14;02;24;119;Cagny;1966;21;1987;14119
28;14;04;01;120;Cahagnes;1396;23;1419;14120
28;14;01;23;121;Cahagnolles;252;1;253;14121
28;14;02;12;122;La Caine;158;1;159;14122
28;14;02;03;123;Cairon;2021;48;2069;14123
28;14;01;23;124;La Cambe;546;10;556;14124
28;14;02;20;125;Cambes-en-Plaine;1753;49;1802;14125
28;14;03;19;126;Cambremer;1334;36;1370;14126
28;14;04;25;127;Campagnolles;548;4;552;14127
28;14;01;02;130;Campigny;186;1;187;14130
28;14;03;21;131;Canapville;228;4;232;14131
28;14;01;23;132;Canchy;204;0;204;14132
28;14;02;24;134;Canteloup;186;5;191;14134
28;14;01;03;135;Carcagny;281;2;283;14135
28;14;01;23;136;Cardonville;101;0;101;14136
28;14;02;06;137;Carpiquet;2886;25;2911;14137
28;14;01;23;138;Cartigny-l'Epinay;292;6;298;14138
28;14;01;23;140;Castillon;349;6;355;14140
28;14;03;19;141;Castillon-en-Auge;163;2;165;14141
28;14;04;01;143;Caumont-sur-Aure;2372;25;2397;14143
28;14;02;22;145;Cauvicourt;525;4;529;14145
28;14;02;22;146;Cauville;169;4;173;14146
28;14;03;18;147;Cernay;140;1;141;14147
28;14;02;24;149;Cesny-aux-Vignes;422;13;435;14149
28;14;02;22;150;Cesny-les-Sources;1338;27;1365;14150
28;14;01;02;159;Chouain;220;13;233;14159
28;14;02;22;160;Cintheaux;188;6;194;14160
28;14;03;21;161;Clarbec;342;16;358;14161
28;14;02;22;162;Clécy;1305;15;1320;14162
28;14;02;24;163;Cléville;382;3;385;14163
28;14;01;23;165;Colleville-sur-Mer;174;4;178;14165
28;14;02;20;166;Colleville-Montgomery;2555;44;2599;14166
28;14;02;14;167;Colombelles;6976;52;7028;14167
28;14;01;23;168;Colombières;207;5;212;14168
28;14;01;03;169;Colombiers-sur-Seulles;159;0;159;14169
28;14;02;22;171;Combray;144;1;145;14171
28;14;01;02;172;Commes;432;10;442;14172
28;14;02;19;173;Condé-sur-Ifs;440;14;454;14173
28;14;04;10;174;Condé-en-Normandie;6452;274;6726;14174
28;14;01;02;175;Condé-sur-Seulles;292;5;297;14175
28;14;03;21;177;Coquainvilliers;848;17;865;14177
28;14;03;17;179;Cordebugle;164;5;169;14179
28;14;02;13;180;Cordey;156;3;159;14180
28;14;02;16;181;Cormelles-le-Royal;4957;45;5002;14181
28;14;01;23;182;Cormolain;404;6;410;14182
28;14;02;22;183;Cossesseville;103;1;104;14183
28;14;01;02;184;Cottun;229;0;229;14184
28;14;02;13;190;Courcy;128;5;133;14190
28;14;02;11;191;Courseulles-sur-Mer;4196;54;4250;14191
28;14;03;17;193;Courtonne-la-Meurdrac;655;20;675;14193
28;14;03;17;194;Courtonne-les-Deux-Eglises;648;10;658;14194
28;14;04;01;195;Courvaudon;261;1;262;14195
28;14;01;11;196;Crépon;208;6;214;14196
28;14;02;11;197;Cresserons;1116;27;1143;14197
28;14;03;04;198;Cresseveuille;255;9;264;14198
28;14;01;03;200;Creully sur Seulles;2261;79;2340;14200
28;14;03;15;202;CricquebÅ“uf;267;6;273;14202
28;14;03;04;203;Cricqueville-en-Auge;192;7;199;14203
28;14;01;23;204;Cricqueville-en-Bessin;179;2;181;14204
28;14;01;03;205;Cristot;217;6;223;14205
28;14;02;13;206;Crocy;298;0;298;14206
28;14;02;22;207;Croisilles;646;9;655;14207
28;14;01;23;209;Crouay;512;10;522;14209
28;14;02;22;211;Culey-le-Patry;360;4;364;14211
28;14;01;02;214;Cussy;190;2;192;14214
28;14;02;24;215;Cuverville;2259;34;2293;14215
28;14;02;13;216;Damblainville;238;3;241;14216
28;14;03;04;218;Danestal;403;6;409;14218
28;14;03;15;220;Deauville;3565;60;3625;14220
28;14;02;24;221;Démouville;3117;45;3162;14221
28;14;02;13;223;Le Détroit;87;2;89;14223
28;14;01;23;224;Deux-Jumeaux;49;2;51;14224
28;14;03;04;225;Dives-sur-Mer;5276;169;5445;14225
28;14;02;22;226;Donnay;299;2;301;14226
28;14;03;04;227;Douville-en-Auge;210;6;216;14227
28;14;02;11;228;Douvres-la-Délivrande;4973;204;5177;14228
28;14;03;04;229;Dozulé;2293;22;2315;14229
28;14;03;19;230;Drubec;116;1;117;14230
28;14;03;19;231;Beaufour-Druval;446;12;458;14231
28;14;01;03;232;Ducy-Sainte-Marguerite;168;3;171;14232
28;14;01;02;236;Ellon;585;7;592;14236
28;14;02;24;237;Emiéville;618;7;625;14237
28;14;03;21;238;Englesqueville-en-Auge;109;2;111;14238
28;14;01;23;239;Englesqueville-la-Percée;107;0;107;14239
28;14;02;13;240;Epaney;511;12;523;14240
28;14;04;01;241;Epinay-sur-Odon;621;15;636;14241
28;14;02;07;242;Epron;1623;24;1647;14242
28;14;03;15;243;Equemauville;1587;6;1593;14243
28;14;02;13;244;Eraines;312;11;323;14244
28;14;02;13;245;Ernes;320;11;331;14245
28;14;03;24;246;Escoville;807;6;813;14246
28;14;02;22;248;Espins;250;5;255;14248
28;14;02;12;249;Esquay-Notre-Dame;1431;10;1441;14249
28;14;01;02;250;Esquay-sur-Seulles;283;6;289;14250
28;14;02;22;251;Esson;539;6;545;14251
28;14;02;22;252;Estrées-la-Campagne;260;3;263;14252
28;14;02;09;254;Eterville;1653;27;1680;14254
28;14;01;23;256;Etréham;336;5;341;14256
28;14;02;12;257;Evrecy;2013;27;2040;14257
28;14;02;13;258;Falaise;7968;250;8218;14258
28;14;03;21;260;Fauguernon;245;7;252;14260
28;14;03;21;261;Le Faulq;338;7;345;14261
28;14;02;12;266;Feuguerolles-Bully;1439;23;1462;14266
28;14;03;21;269;Fierville-les-Parcs;226;4;230;14269
28;14;03;21;270;Firfol;398;16;414;14270
28;14;02;09;271;Fleury-sur-Orne;4938;69;5007;14271
28;14;01;23;272;La Folie;96;2;98;14272
28;14;03;18;273;La Folletière-Abenon;136;1;137;14273
28;14;02;12;274;Fontaine-Etoupefour;2617;64;2681;14274
28;14;01;03;275;Fontaine-Henry;464;6;470;14275
28;14;02;13;276;Fontaine-le-Pin;355;4;359;14276
28;14;02;12;277;Fontenay-le-Marmion;1941;13;1954;14277
28;14;01;03;278;Fontenay-le-Pesnel;1199;18;1217;14278
28;14;03;19;280;Formentin;256;9;265;14280
28;14;01;23;281;Formigny La Bataille;735;14;749;14281
28;14;01;23;282;Foulognes;208;6;214;14282
28;14;02;13;283;Fourches;224;7;231;14283
28;14;02;13;284;Fourneaux-le-Val;156;4;160;14284
28;14;03;19;285;Le Fournet;71;2;73;14285
28;14;03;15;286;Fourneville;484;20;504;14286
28;14;02;24;287;Frénouville;1970;14;1984;14287
28;14;02;03;288;Le Fresne-Camilly;933;24;957;14288
28;14;02;13;289;Fresné-la-Mère;584;13;597;14289
28;14;02;22;290;Fresney-le-Puceux;812;8;820;14290
28;14;02;22;291;Fresney-le-Vieux;289;4;293;14291
28;14;03;21;293;Fumichon;274;6;280;14293
28;14;02;12;297;Gavrus;584;7;591;14297
28;14;01;23;298;Géfosse-Fontenay;135;3;138;14298
28;14;03;15;299;Genneville;835;18;853;14299
28;14;03;19;300;Gerrots;52;0;52;14300
28;14;02;16;301;Giberville;4916;47;4963;14301
28;14;03;21;302;Glanville;166;14;180;14302
28;14;03;17;303;Glos;919;20;939;14303
28;14;03;15;304;Gonneville-sur-Honfleur;882;35;917;14304
28;14;03;04;305;Gonneville-sur-Mer;678;13;691;14305
28;14;03;04;306;Gonneville-en-Auge;390;5;395;14306
28;14;03;04;308;Goustranville;268;0;268;14308
28;14;02;22;309;Gouvix;840;4;844;14309
28;14;02;22;310;Grainville-Langannerie;706;7;713;14310
28;14;02;12;311;Grainville-sur-Odon;1045;9;1054;14311
28;14;01;23;312;Grandcamp-Maisy;1536;24;1560;14312
28;14;03;04;316;Grangues;265;3;268;14316
28;14;01;11;318;Graye-sur-Mer;728;7;735;14318
28;14;02;12;319;Grentheville;973;8;981;14319
28;14;02;22;320;Grimbosq;283;7;290;14320
28;14;01;02;322;Guéron;245;5;250;14322
28;14;02;20;325;Hermanville-sur-Mer;3110;42;3152;14325
28;14;03;21;326;Hermival-les-Vaux;808;39;847;14326
28;14;02;14;327;Hérouville-Saint-Clair;22555;275;22830;14327
28;14;03;04;328;Hérouvillette;1345;9;1354;14328
28;14;03;04;329;Heuland;109;4;113;14329
28;14;02;13;332;La Hoguette;667;11;678;14332
28;14;03;15;333;Honfleur;6733;200;6933;14333
28;14;03;17;334;L'Hôtellerie;316;6;322;14334
28;14;03;19;335;Hotot-en-Auge;300;3;303;14335
28;14;01;01;336;Hottot-les-Bagues;476;5;481;14336
28;14;03;19;337;La Houblonnière;329;10;339;14337
28;14;03;04;338;Houlgate;1711;37;1748;14338
28;14;02;16;341;Ifs;11696;193;11889;14341
28;14;01;23;342;Isigny-sur-Mer;3610;43;3653;14342
28;14;02;13;343;Les Isles-Bardel;66;0;66;14343
28;14;02;24;344;Janville;379;9;388;14344
28;14;02;13;345;Jort;301;2;303;14345
28;14;01;02;346;Juaye-Mondaye;679;14;693;14346
28;14;04;01;347;Dialan sur Chaîne;1041;12;1053;14347
28;14;01;03;348;Juvigny-sur-Seulles;81;1;82;14348
28;14;02;12;349;Laize-Clinchamps;2116;21;2137;14349
28;14;04;25;352;Landelles-et-Coupigny;841;20;861;14352
28;14;04;01;353;Landes-sur-Ajon;451;5;456;14353
28;14;02;11;354;Langrune-sur-Mer;1934;48;1982;14354
28;14;01;03;355;Ponts sur Seulles;1191;20;1211;14355
28;14;04;10;357;Terres de Druance;910;22;932;14357
28;14;03;19;358;Léaupartie;89;2;91;14358
28;14;02;13;360;Leffard;216;2;218;14360
28;14;03;19;362;Lessard-et-le-Chêne;160;0;160;14362
28;14;01;01;364;Lingèvres;465;13;478;14364
28;14;02;20;365;Lion-sur-Mer;2536;40;2576;14365
28;14;03;17;366;Lisieux;20038;654;20692;14366
28;14;01;23;367;Lison;437;5;442;14367
28;14;03;18;368;Lisores;262;11;273;14368
28;14;01;23;369;Litteau;288;3;291;14369
28;14;01;23;370;Le Molay-Littry;3016;39;3055;14370
28;14;03;18;371;Livarot-Pays-d'Auge;6220;110;6330;14371
28;14;04;01;374;Les Loges;142;2;144;14374
28;14;02;13;375;Les Loges-Saulces;166;3;169;14375
28;14;01;02;377;Longues-sur-Mer;592;9;601;14377
28;14;01;23;378;Longueville;274;9;283;14378
28;14;04;01;379;Longvillers;364;5;369;14379
28;14;01;03;380;Loucelles;186;5;191;14380
28;14;02;13;381;Louvagny;61;2;63;14381
28;14;02;09;383;Louvigny;2683;38;2721;14383
28;14;02;11;384;Luc-sur-Mer;3213;52;3265;14384
28;14;01;02;385;Magny-en-Bessin;164;9;173;14385
28;14;04;01;389;Maisoncelles-Pelvey;263;9;272;14389
28;14;04;01;390;Maisoncelles-sur-Ajon;189;4;193;14390
28;14;01;23;391;Maisons;393;4;397;14391
28;14;02;12;393;Maizet;366;7;373;14393
28;14;02;13;394;Maizières;428;14;442;14394
28;14;02;12;396;Maltot;1024;15;1039;14396
28;14;01;23;397;Mandeville-en-Bessin;335;6;341;14397
28;14;03;19;398;Manerbe;547;16;563;14398
28;14;03;21;399;Manneville-la-Pipard;275;11;286;14399
28;14;01;02;400;Le Manoir;217;3;220;14400
28;14;01;02;401;Manvieux;132;6;138;14401
28;14;02;13;402;Le Marais-la-Chapelle;109;2;111;14402
28;14;03;17;403;Marolles;745;21;766;14403
28;14;02;22;404;Martainville;120;2;122;14404
28;14;02;13;405;Martigny-sur-l'Ante;325;7;332;14405
28;14;01;03;406;Moulins-en-Bessin;1116;27;1143;14406
28;14;02;20;407;Mathieu;2286;56;2342;14407
28;14;02;12;408;May-sur-Orne;2014;14;2028;14408
28;14;03;04;409;Merville-Franceville-Plage;2186;35;2221;14409
28;14;03;19;410;Méry-Bissières-en-Auge;1080;7;1087;14410
28;14;02;22;411;Meslay;309;6;315;14411
28;14;04;01;412;Le Mesnil-au-Grain;83;2;85;14412
28;14;03;19;419;Le Mesnil-Eudes;257;9;266;14419
28;14;03;17;421;Le Mesnil-Guillaume;607;6;613;14421
28;14;04;25;424;Le Mesnil-Robert;190;3;193;14424
28;14;03;19;425;Le Mesnil-Simon;164;6;170;14425
28;14;03;21;426;Le Mesnil-sur-Blangy;160;7;167;14426
28;14;02;13;427;Le Mesnil-Villement;294;3;297;14427
28;14;01;11;430;Meuvaines;137;3;140;14430
28;14;03;19;431;Mézidon Vallée d'Auge;9586;113;9699;14431
28;14;03;19;435;Les Monceaux;198;3;201;14435
28;14;01;02;436;Monceaux-en-Bessin;558;5;563;14436
28;14;02;16;437;Mondeville;9973;244;10217;14437
28;14;02;12;438;Mondrainville;545;10;555;14438
28;14;01;23;439;Monfréville;90;2;92;14439
28;14;01;23;445;Montfiquet;95;2;97;14445
28;14;02;12;446;Montigny;98;2;100;14446
28;14;03;19;448;Montreuil-en-Auge;64;0;64;14448
28;14;04;01;449;Monts-en-Bessin;408;5;413;14449
28;14;02;13;452;Morteaux-CoulibÅ“uf;626;10;636;14452
28;14;01;23;453;Mosles;352;7;359;14453
28;14;02;05;454;Mouen;1626;22;1648;14454
28;14;02;22;455;Moulines;285;2;287;14455
28;14;02;24;456;Moult-Chicheboville;3273;45;3318;14456
28;14;02;13;457;Les Moutiers-en-Auge;128;1;129;14457
28;14;02;22;458;Les Moutiers-en-Cinglais;533;58;591;14458
28;14;03;21;460;Moyaux;1353;31;1384;14460
28;14;02;22;461;Mutrécy;470;2;472;14461
28;14;01;02;465;Nonant;501;13;514;14465
28;14;03;21;466;Norolles;342;9;351;14466
28;14;02;13;467;Noron-l'Abbaye;320;7;327;14467
28;14;01;23;468;Noron-la-Poterie;363;6;369;14468
28;14;02;13;469;Norrey-en-Auge;91;3;94;14469
28;14;03;19;473;Notre-Dame-de-Livaye;112;3;115;14473
28;14;03;19;474;Notre-Dame-d'Estrées-Corbon;201;3;204;14474
28;14;04;01;475;Val d'Arry;2352;43;2395;14475
28;14;02;13;476;Olendon;178;3;181;14476
28;14;03;18;478;Orbec;1967;50;2017;14478
28;14;01;23;480;Osmanville;521;7;528;14480
28;14;02;24;482;Ouézy;238;2;240;14482
28;14;02;22;483;Ouffières;191;3;194;14483
28;14;03;21;484;Ouilly-du-Houley;245;4;249;14484
28;14;02;13;486;Ouilly-le-Tesson;570;9;579;14486
28;14;03;21;487;Ouilly-le-Vicomte;774;23;797;14487
28;14;02;20;488;Ouistreham;9344;118;9462;14488
28;14;04;01;491;Parfouru-sur-Odon;196;11;207;14491
28;14;03;15;492;Pennedepie;313;7;320;14492
28;14;03;04;494;Périers-en-Auge;129;7;136;14494
28;14;02;20;495;Périers-sur-le-Dan;548;11;559;14495
28;14;04;10;496;Périgny;57;4;61;14496
28;14;02;13;497;Perrières;333;7;340;14497
28;14;02;13;498;Pertheville-Ners;240;4;244;14498
28;14;03;04;499;Petiville;534;5;539;14499
28;14;03;21;500;Pierrefitte-en-Auge;159;6;165;14500
28;14;02;13;501;Pierrefitte-en-Cinglais;247;5;252;14501
28;14;02;13;502;Pierrepont;89;1;90;14502
28;14;03;21;504;Le Pin;813;21;834;14504
28;14;01;23;506;Planquery;246;3;249;14506
28;14;02;11;509;Plumetot;212;5;217;14509
28;14;02;22;510;La Pommeraye;55;3;58;14510
28;14;04;25;511;Pont-Bellanger;67;0;67;14511
28;14;04;10;512;Pontécoulant;73;0;73;14512
28;14;03;21;514;Pont-l'Evêque;4627;70;4697;14514
28;14;01;02;515;Port-en-Bessin-Huppain;1938;17;1955;14515
28;14;02;13;516;Potigny;2079;19;2098;14516
28;14;02;12;519;Préaux-Bocage;126;0;126;14519
28;14;03;19;520;Le Pré-d'Auge;867;23;890;14520
28;14;03;19;522;Prêtreville;391;7;398;14522
28;14;03;04;524;Putot-en-Auge;294;5;299;14524
28;14;03;19;527;Belle Vie en Auge;538;8;546;14527
28;14;03;15;528;Quetteville;391;5;396;14528
28;14;01;02;529;Ranchy;262;3;265;14529
28;14;03;04;530;Ranville;1909;27;1936;14530
28;14;02;13;531;Rapilly;48;0;48;14531
28;14;03;19;533;Repentigny;96;4;100;14533
28;14;03;21;534;Reux;391;6;397;14534
28;14;02;03;535;Reviers;554;12;566;14535
28;14;03;15;536;La Rivière-Saint-Sauveur;2547;43;2590;14536
28;14;02;12;538;Castine-en-Plaine;1650;31;1681;14538
28;14;03;21;540;Rocques;289;14;303;14540
28;14;03;19;541;La Roque-Baignard;121;1;122;14541
28;14;02;03;542;Rosel;535;11;546;14542
28;14;02;03;543;Rots;2448;71;2519;14543
28;14;02;13;546;Rouvres;222;2;224;14546
28;14;01;23;547;Rubercy;158;3;161;14547
28;14;03;19;550;Rumesnil;94;1;95;14550
28;14;01;02;552;Ryes;505;14;519;14552
28;14;02;12;554;Le Castelet;1659;10;1669;14554
28;14;03;21;555;Saint-André-d'Hébertot;452;6;458;14555
28;14;02;09;556;Saint-André-sur-Orne;1822;23;1845;14556
28;14;03;21;557;Saint-Arnoult;1132;12;1144;14557
28;14;02;20;558;Saint-Aubin-d'Arquenay;1093;15;1108;14558
28;14;04;25;559;Saint-Aubin-des-Bois;229;1;230;14559
28;14;02;11;562;Saint-Aubin-sur-Mer;2237;41;2278;14562
28;14;03;21;563;Saint-Benoît-d'Hébertot;430;9;439;14563
28;14;01;11;565;Saint-Côme-de-Fresné;259;4;263;14565
28;14;02;06;566;Saint-Contest;2525;52;2577;14566
28;14;01;11;569;Sainte-Croix-sur-Mer;236;6;242;14569
28;14;03;18;570;Valorbiquet;2507;44;2551;14570
28;14;03;18;571;Saint-Denis-de-Mailloc;305;5;310;14571
28;14;04;10;572;Saint-Denis-de-Méré;788;7;795;14572
28;14;03;19;574;Saint-Désir;1751;88;1839;14574
28;14;03;21;575;Saint-Etienne-la-Thillaye;389;25;414;14575
28;14;03;18;576;Val-de-Vie;524;13;537;14576
28;14;03;15;578;Saint-Gatien-des-Bois;1352;30;1382;14578
28;14;04;01;579;Seulline;1321;24;1345;14579
28;14;03;19;582;Saint-Germain-de-Livet;735;24;759;14582
28;14;01;23;586;Saint-Germain-du-Pert;164;6;170;14586
28;14;02;06;587;Saint-Germain-la-Blanche-Herbe;2298;42;2340;14587
28;14;02;13;588;Saint-Germain-Langot;330;3;333;14588
28;14;02;22;589;Saint-Germain-le-Vasson;950;9;959;14589
28;14;01;23;590;Sainte-Honorine-de-Ducy;133;1;134;14590
28;14;01;23;591;Aure sur Mer;732;10;742;14591
28;14;02;12;592;Sainte-Honorine-du-Fay;1340;22;1362;14592
28;14;03;21;593;Saint-Hymer;688;10;698;14593
28;14;03;19;595;Saint-Jean-de-Livet;237;5;242;14595
28;14;03;04;598;Saint-Jouin;230;4;234;14598
28;14;03;21;601;Saint-Julien-sur-Calonne;168;5;173;14601
28;14;02;22;602;Saint-Lambert;270;3;273;14602
28;14;02;22;603;Saint-Laurent-de-Condel;508;8;516;14603
28;14;01;23;605;Saint-Laurent-sur-Mer;265;8;273;14605
28;14;03;04;606;Saint-Léger-Dubosq;211;2;213;14606
28;14;04;01;607;Saint-Louet-sur-Seulles;145;1;146;14607
28;14;01;02;609;Saint-Loup-Hors;545;9;554;14609
28;14;02;03;610;Saint-Manvieu-Norrey;1955;115;2070;14610
28;14;01;23;613;Saint-Marcouf;94;1;95;14613
28;14;01;23;614;Sainte-Marguerite-d'Elle;779;13;792;14614
28;14;04;25;619;Sainte-Marie-Outre-l'Eau;124;2;126;14619
28;14;03;21;620;Saint-Martin-aux-Chartrains;422;9;431;14620
28;14;03;18;621;Saint-Martin-de-Bienfaite-la-Cressonnière;436;7;443;14621
28;14;01;23;622;Saint-Martin-de-Blagny;127;6;133;14622
28;14;02;12;623;Saint-Martin-de-Fontenay;2523;19;2542;14623
28;14;03;17;625;Saint-Martin-de-la-Lieue;772;14;786;14625
28;14;03;19;626;Saint-Martin-de-Mailloc;930;21;951;14626
28;14;02;13;627;Saint-Martin-de-Mieux;398;8;406;14627
28;14;01;02;630;Saint-Martin-des-Entrées;705;18;723;14630
28;14;02;22;635;Saint-Omer;187;2;189;14635
28;14;02;24;637;Saint-Ouen-du-Mesnil-Oger;204;3;207;14637
28;14;03;19;639;Saint-Ouen-le-Pin;257;9;266;14639
28;14;02;24;640;Saint-Pair;237;1;238;14640
28;14;01;23;643;Saint-Paul-du-Vernay;831;14;845;14643
28;14;03;21;644;Saint-Philbert-des-Champs;654;14;668;14644
28;14;03;21;645;Saint-Pierre-Azif;163;9;172;14645
28;14;02;13;646;Saint-Pierre-Canivet;439;9;448;14646
28;14;03;19;648;Saint-Pierre-des-Ifs;453;19;472;14648
28;14;02;13;649;Saint-Pierre-du-Bû;475;10;485;14649
28;14;04;01;650;Saint-Pierre-du-Fresne;190;4;194;14650
28;14;02;24;651;Saint-Pierre-du-Jonquet;261;2;263;14651
28;14;01;23;652;Saint-Pierre-du-Mont;79;2;81;14652
28;14;03;18;654;Saint-Pierre-en-Auge;7329;340;7669;14654
28;14;02;22;656;Saint-Rémy;988;16;1004;14656
28;14;03;24;657;Saint-Samson;313;4;317;14657
28;14;04;25;658;Noues de Sienne;4357;97;4454;14658
28;14;02;22;659;Saint-Sylvain;1428;24;1452;14659
28;14;03;04;660;Saint-Vaast-en-Auge;94;3;97;14660
28;14;01;03;661;Saint-Vaast-sur-Seulles;154;1;155;14661
28;14;01;02;663;Saint-Vigor-le-Grand;2490;52;2542;14663
28;14;01;23;664;Sallen;311;4;315;14664
28;14;03;04;665;Sallenelles;294;4;298;14665
28;14;02;24;666;Sannerville;1906;27;1933;14666
28;14;01;23;667;Saon;222;4;226;14667
28;14;01;23;668;Saonnet;318;3;321;14668
28;14;02;13;669;Sassy;207;2;209;14669
28;14;04;01;672;Val de Drôme;874;15;889;14672
28;14;02;22;674;Soignolles;128;3;131;14674
28;14;02;12;675;Soliers;2036;25;2061;14675
28;14;01;02;676;Sommervieu;993;23;1016;14676
28;14;02;13;677;Soulangy;254;6;260;14677
28;14;02;13;678;Soumont-Saint-Quentin;562;8;570;14678
28;14;01;02;679;Subles;666;21;687;14679
28;14;01;02;680;Sully;153;6;159;14680
28;14;01;23;681;Surrain;151;4;155;14681
28;14;03;21;682;Surville;452;13;465;14682
28;14;01;03;684;Tessel;253;3;256;14684
28;14;02;03;685;Thaon;1726;33;1759;14685
28;14;03;15;687;Le Theil-en-Auge;192;3;195;14687
28;14;02;22;689;Le Hom;3629;48;3677;14689
28;14;01;03;692;Tilly-sur-Seulles;1744;21;1765;14692
28;14;03;21;694;Le Torquesne;510;19;529;14694
28;14;03;24;698;Touffréville;391;1;392;14698
28;14;03;15;699;Touques;3731;67;3798;14699
28;14;01;23;700;Tour-en-Bessin;664;9;673;14700
28;14;03;21;701;Tourgéville;782;19;801;14701
28;14;01;23;705;Tournières;152;1;153;14705
28;14;03;21;706;Tourville-en-Auge;240;11;251;14706
28;14;02;05;707;Tourville-sur-Odon;1118;14;1132;14707
28;14;04;01;708;Tracy-Bocage;297;7;304;14708
28;14;01;02;709;Tracy-sur-Mer;346;7;353;14709
28;14;02;13;710;Tréprel;105;0;105;14710
28;14;01;23;711;Trévières;917;10;927;14711
28;14;02;24;712;Troarn;3459;91;3550;14712
28;14;02;22;713;Montillières-sur-Orne;577;11;588;14713
28;14;01;23;714;Le Tronquay;785;10;795;14714
28;14;03;15;715;Trouville-sur-Mer;4603;89;4692;14715
28;14;01;23;716;Trungy;210;3;213;14716
28;14;02;22;719;Urville;700;7;707;14719
28;14;02;13;720;Ussy;857;28;885;14720
28;14;02;12;721;Vacognes-Neuilly;648;9;657;14721
28;14;03;19;723;Valsemé;270;4;274;14723
28;14;03;04;724;Varaville;997;12;1009;14724
28;14;04;10;726;Valdallière;5755;117;5872;14726
28;14;01;02;728;Vaucelles;563;7;570;14728
28;14;03;21;731;Vauville;188;13;201;14731
28;14;01;02;732;Vaux-sur-Aure;307;11;318;14732
28;14;01;02;733;Vaux-sur-Seulles;312;9;321;14733
28;14;01;03;734;Vendes;333;8;341;14734
28;14;02;18;735;Vendeuvre;800;11;811;14735
28;14;02;13;737;Versainville;500;8;508;14737
28;14;02;05;738;Verson;3636;54;3690;14738
28;14;01;11;739;Ver-sur-Mer;1645;36;1681;14739
28;14;03;18;740;La Vespière-Friardel;1181;18;1199;14740
28;14;02;22;741;Le Vey;121;3;124;14741
28;14;02;13;742;Vicques;72;0;72;14742
28;14;03;19;743;Victot-Pontfol;88;3;91;14743
28;14;01;02;744;Vienne-en-Bessin;299;4;303;14744
28;14;01;23;745;Vierville-sur-Mer;230;4;234;14745
28;14;02;12;747;Vieux;678;8;686;14747
28;14;03;21;748;Vieux-Bourg;74;1;75;14748
28;14;02;13;751;Vignats;295;9;304;14751
28;14;04;01;752;Villers-Bocage;3160;37;3197;14752
28;14;02;13;753;Villers-Canivet;740;22;762;14753
28;14;03;21;754;Villers-sur-Mer;2543;58;2601;14754
28;14;03;15;755;Villerville;593;13;606;14755
28;14;04;10;756;La Villette;231;3;234;14756
28;14;02;06;758;Villons-les-Buissons;777;25;802;14758
28;14;02;13;759;Villy-lez-Falaise;269;10;279;14759
28;14;04;01;760;Villy-Bocage;742;6;748;14760
28;14;02;24;761;Vimont;817;15;832;14761
28;14;04;25;762;Vire Normandie;16590;891;17481;14762
28;14;02;13;764;Pont-d'Ouilly;975;16;991;14764
84;15;03;07;001;Allanche;799;9;808;15001
84;15;03;09;002;Alleuze;223;4;227;15002
84;15;02;05;003;Ally;599;12;611;15003
84;15;03;11;004;Andelat;472;9;481;15004
84;15;03;09;005;Anglards-de-Saint-Flour;350;16;366;15005
84;15;02;05;006;Anglards-de-Salers;731;28;759;15006
84;15;03;09;007;Anterrieux;121;7;128;15007
84;15;02;15;008;Antignac;285;1;286;15008
84;15;02;10;009;Apchon;186;6;192;15009
84;15;02;15;010;Arches;190;3;193;15010
84;15;01;13;011;Arnac;182;3;185;15011
84;15;01;01;012;Arpajon-sur-Cère;6279;192;6471;15012
84;15;03;11;013;Auriac-l'Eglise;147;0;147;15013
84;15;01;98;014;Aurillac;25593;1283;26876;15014
84;15;02;10;015;Auzers;167;4;171;15015
84;15;01;13;016;Ayrens;629;14;643;15016
84;15;01;14;017;Badailhac;145;6;151;15017
84;15;02;05;018;Barriac-les-Bosquets;132;1;133;15018
84;15;02;15;019;Bassignac;235;4;239;15019
84;15;02;15;020;Beaulieu;97;4;101;15020
84;15;01;06;021;Boisset;634;16;650;15021
84;15;03;11;022;Bonnac;163;6;169;15022
84;15;02;05;024;Brageac;76;0;76;15024
84;15;03;07;025;Albepierre-Bredons;240;7;247;15025
84;15;03;12;026;Brezons;183;1;184;15026
84;15;01;06;027;Puycapel;745;14;759;15027
84;15;01;14;028;Carlat;356;9;365;15028
84;15;01;01;029;Cassaniouze;507;16;523;15029
84;15;01;13;030;Cayrols;294;7;301;15030
84;15;03;09;032;Celoux;60;3;63;15032
84;15;03;12;033;Cézens;215;4;219;15033
84;15;03;09;034;Chaliers;145;6;151;15034
84;15;02;05;036;Chalvignac;470;8;478;15036
84;15;02;15;037;Champagnac;1056;24;1080;15037
84;15;02;15;038;Champs-sur-Tarentaine-Marchal;1030;25;1055;15038
84;15;03;10;040;Chanterelle;98;7;105;15040
84;15;03;07;041;La Chapelle-d'Alagnon;252;5;257;15041
84;15;03;11;042;La Chapelle-Laurent;254;4;258;15042
84;15;03;07;043;Charmensac;87;2;89;15043
84;15;03;09;045;Chaudes-Aigues;841;11;852;15045
84;15;02;05;046;Chaussenac;218;3;221;15046
84;15;03;09;048;Chazelles;31;1;32;15048
84;15;03;07;049;Cheylade;221;5;226;15049
84;15;03;07;050;Le Claux;170;2;172;15050
84;15;03;09;051;Clavières;209;5;214;15051
84;15;02;10;052;Collandres;156;12;168;15052
84;15;03;11;053;Coltines;439;10;449;15053
84;15;03;10;054;Condat;989;24;1013;15054
84;15;03;11;055;Coren;442;12;454;15055
84;15;01;08;056;Crandelles;856;20;876;15056
84;15;01;13;057;Cros-de-Montvert;189;4;193;15057
84;15;01;14;058;Cros-de-Ronesque;147;0;147;15058
84;15;03;12;059;Cussac;121;7;128;15059
84;15;03;09;060;Deux-Verges;51;1;52;15060
84;15;03;07;061;Dienne;272;4;276;15061
84;15;02;05;063;Drugeac;332;14;346;15063
84;15;02;05;064;Escorailles;83;1;84;15064
84;15;03;09;065;Espinasse;79;1;80;15065
84;15;02;10;066;Le Falgoux;117;2;119;15066
84;15;02;05;067;Le Fau;28;1;29;15067
84;15;03;11;069;Ferrières-Saint-Mary;248;2;250;15069
84;15;02;05;070;Fontanges;200;3;203;15070
84;15;01;08;072;Freix-Anglards;222;6;228;15072
84;15;03;09;073;Fridefont;92;2;94;15073
84;15;01;14;074;Giou-de-Mamou;763;21;784;15074
84;15;01;08;075;Girgols;74;4;78;15075
84;15;01;13;076;Glénat;171;4;175;15076
84;15;03;12;077;Gourdièges;61;0;61;15077
84;15;03;09;078;Jabrun;155;2;157;15078
84;15;02;15;079;Jaleyrac;372;9;381;15079
84;15;03;07;080;Joursac;147;4;151;15080
84;15;01;14;081;Jou-sous-Monjou;98;2;100;15081
84;15;01;01;082;Junhac;297;11;308;15082
84;15;01;08;083;Jussac;2022;67;2089;15083
84;15;01;01;084;Labesserette;291;9;300;15084
84;15;01;14;085;Labrousse;496;12;508;15085
84;15;03;12;086;Lacapelle-Barrès;58;2;60;15086
84;15;01;01;087;Lacapelle-del-Fraisse;360;10;370;15087
84;15;01;13;088;Lacapelle-Viescamp;512;15;527;15088
84;15;01;01;089;Ladinhac;449;8;457;15089
84;15;01;01;090;Lafeuillade-en-Vézie;591;15;606;15090
84;15;03;07;091;Landeyrat;90;5;95;15091
84;15;02;15;092;Lanobre;1405;41;1446;15092
84;15;01;01;093;Lapeyrugue;99;3;102;15093
84;15;01;13;094;Laroquebrou;829;16;845;15094
84;15;01;08;095;Laroquevieille;355;3;358;15095
84;15;01;14;096;Lascelle;286;7;293;15096
84;15;03;11;097;Lastic;111;5;116;15097
84;15;03;11;098;Laurie;93;0;93;15098
84;15;03;07;100;Laveissenet;131;2;133;15100
84;15;03;07;101;Laveissière;517;14;531;15101
84;15;03;07;102;Lavigerie;107;0;107;15102
84;15;01;01;103;Leucamp;237;6;243;15103
84;15;01;06;104;Leynhac;345;9;354;15104
84;15;03;11;105;Leyvaux;35;3;38;15105
84;15;03;09;106;Lieutadès;156;2;158;15106
84;15;03;09;107;Lorcières;171;4;175;15107
84;15;03;09;108;Val d'Arcomie;990;23;1013;15108
84;15;03;10;110;Lugarde;130;6;136;15110
84;15;02;15;111;Madic;208;7;215;15111
84;15;03;12;112;Malbo;92;4;96;15112
84;15;01;14;113;Mandailles-Saint-Julien;183;4;187;15113
84;15;03;10;114;Marcenat;517;7;524;15114
84;15;03;10;116;Marchastel;154;11;165;15116
84;15;01;06;117;Marcolès;593;68;661;15117
84;15;01;08;118;Marmanhac;726;31;757;15118
84;15;03;11;119;Massiac;1797;66;1863;15119
84;15;02;05;120;Mauriac;3498;218;3716;15120
84;15;03;09;121;Maurines;108;1;109;15121
84;15;01;06;122;Maurs;2111;60;2171;15122
84;15;02;10;123;Méallet;164;2;166;15123
84;15;02;10;124;Menet;532;23;555;15124
84;15;03;11;125;Mentières;128;3;131;15125
84;15;03;11;126;Molèdes;81;2;83;15126
84;15;03;11;127;Molompize;281;3;284;15127
84;15;02;15;128;La Monselie;120;3;123;15128
84;15;03;10;129;Montboudif;174;6;180;15129
84;15;03;11;130;Montchamp;140;4;144;15130
84;15;02;15;131;Le Monteil;286;12;298;15131
84;15;03;10;132;Montgreleix;45;0;45;15132
84;15;01;06;133;Montmurat;135;1;136;15133
84;15;01;01;134;Montsalvy;815;12;827;15134
84;15;01;13;135;Montvert;115;6;121;15135
84;15;02;10;137;Moussages;267;7;274;15137
84;15;03;07;138;Murat;1845;99;1944;15138
84;15;03;12;139;Narnhac;68;0;68;15139
84;15;01;08;140;Naucelles;2113;58;2171;15140
84;15;03;07;141;Neussargues en Pinatelle;1804;30;1834;15141
84;15;03;09;142;Neuvéglise-sur-Truyère;1735;40;1775;15142
84;15;01;13;143;Nieudan;102;1;103;15143
84;15;01;13;144;Omps;330;10;340;15144
84;15;01;14;146;Pailherols;126;5;131;15146
84;15;01;13;147;Parlan;450;9;459;15147
84;15;03;12;148;Paulhac;432;11;443;15148
84;15;03;12;149;Paulhenc;257;3;260;15149
84;15;03;07;151;Peyrusse;151;0;151;15151
84;15;03;12;152;Pierrefort;898;18;916;15152
84;15;02;05;153;Pleaux;1463;36;1499;15153
84;15;01;14;154;Polminhac;1188;24;1212;15154
84;15;03;07;155;Pradiers;87;2;89;15155
84;15;01;01;156;Prunet;685;15;700;15156
84;15;01;06;157;Quézac;351;43;394;15157
84;15;03;09;158;Rageade;103;2;105;15158
84;15;01;14;159;Raulhac;269;8;277;15159
84;15;01;08;160;Reilhac;1094;22;1116;15160
84;15;03;11;161;Rézentières;108;2;110;15161
84;15;02;10;162;Riom-ès-Montagnes;2479;62;2541;15162
84;15;01;06;163;Roannes-Saint-Mary;1098;31;1129;15163
84;15;03;11;164;Roffiac;627;18;645;15164
84;15;01;13;165;Rouffiac;203;3;206;15165
84;15;01;13;166;Roumégoux;314;10;324;15166
84;15;01;06;167;Rouziers;117;8;125;15167
84;15;03;09;168;Ruynes-en-Margeride;712;25;737;15168
84;15;02;15;169;Saignes;820;16;836;15169
84;15;03;10;170;Saint-Amandin;231;4;235;15170
84;15;01;06;172;Saint-Antoine;93;1;94;15172
84;15;03;10;173;Saint-Bonnet-de-Condat;115;5;120;15173
84;15;02;05;174;Saint-Bonnet-de-Salers;271;6;277;15174
84;15;01;08;175;Saint-Cernin;1070;27;1097;15175
84;15;02;08;176;Saint-Chamant;242;9;251;15176
84;15;01;14;178;Saint-Cirgues-de-Jordanne;142;7;149;15178
84;15;01;08;179;Saint-Cirgues-de-Malbert;249;4;253;15179
84;15;01;14;180;Saint-Clément;75;3;78;15180
84;15;01;06;181;Saint-Constant-Fournoulès;577;11;588;15181
84;15;01;13;182;Saint-Etienne-Cantalès;133;3;136;15182
84;15;01;14;183;Saint-Etienne-de-Carlat;135;0;135;15183
84;15;01;06;184;Saint-Etienne-de-Maurs;785;19;804;15184
84;15;02;10;185;Saint-Etienne-de-Chomeil;243;11;254;15185
84;15;02;05;186;Sainte-Eulalie;229;3;232;15186
84;15;03;99;187;Saint-Flour;6458;542;7000;15187
84;15;03;09;188;Saint-Georges;1198;31;1229;15188
84;15;01;13;189;Saint-Gérons;222;7;229;15189
84;15;02;10;190;Saint-Hippolyte;104;3;107;15190
84;15;01;08;191;Saint-Illide;644;9;653;15191
84;15;01;14;192;Saint-Jacques-des-Blats;293;4;297;15192
84;15;01;06;194;Saint-Julien-de-Toursac;105;6;111;15194
84;15;01;06;196;Saint-Mamet-la-Salvetat;1548;53;1601;15196
84;15;03;12;198;Sainte-Marie;108;1;109;15198
84;15;03;09;199;Saint-Martial;75;0;75;15199
84;15;02;05;200;Saint-Martin-Cantalès;146;3;149;15200
84;15;03;12;201;Saint-Martin-sous-Vigouroux;226;3;229;15201
84;15;02;05;202;Saint-Martin-Valmeroux;717;17;734;15202
84;15;03;11;203;Saint-Mary-le-Plain;174;3;177;15203
84;15;01;13;204;Saint-Paul-des-Landes;1539;42;1581;15204
84;15;02;05;205;Saint-Paul-de-Salers;105;5;110;15205
84;15;02;15;206;Saint-Pierre;142;2;144;15206
84;15;03;11;207;Saint-Poncy;362;12;374;15207
84;15;02;08;208;Saint-Projet-de-Salers;135;4;139;15208
84;15;03;09;209;Saint-Rémy-de-Chaudes-Aigues;124;5;129;15209
84;15;01;13;211;Saint-Santin-Cantalès;298;5;303;15211
84;15;01;06;212;Saint-Santin-de-Maurs;359;15;374;15212
84;15;03;07;213;Saint-Saturnin;203;4;207;15213
84;15;01;13;214;Saint-Saury;178;5;183;15214
84;15;01;14;215;Saint-Simon;1121;37;1158;15215
84;15;03;09;216;Saint-Urcize;402;14;416;15216
84;15;01;13;217;Saint-Victor;106;3;109;15217
84;15;02;10;218;Saint-Vincent-de-Salers;68;2;70;15218
84;15;02;05;219;Salers;325;5;330;15219
84;15;02;05;220;Salins;145;2;147;15220
84;15;01;06;221;Sansac-de-Marmiesse;1368;34;1402;15221
84;15;01;01;222;Sansac-Veinazès;217;10;227;15222
84;15;02;15;223;Sauvat;214;6;220;15223
84;15;01;13;224;La Ségalassière;132;13;145;15224
84;15;03;07;225;Ségur-les-Villas;212;4;216;15225
84;15;01;01;226;Sénezergues;204;4;208;15226
84;15;01;13;228;Siran;462;10;472;15228
84;15;03;09;229;Soulages;81;2;83;15229
84;15;02;15;230;Sourniac;197;9;206;15230
84;15;03;11;231;Talizat;596;20;616;15231
84;15;03;12;232;Tanavelle;228;7;235;15232
84;15;01;08;233;Teissières-de-Cornet;301;5;306;15233
84;15;01;14;234;Teissières-lès-Bouliès;330;6;336;15234
84;15;03;12;235;Les Ternes;573;23;596;15235
84;15;01;14;236;Thiézac;602;14;616;15236
84;15;03;11;237;Tiviers;172;6;178;15237
84;15;01;08;238;Tournemire;128;3;131;15238
84;15;02;15;240;Trémouille;173;7;180;15240
84;15;03;09;241;La Trinitat;48;3;51;15241
84;15;01;06;242;Le Trioulou;101;3;104;15242
84;15;02;10;243;Trizac;503;9;512;15243
84;15;03;07;244;Ussel;473;10;483;15244
84;15;03;09;245;Vabres;252;4;256;15245
84;15;02;10;246;Valette;235;2;237;15246
84;15;03;11;247;Valjouze;23;0;23;15247
84;15;03;12;248;Valuéjols;564;12;576;15248
84;15;02;10;249;Le Vaulmier;64;2;66;15249
84;15;02;15;250;Vebret;509;18;527;15250
84;15;03;09;251;Védrines-Saint-Loup;141;6;147;15251
84;15;01;14;252;Velzic;413;18;431;15252
84;15;03;07;253;Vernols;65;1;66;15253
84;15;02;15;254;Veyrières;119;2;121;15254
84;15;01;14;255;Vézac;1249;35;1284;15255
84;15;03;07;256;Vèze;52;5;57;15256
84;15;01;14;257;Vezels-Roussy;125;4;129;15257
84;15;01;14;258;Vic-sur-Cère;1838;36;1874;15258
84;15;03;11;259;Vieillespesse;244;3;247;15259
84;15;01;01;260;Vieillevie;108;4;112;15260
84;15;02;05;261;Le Vigean;825;21;846;15261
84;15;03;12;262;Villedieu;562;11;573;15262
84;15;03;07;263;Virargues;124;5;129;15263
84;15;01;06;264;Vitrac;269;6;275;15264
84;15;02;15;265;Ydes;1644;28;1672;15265
84;15;01;14;266;Yolet;551;10;561;15266
84;15;01;02;267;Ytrac;4335;106;4441;15267
84;15;01;13;268;Le Rouget-Pers;1233;26;1259;15268
84;15;01;08;269;Besse;130;3;133;15269
75;16;03;10;001;Abzac;503;1;504;16001
75;16;03;08;002;Les Adjots;523;8;531;16002
75;16;01;19;003;Agris;857;10;867;16003
75;16;03;08;005;Aigre;1579;39;1618;16005
75;16;03;06;007;Alloue;463;11;474;16007
75;16;03;05;008;Ambérac;310;2;312;16008
75;16;03;10;009;Ambernac;380;6;386;16009
75;16;02;07;010;Ambleville;167;4;171;16010
75;16;03;05;011;Anais;568;21;589;16011
75;16;02;07;012;Angeac-Champagne;503;9;512;16012
75;16;02;07;013;Angeac-Charente;319;8;327;16013
75;16;02;09;014;Angeduc;128;0;128;16014
75;16;01;98;015;Angoulême;41603;1687;43290;16015
75;16;03;10;016;Ansac-sur-Vienne;827;23;850;16016
75;16;02;12;018;Ars;709;18;727;16018
75;16;01;18;019;Asnières-sur-Nouère;1248;23;1271;16019
75;16;01;17;020;Aubeterre-sur-Dronne;347;4;351;16020
75;16;03;05;023;Aunac-sur-Charente;590;11;601;16023
75;16;03;05;024;Aussac-Vadalle;515;9;524;16024
75;16;02;09;025;Baignes-Sainte-Radegonde;1237;31;1268;16025
75;16;01;14;026;Balzac;1359;27;1386;16026
75;16;03;08;027;Barbezières;126;3;129;16027
75;16;02;09;028;Barbezieux-Saint-Hilaire;4714;177;4891;16028
75;16;01;17;029;Bardenac;226;5;231;16029
75;16;02;09;030;Barret;1052;22;1074;16030
75;16;03;08;031;Barro;410;11;421;16031
75;16;02;15;032;Bassac;517;7;524;16032
75;16;01;17;034;Bazac;144;2;146;16034
75;16;03;06;035;Beaulieu-sur-Sonnette;199;5;204;16035
75;16;02;09;036;Bécheresse;291;9;300;16036
75;16;01;17;037;Bellon;141;5;146;16037
75;16;03;06;038;Benest;310;8;318;16038
75;16;03;08;039;Bernac;474;12;486;16039
75;16;02;09;040;Berneuil;305;6;311;16040
75;16;01;17;041;Bessac;111;1;112;16041
75;16;03;08;042;Bessé;110;7;117;16042
75;16;03;08;044;Bioussac;215;7;222;16044
75;16;02;07;045;Birac;366;6;372;16045
75;16;02;09;046;Coteaux-du-Blanzacais;1003;12;1015;16046
75;16;01;17;047;Blanzaguet-Saint-Cybard;295;6;301;16047
75;16;02;09;048;Boisbreteau;129;0;129;16048
75;16;01;17;049;Bonnes;375;8;383;16049
75;16;02;07;050;Bonneuil;251;8;259;16050
75;16;01;17;052;Bors (Canton de Tude-et-Lavalette);246;3;249;16052
75;16;02;09;053;Bors (Canton de Charente-Sud);119;1;120;16053
75;16;03;06;054;Le Bouchage;175;1;176;16054
75;16;01;04;055;BouÃ«x;892;11;903;16055
75;16;02;15;056;Bourg-Charente;891;18;909;16056
75;16;02;07;057;Bouteville;320;6;326;16057
75;16;02;11;058;Boutiers-Saint-Trojan;1410;51;1461;16058
75;16;03;08;059;Brettes;176;5;181;16059
75;16;02;11;060;Bréville;454;12;466;16060
75;16;01;16;061;Brie;4233;82;4315;16061
75;16;02;09;062;Brie-sous-Barbezieux;137;1;138;16062
75;16;01;17;063;Brie-sous-Chalais;159;0;159;16063
75;16;03;10;064;Brigueuil;1115;17;1132;16064
75;16;03;10;065;Brillac;621;6;627;16065
75;16;02;09;066;Brossac;464;8;472;16066
75;16;01;19;067;Bunzac;465;10;475;16067
75;16;03;05;068;Cellefrouin;565;6;571;16068
75;16;03;05;069;Cellettes;388;3;391;16069
75;16;03;10;070;Chabanais;1568;32;1600;16070
75;16;03;10;071;Chabrac;591;16;607;16071
75;16;01;17;072;Chadurie;511;10;521;16072
75;16;01;17;073;Chalais;1776;31;1807;16073
75;16;02;09;074;Challignac;333;8;341;16074
75;16;02;09;075;Champagne-Vigny;244;3;247;16075
75;16;03;06;076;Champagne-Mouton;878;9;887;16076
75;16;02;18;077;Champmillon;491;9;500;16077
75;16;01;14;078;Champniers;5149;118;5267;16078
75;16;02;09;079;Chantillac;347;3;350;16079
75;16;03;05;081;La Chapelle;215;5;220;16081
75;16;01;17;082;Boisné-La Tude;673;12;685;16082
75;16;03;08;083;Charmé;340;6;346;16083
75;16;01;19;084;Charras;334;3;337;16084
75;16;03;06;085;Chasseneuil-sur-Bonnieure;3083;272;3355;16085
75;16;03;10;086;Chassenon;864;17;881;16086
75;16;03;06;087;Chassiecq;142;2;144;16087
75;16;02;15;088;Chassors;1105;38;1143;16088
75;16;02;12;089;Châteaubernard;3746;66;3812;16089
75;16;02;07;090;Châteauneuf-sur-Charente;3537;64;3601;16090
75;16;01;17;091;Châtignac;172;2;174;16091
75;16;01;19;093;Chazelles;1587;26;1613;16093
75;16;03;05;095;Chenon;130;4;134;16095
75;16;03;06;096;Cherves-Châtelars;418;3;421;16096
75;16;02;11;097;Cherves-Richemont;2299;100;2399;16097
75;16;03;08;098;La Chèvrerie;141;2;143;16098
75;16;02;09;099;Chillac;221;1;222;16099
75;16;03;10;100;Chirac;767;14;781;16100
75;16;01;04;101;Claix;1052;18;1070;16101
75;16;02;99;102;Cognac;18670;434;19104;16102
75;16;01;17;103;Combiers;123;5;128;16103
75;16;03;08;104;Condac;470;9;479;16104
75;16;02;09;105;Condéon;620;5;625;16105
75;16;03;10;106;Confolens;2712;154;2866;16106
75;16;01;19;107;Coulgens;534;6;540;16107
75;16;03;05;108;Coulonges;131;1;132;16108
75;16;02;18;109;Courbillac;763;8;771;16109
75;16;03;08;110;Courcôme;777;21;798;16110
75;16;01;17;111;Courgeac;178;3;181;16111
75;16;01;17;112;Courlac;57;2;59;16112
75;16;01;13;113;La Couronne;7764;260;8024;16113
75;16;03;08;114;Couture;165;3;168;16114
75;16;02;07;116;Criteuil-la-Magdeleine;390;9;399;16116
75;16;01;17;117;Curac;120;3;123;16117
75;16;01;17;118;Deviat;138;0;138;16118
75;16;01;04;119;Dignac;1355;15;1370;16119
75;16;01;04;120;Dirac;1520;21;1541;16120
75;16;02;18;121;Douzat;440;13;453;16121
75;16;03;08;122;Ebréon;140;4;144;16122
75;16;02;18;123;Echallat;488;10;498;16123
75;16;01;19;124;Ecuras;569;10;579;16124
75;16;01;17;125;Edon;263;3;266;16125
75;16;03;08;127;Empuré;95;3;98;16127
75;16;03;10;128;Epenède;174;6;180;16128
75;16;01;17;130;Les Essards;186;7;193;16130
75;16;03;10;131;Esse;497;7;504;16131
75;16;03;10;132;Etagnac;990;9;999;16132
75;16;02;09;133;Etriac;198;3;201;16133
75;16;03;10;134;Exideuil-sur-Vienne;1014;27;1041;16134
75;16;01;19;135;Eymouthiers;314;4;318;16135
75;16;03;08;136;La Faye;572;12;584;16136
75;16;01;19;137;Feuillade;312;6;318;16137
75;16;01;01;138;Fléac;3818;105;3923;16138
75;16;02;15;139;Fleurac;239;2;241;16139
75;16;03;05;140;Fontclaireau;438;15;453;16140
75;16;03;05;141;Fontenille;321;12;333;16141
75;16;03;08;142;La Forêt-de-Tessé;200;4;204;16142
75;16;01;17;143;Fouquebrune;704;13;717;16143
75;16;03;08;144;Fouqueure;421;6;427;16144
75;16;02;15;145;Foussignac;639;19;658;16145
75;16;01;04;146;Garat;2108;35;2143;16146
75;16;01;17;147;Gardes-le-Pontaroux;264;6;270;16147
75;16;02;18;148;Genac-Bignac;1011;14;1025;16148
75;16;02;07;150;Gensac-la-Pallue;1594;43;1637;16150
75;16;02;07;151;Genté;886;21;907;16151
75;16;02;12;152;Gimeux;719;20;739;16152
75;16;02;15;153;Mainxe-Gondeville;1168;22;1190;16153
75;16;01;14;154;Gond-Pontouvre;6119;115;6234;16154
75;16;03;08;155;Les Gours;110;1;111;16155
75;16;03;06;157;Le Grand-Madieu;162;3;165;16157
75;16;01;19;158;Grassac;308;5;313;16158
75;16;02;09;160;Guimps;482;7;489;16160
75;16;02;09;161;Guizengeard;165;3;168;16161
75;16;01;17;162;Gurat;182;0;182;16162
75;16;02;18;163;Hiersac;1145;21;1166;16163
75;16;03;10;164;Hiesse;243;2;245;16164
75;16;02;15;165;Houlette;367;4;371;16165
75;16;01;02;166;L'Isle-d'Espagnac;5626;153;5779;16166
75;16;02;15;167;Jarnac;4434;134;4568;16167
75;16;01;16;168;Jauldes;813;8;821;16168
75;16;02;12;169;Javrezac;563;8;571;16169
75;16;01;17;170;Juignac;399;2;401;16170
75;16;02;07;171;Juillac-le-Coq;651;13;664;16171
75;16;03;05;173;Juillé;180;4;184;16173
75;16;02;15;174;Julienne;511;11;522;16174
75;16;02;09;175;Val des Vignes;1390;34;1424;16175
75;16;02;09;176;Lachaise;305;7;312;16176
75;16;02;09;177;Ladiville;118;2;120;16177
75;16;02;09;178;Lagarde-sur-le-Né;186;5;191;16178
75;16;01;17;180;Laprade;247;6;253;16180
75;16;03;10;181;Lessac;523;11;534;16181
75;16;03;10;182;Lesterps;453;13;466;16182
75;16;03;06;183;Lésignac-Durand;178;4;182;16183
75;16;03;05;184;Lichères;87;1;88;16184
75;16;03;08;185;Ligné;157;2;159;16185
75;16;02;07;186;Lignières-Sonneville;552;17;569;16186
75;16;01;18;187;Linars;2092;47;2139;16187
75;16;03;06;188;Le Lindois;341;4;345;16188
75;16;03;08;189;Londigny;254;6;260;16189
75;16;03;08;190;Longré;186;6;192;16190
75;16;03;05;191;Lonnes;181;1;182;16191
75;16;03;89;192;Terres-de-Haute-Charente;3900;107;4007;16192
75;16;02;11;193;Louzac-Saint-André;991;17;1008;16193
75;16;03;08;194;Lupsault;104;1;105;16194
75;16;03;06;195;Lussac;294;8;302;16195
75;16;03;05;196;Luxé;723;9;732;16196
75;16;03;08;197;La Magdeleine;110;7;117;16197
75;16;01;17;198;Magnac-Lavalette-Villars;445;5;450;16198
75;16;01;16;199;Magnac-sur-Touvre;3223;69;3292;16199
75;16;03;05;200;Maine-de-Boixe;482;4;486;16200
75;16;01;19;203;Mainzac;115;0;115;16203
75;16;02;07;204;Bellevigne;1298;35;1333;16204
75;16;03;10;205;Manot;540;5;545;16205
75;16;03;05;206;Mansle;1692;17;1709;16206
75;16;02;18;207;Marcillac-Lanville;492;9;501;16207
75;16;02;18;208;Mareuil;398;4;402;16208
75;16;01;19;209;Marillac-le-Franc;824;9;833;16209
75;16;01;18;210;Marsac;817;10;827;16210
75;16;01;19;211;Marthon;561;7;568;16211
75;16;03;06;212;Massignac;391;6;397;16212
75;16;03;06;213;Mazerolles;295;5;300;16213
75;16;01;17;215;Médillac;155;5;160;16215
75;16;02;15;216;Mérignac;843;14;857;16216
75;16;02;12;217;Merpins;1101;24;1125;16217
75;16;02;11;218;Mesnac;409;12;421;16218
75;16;02;15;220;Les Métairies;716;15;731;16220
75;16;02;18;221;Mons;238;4;242;16221
75;16;01;17;222;Montboyer;328;7;335;16222
75;16;01;19;223;Montbron;2009;28;2037;16223
75;16;02;09;224;Montmérac;714;18;732;16224
75;16;03;06;225;MontembÅ“uf;650;31;681;16225
75;16;03;05;226;Montignac-Charente;717;9;726;16226
75;16;01;17;227;Montignac-le-Coq;139;0;139;16227
75;16;03;08;229;Montjean;242;4;246;16229
75;16;01;17;230;Montmoreau;2564;100;2664;16230
75;16;03;10;231;Montrollet;321;2;323;16231
75;16;01;16;232;Mornac;2151;50;2201;16232
75;16;02;07;233;Mosnac-Saint-Simeux;1004;17;1021;16233
75;16;02;18;234;Moulidars;731;8;739;16234
75;16;01;04;236;Mouthiers-sur-BoÃ«me;2397;73;2470;16236
75;16;03;05;237;Mouton;223;0;223;16237
75;16;03;05;238;Moutonneau;117;0;117;16238
75;16;03;06;239;Mouzon;134;2;136;16239
75;16;01;17;240;Nabinaud;99;0;99;16240
75;16;03;05;241;Nanclars;207;4;211;16241
75;16;03;08;242;Nanteuil-en-Vallée;1382;17;1399;16242
75;16;02;15;243;Nercillac;1047;21;1068;16243
75;16;01;13;244;Nersac;2348;54;2402;16244
75;16;03;06;245;Nieuil;932;23;955;16245
75;16;01;17;246;Nonac;266;8;274;16246
75;16;03;08;248;Oradour;152;1;153;16248
75;16;03;10;249;Oradour-Fanais;403;3;406;16249
75;16;01;19;250;Orgedeuil;220;2;222;16250
75;16;02;09;251;Oriolles;253;6;259;16251
75;16;01;17;252;Orival;152;3;155;16252
75;16;03;08;253;Paizay-Naudouin-Embourie;362;3;365;16253
75;16;01;17;254;Palluaud;221;8;229;16254
75;16;03;06;255;Parzac;141;5;146;16255
75;16;02;09;256;Passirac;240;11;251;16256
75;16;02;09;258;Pérignac;483;9;492;16258
75;16;01;17;260;Pillac;271;7;278;16260
75;16;03;06;261;Les Pins;467;17;484;16261
75;16;01;04;263;Plassac-Rouffiac;400;5;405;16263
75;16;03;10;264;Pleuville;323;6;329;16264
75;16;01;17;267;Poullignac;89;1;90;16267
75;16;03;08;268;Poursac;209;2;211;16268
75;16;01;19;269;Pranzac;898;10;908;16269
75;16;03;10;270;Pressignac;344;5;349;16270
75;16;01;13;271;Puymoyen;2369;146;2515;16271
75;16;03;05;272;Puyréaux;543;9;552;16272
75;16;03;08;273;Raix;124;6;130;16273
75;16;03;08;275;Ranville-Breuillaud;175;2;177;16275
75;16;02;09;276;Reignac;761;17;778;16276
75;16;02;15;277;Réparsac;595;11;606;16277
75;16;01;17;279;Rioux-Martin;225;3;228;16279
75;16;01;19;280;Rivières;1996;31;2027;16280
75;16;01;19;281;La Rochefoucauld-en-Angoumois;3977;159;4136;16281
75;16;01;19;282;La Rochette;534;11;545;16282
75;16;01;17;283;Ronsenac;570;7;577;16283
75;16;01;17;284;Rouffiac;120;1;121;16284
75;16;01;17;285;Rougnac;406;5;411;16285
75;16;02;18;286;Rouillac;2964;49;3013;16286
75;16;01;04;287;Roullet-Saint-Estèphe;4277;69;4346;16287
75;16;03;06;289;Roussines;294;2;296;16289
75;16;01;19;290;Rouzède;242;4;246;16290
75;16;01;16;291;Ruelle-sur-Touvre;7305;200;7505;16291
75;16;03;08;292;Ruffec;3372;150;3522;16292
75;16;01;19;293;Saint-Adjutory;492;7;499;16293
75;16;03;05;295;Saint-Amant-de-Boixe;1333;24;1357;16295
75;16;02;07;297;Graves-Saint-Amant;329;12;341;16297
75;16;02;18;298;Saint-Amant-de-Nouère;373;5;378;16298
75;16;03;05;300;Val-de-Bonnieure;1308;16;1324;16300
75;16;02;09;301;Saint-Aulais-la-Chapelle;229;3;232;16301
75;16;01;17;302;Saint-Avit;216;2;218;16302
75;16;02;09;303;Saint-Bonnet;406;12;418;16303
75;16;02;11;304;Saint-Brice;963;35;998;16304
75;16;03;10;306;Saint-Christophe;317;8;325;16306
75;16;03;05;307;Saint-Ciers-sur-Bonnieure;333;14;347;16307
75;16;03;06;308;Saint-Claud;1053;24;1077;16308
75;16;03;06;310;Saint-Coutant;216;2;218;16310
75;16;02;18;312;Saint-Cybardeaux;823;13;836;16312
75;16;02;09;315;Saint-Félix;107;1;108;16315
75;16;02;07;316;Saint-Fort-sur-le-Né;385;6;391;16316
75;16;03;08;317;Saint-Fraigne;439;5;444;16317
75;16;03;05;318;Saint-Front;366;2;368;16318
75;16;02;18;320;Saint-Genis-d'Hiersac;896;17;913;16320
75;16;03;08;321;Saint-Georges;46;0;46;16321
75;16;01;19;323;Saint-Germain-de-Montbron;471;11;482;16323
75;16;03;08;325;Saint-Gourson;132;3;135;16325
75;16;03;05;326;Saint-Groux;135;0;135;16326
75;16;03;06;329;Saint-Laurent-de-Céris;782;15;797;16329
75;16;02;12;330;Saint-Laurent-de-Cognac;826;28;854;16330
75;16;01;17;331;Saint-Laurent-des-Combes;89;3;92;16331
75;16;01;17;334;Saint-Martial;126;3;129;16334
75;16;03;08;335;Saint-Martin-du-Clocher;124;3;127;16335
75;16;03;06;336;Saint-Mary;343;3;346;16336
75;16;03;10;337;Saint-Maurice-des-Lions;895;30;925;16337
75;16;02;09;338;Saint-Médard;319;5;324;16338
75;16;02;18;339;Val-d'Auge;802;19;821;16339
75;16;02;15;340;Saint-Même-les-Carrières;1032;28;1060;16340
75;16;01;13;341;Saint-Michel;3218;39;3257;16341
75;16;02;09;342;Saint-Palais-du-Né;299;7;306;16342
75;16;02;07;343;Saint-Preuil;296;9;305;16343
75;16;03;10;345;Saint-Quentin-sur-Charente;218;2;220;16345
75;16;01;17;346;Saint-Quentin-de-Chalais;248;8;256;16346
75;16;01;17;347;Saint-Romain;508;12;520;16347
75;16;01;18;348;Saint-Saturnin;1296;32;1328;16348
75;16;02;15;349;Sainte-Sévère;513;11;524;16349
75;16;01;17;350;Saint-Séverin;796;10;806;16350
75;16;02;07;352;Saint-Simon;216;8;224;16352
75;16;01;19;353;Saint-Sornin;787;16;803;16353
75;16;02;09;354;Sainte-Souline;121;3;124;16354
75;16;02;11;355;Saint-Sulpice-de-Cognac;1192;16;1208;16355
75;16;03;08;356;Saint-Sulpice-de-Ruffec;31;0;31;16356
75;16;02;09;357;Saint-Vallier;136;2;138;16357
75;16;01;14;358;Saint-Yrieix-sur-Charente;7381;246;7627;16358
75;16;02;07;359;Salles-d'Angles;1011;27;1038;16359
75;16;02;09;360;Salles-de-Barbezieux;403;85;488;16360
75;16;03;08;361;Salles-de-Villefagnan;313;6;319;16361
75;16;01;17;362;Salles-Lavalette;326;12;338;16362
75;16;03;10;363;Saulgond;524;10;534;16363
75;16;03;06;364;Sauvagnac;64;2;66;16364
75;16;02;09;365;Sauvignac;106;0;106;16365
75;16;02;07;366;Segonzac;2074;77;2151;16366
75;16;01;04;368;Sers;888;21;909;16368
75;16;02;15;369;Sigogne;982;20;1002;16369
75;16;01;18;370;Sireuil;1160;41;1201;16370
75;16;01;19;372;Souffrignac;127;2;129;16372
75;16;03;08;373;Souvigné;196;6;202;16373
75;16;01;03;374;Soyaux;9761;312;10073;16374
75;16;03;06;375;Suaux;386;6;392;16375
75;16;03;05;377;La Tâche;116;0;116;16377
75;16;03;08;378;Taizé-Aizie;573;15;588;16378
75;16;01;19;379;Taponnat-Fleurignac;1486;27;1513;16379
75;16;02;09;380;Le Tâtre;410;3;413;16380
75;16;03;08;381;Theil-Rabier;164;2;166;16381
75;16;01;04;382;Torsac;721;31;752;16382
75;16;03;05;383;Tourriers;758;10;768;16383
75;16;02;09;384;Touvérac;581;7;588;16384
75;16;01;16;385;Touvre;1165;26;1191;16385
75;16;02;15;387;Triac-Lautrait;466;63;529;16387
75;16;01;18;388;Trois-Palis;940;22;962;16388
75;16;03;06;389;Turgon;87;2;89;16389
75;16;03;08;390;Tusson;222;7;229;16390
75;16;03;05;392;Valence;189;6;195;16392
75;16;03;05;393;Vars;2168;33;2201;16393
75;16;01;17;394;Vaux-Lavalette;83;2;85;16394
75;16;02;18;395;Vaux-Rouillac;297;4;301;16395
75;16;03;05;396;Ventouse;124;0;124;16396
75;16;03;08;397;Verdille;374;7;381;16397
75;16;03;06;398;Verneuil;99;5;104;16398
75;16;02;07;399;Verrières;346;9;355;16399
75;16;03;08;400;Verteuil-sur-Charente;620;11;631;16400
75;16;03;05;401;Vervant;146;2;148;16401
75;16;02;07;402;Vibrac;283;5;288;16402
75;16;03;06;403;Le Vieux-Cérier;127;3;130;16403
75;16;03;06;404;Vieux-Ruffec;109;2;111;16404
75;16;02;09;405;Vignolles;165;9;174;16405
75;16;01;19;406;Moulins-sur-Tardoire;770;15;785;16406
75;16;01;17;408;Villebois-Lavalette;717;19;736;16408
75;16;03;08;409;Villefagnan;982;11;993;16409
75;16;03;05;412;Villejoubert;338;1;339;16412
75;16;03;08;413;Villiers-le-Roux;136;2;138;16413
75;16;03;05;414;Villognon;312;4;316;16414
75;16;01;18;415;Vindelle;1099;20;1119;16415
75;16;03;06;416;Vitrac-Saint-Vincent;506;8;514;16416
75;16;01;04;418;VÅ“uil-et-Giget;1547;28;1575;16418
75;16;03;05;419;Vouharte;328;2;330;16419
75;16;01;04;420;Voulgézac;242;4;246;16420
75;16;01;19;421;Vouthon;411;6;417;16421
75;16;01;04;422;Vouzan;811;8;819;16422
75;16;03;05;423;Xambes;254;4;258;16423
75;16;01;17;424;Yviers;525;8;533;16424
75;16;01;19;425;Yvrac-et-Malleyrand;557;11;568;16425
75;17;01;07;002;Agudelle;133;4;137;17002
75;17;02;23;003;Aigrefeuille-d'Aunis;4143;74;4217;17003
75;17;02;03;004;ÃŽle-d'Aix;207;5;212;17004
75;17;01;07;005;Allas-Bocage;196;1;197;17005
75;17;01;07;006;Allas-Champagne;252;4;256;17006
75;17;02;06;007;Anais;313;7;320;17007
75;17;03;09;008;Andilly;2272;33;2305;17008
75;17;03;09;009;Angliers;1147;9;1156;17009
75;17;03;03;010;Angoulins;4050;101;4151;17010
75;17;05;18;011;Annepont;394;4;398;17011
75;17;05;18;012;Annezay;155;5;160;17012
75;17;05;11;013;Antezant-la-Chapelle;340;8;348;17013
75;17;04;21;015;Arces;760;9;769;17015
75;17;01;07;016;Archiac;782;12;794;17016
75;17;05;18;017;Archingeay;670;13;683;17017
75;17;02;23;018;Ardillières;855;13;868;17018
75;17;03;05;019;Ars-en-Ré;1302;24;1326;17019
75;17;01;07;020;Arthenac;349;4;353;17020
75;17;02;26;021;Arvert;3566;84;3650;17021
75;17;05;11;022;Asnières-la-Giraud;1006;23;1029;17022
75;17;05;02;023;Aujac;373;7;380;17023
75;17;05;11;024;Aulnay;1333;25;1358;17024
75;17;05;02;025;Aumagne;704;29;733;17025
75;17;05;02;026;Authon-Ebéon;385;5;390;17026
75;17;01;12;027;Avy;471;7;478;17027
75;17;03;01;028;Aytré;9247;167;9414;17028
75;17;05;11;029;Bagnizeau;209;1;210;17029
75;17;04;19;030;Balanzac;545;5;550;17030
75;17;05;11;031;Ballans;195;2;197;17031
75;17;02;23;032;Ballon;804;17;821;17032
75;17;01;27;033;La Barde;496;5;501;17033
75;17;04;21;034;Barzan;463;7;470;17034
75;17;05;11;035;Bazauges;112;2;114;17035
75;17;02;10;036;Beaugeay;780;14;794;17036
75;17;05;11;037;Beauvais-sur-Matha;650;9;659;17037
75;17;01;27;038;Bedenac;692;6;698;17038
75;17;01;12;039;Belluire;211;1;212;17039
75;17;03;09;041;Benon;1679;16;1695;17041
75;17;05;02;042;Bercloux;443;9;452;17042
75;17;05;18;043;Bernay-Saint-Martin;746;13;759;17043
75;17;04;24;044;Berneuil;1149;22;1171;17044
75;17;04;19;045;Beurlay;1030;18;1048;17045
75;17;05;18;046;Bignay;387;8;395;17046
75;17;01;12;047;Biron;237;1;238;17047
75;17;05;11;048;Blanzac-lès-Matha;321;4;325;17048
75;17;05;11;049;Blanzay-sur-Boutonne;79;5;84;17049
75;17;01;12;050;Bois;517;144;661;17050
75;17;03;05;051;Le Bois-Plage-en-Ré;2272;30;2302;17051
75;17;01;12;052;Boisredon;693;9;702;17052
75;17;05;18;053;Bords;1322;27;1349;17053
75;17;01;27;054;Boresse-et-Martron;204;9;213;17054
75;17;01;27;055;Boscamnant;361;4;365;17055
75;17;01;12;056;Bougneau;600;14;614;17056
75;17;02;06;057;Bouhet;916;16;932;17057
75;17;02;10;058;Bourcefranc-le-Chapus;3506;126;3632;17058
75;17;03;06;059;Bourgneuf;1375;25;1400;17059
75;17;04;21;060;Boutenac-Touvent;228;5;233;17060
75;17;01;27;061;Bran;137;2;139;17061
75;17;05;11;062;Bresdon;216;3;219;17062
75;17;02;23;063;Breuil-la-Réorte;453;7;460;17063
75;17;02;26;064;Breuillet;3010;63;3073;17064
75;17;02;25;065;Breuil-Magné;1777;53;1830;17065
75;17;01;07;066;Brie-sous-Archiac;235;2;237;17066
75;17;05;11;067;Brie-sous-Matha;173;4;177;17067
75;17;04;21;068;Brie-sous-Mortagne;243;3;246;17068
75;17;01;24;069;Brives-sur-Charente;232;6;238;17069
75;17;05;02;070;Brizambourg;934;14;948;17070
75;17;05;11;071;La Brousse;511;9;520;17071
75;17;04;02;072;Burie;1303;26;1329;17072
75;17;04;02;073;Bussac-sur-Charente;1277;44;1321;17073
75;17;01;27;074;Bussac-Forêt;1053;15;1068;17074
75;17;02;25;075;Cabariot;1386;23;1409;17075
75;17;01;07;076;Celles;321;3;324;17076
75;17;01;27;077;Cercoux;1235;20;1255;17077
75;17;01;12;078;Chadenac;511;7;518;17078
75;17;02;26;079;Chaillevette;1610;33;1643;17079
75;17;02;23;080;Chambon;961;12;973;17080
75;17;01;27;081;Chamouillac;372;7;379;17081
75;17;01;07;082;Champagnac;527;8;535;17082
75;17;02;10;083;Champagne;619;12;631;17083
75;17;01;12;084;Champagnolles;678;8;686;17084
75;17;05;18;085;Champdolent;408;6;414;17085
75;17;04;02;086;Chaniers;3587;83;3670;17086
75;17;05;18;087;Chantemerle-sur-la-Soie;205;2;207;17087
75;17;04;02;089;La Chapelle-des-Pots;1004;26;1030;17089
75;17;03;09;091;Charron;2001;27;2028;17091
75;17;01;27;092;Chartuzac;160;4;164;17092
75;17;02;04;093;Le Château-d'Oléron;4270;79;4349;17093
75;17;03;03;094;Châtelaillon-Plage;5900;93;5993;17094
75;17;01;27;095;Chatenet;215;6;221;17095
75;17;01;07;096;Chaunac;77;2;79;17096
75;17;04;22;097;Le Chay;778;15;793;17097
75;17;04;21;098;Chenac-Saint-Seurin-d'Uzet;598;13;611;17098
75;17;01;27;099;Chepniers;635;10;645;17099
75;17;04;02;100;Chérac;1118;17;1135;17100
75;17;05;11;101;Cherbonnières;331;1;332;17101
75;17;04;24;102;Chermignac;1263;35;1298;17102
75;17;01;27;104;Chevanceaux;1090;108;1198;17104
75;17;05;11;105;Chives;316;1;317;17105
75;17;01;07;106;Cierzac;313;5;318;17106
75;17;02;23;107;Ciré-d'Aunis;1455;24;1479;17107
75;17;01;07;108;Clam;407;15;422;17108
75;17;03;06;109;Clavette;1438;20;1458;17109
75;17;01;27;110;Clérac;977;15;992;17110
75;17;01;07;111;Clion;820;12;832;17111
75;17;04;24;112;La Clisse;713;16;729;17112
75;17;01;27;113;La Clotte;717;7;724;17113
75;17;05;11;114;Coivert;212;2;214;17114
75;17;04;24;115;Colombiers;309;7;316;17115
75;17;01;07;116;Consac;225;5;230;17116
75;17;05;11;117;Contré;140;0;140;17117
75;17;01;27;118;Corignac;348;10;358;17118
75;17;04;22;119;Corme-Ecluse;1127;20;1147;17119
75;17;04;24;120;Corme-Royal;1878;39;1917;17120
75;17;03;05;121;La Couarde-sur-Mer;1137;19;1156;17121
75;17;01;24;122;Coulonges;234;4;238;17122
75;17;05;18;124;Courant;426;5;431;17124
75;17;05;11;125;Courcelles;462;10;472;17125
75;17;05;11;126;Courcerac;299;6;305;17126
75;17;03;09;127;Courçon;1776;30;1806;17127
75;17;04;24;128;Courcoury;694;12;706;17128
75;17;01;12;129;Courpignac;419;6;425;17129
75;17;01;27;130;Coux;473;13;486;17130
75;17;04;21;131;Cozes;2150;43;2193;17131
75;17;03;09;132;Cramchaban;650;18;668;17132
75;17;04;21;133;Cravans;896;75;971;17133
75;17;04;19;134;Crazannes;432;9;441;17134
75;17;05;11;135;Cressé;229;2;231;17135
75;17;03;06;136;Croix-Chapeau;1284;28;1312;17136
75;17;05;18;137;La Croix-Comtesse;223;3;226;17137
75;17;05;11;138;Dampierre-sur-Boutonne;282;3;285;17138
75;17;05;18;139;DÅ“uil-sur-le-Mignon;336;7;343;17139
75;17;02;04;140;Dolus-d'Oléron;3144;62;3206;17140
75;17;04;02;141;Dompierre-sur-Charente;470;9;479;17141
75;17;03;01;142;Dompierre-sur-Mer;5638;143;5781;17142
75;17;04;02;143;Le Douhet;703;13;716;17143
75;17;01;12;145;Echebrune;485;8;493;17145
75;17;02;25;146;Echillais;3547;70;3617;17146
75;17;04;02;147;Ecoyeux;1376;22;1398;17147
75;17;04;19;148;Ecurat;459;10;469;17148
75;17;05;11;149;Les Eduts;59;2;61;17149
75;17;05;11;150;Les Eglises-d'Argenteuil;521;7;528;17150
75;17;02;22;151;L'Eguille;876;23;899;17151
75;17;04;21;152;Epargnes;874;8;882;17152
75;17;03;08;153;Esnandes;2076;32;2108;17153
75;17;04;19;154;Les Essards;712;8;720;17154
75;17;02;26;155;Etaules;2618;43;2661;17155
75;17;01;27;156;Expiremont;129;3;132;17156
75;17;05;18;157;Fenioux;163;2;165;17157
75;17;03;09;158;Ferrières;1066;8;1074;17158
75;17;01;12;159;Fléac-sur-Seugne;365;7;372;17159
75;17;04;21;160;Floirac;413;13;426;17160
75;17;03;05;161;La Flotte;2785;40;2825;17161
75;17;05;11;162;Fontaine-Chalendray;198;1;199;17162
75;17;01;07;163;Fontaines-d'Ozillac;514;10;524;17163
75;17;04;02;164;Fontcouverte;2326;54;2380;17164
75;17;05;11;165;Fontenet;392;13;405;17165
75;17;02;23;166;Forges;1316;14;1330;17166
75;17;01;27;167;Le Fouilloux;771;11;782;17167
75;17;02;03;168;Fouras;3934;75;4009;17168
75;17;04;19;171;Geay;767;18;785;17171
75;17;04;21;172;Gémozac;2906;30;2936;17172
75;17;01;27;173;La Genétouze;234;6;240;17173
75;17;02;25;174;Genouillé;909;9;918;17174
75;17;01;07;175;Germignac;645;7;652;17175
75;17;05;11;176;Gibourne;107;4;111;17176
75;17;05;11;177;Le Gicq;118;0;118;17177
75;17;01;12;178;Givrezac;70;1;71;17178
75;17;04;24;179;Les Gonds;1772;85;1857;17179
75;17;05;11;180;Gourvillette;89;3;92;17180
75;17;05;18;181;Grandjean;310;6;316;17181
75;17;03;09;182;La Grève-sur-Mignon;553;11;564;17182
75;17;04;21;183;Grézac;938;13;951;17183
75;17;02;10;184;La Gripperie-Saint-Symphorien;587;12;599;17184
75;17;02;10;185;Le Gua;2100;32;2132;17185
75;17;03;09;186;Le Gué-d'Alleré;963;11;974;17186
75;17;01;07;187;Guitinières;513;17;530;17187
75;17;05;11;188;Haimps;455;9;464;17188
75;17;03;08;190;L'Houmeau;2865;56;2921;17190
75;17;04;24;191;La Jard;427;9;436;17191
75;17;01;07;192;Jarnac-Champagne;835;18;853;17192
75;17;03;06;193;La Jarne;2541;54;2595;17193
75;17;03;06;194;La Jarrie;3336;75;3411;17194
75;17;05;18;195;La Jarrie-Audouin;274;5;279;17195
75;17;04;21;196;Jazennes;545;6;551;17196
75;17;01;07;197;Jonzac;3519;223;3742;17197
75;17;05;02;198;Juicq;301;0;301;17198
75;17;01;27;199;Jussas;158;2;160;17199
75;17;03;08;200;Lagord;7098;155;7253;17200
75;17;03;09;201;La Laigne;480;6;486;17201
75;17;05;18;202;Landes;587;13;600;17202
75;17;02;23;203;Landrais;729;9;738;17203
75;17;01;07;204;Léoville;306;8;314;17204
75;17;02;25;205;Loire-les-Marais;395;9;404;17205
75;17;05;11;206;Loiré-sur-Nie;283;3;286;17206
75;17;03;05;207;Loix;734;17;751;17207
75;17;03;09;208;Longèves;1051;15;1066;17208
75;17;01;07;209;Lonzac;269;4;273;17209
75;17;01;12;210;Lorignac;505;4;509;17210
75;17;05;18;211;Loulay;751;9;760;17211
75;17;05;11;212;Louzignac;165;2;167;17212
75;17;05;18;213;Lozay;134;4;138;17213
75;17;04;24;214;Luchat;536;12;548;17214
75;17;01;07;215;Lussac;47;0;47;17215
75;17;02;25;216;Lussant;1012;14;1026;17216
75;17;05;11;217;Macqueville;291;7;298;17217
75;17;03;09;218;Marans;4505;64;4569;17218
75;17;02;10;219;Marennes-Hiers-Brouage;6234;103;6337;17219
75;17;01;12;220;Marignac;415;17;432;17220
75;17;02;23;221;Marsais;930;21;951;17221
75;17;03;08;222;Marsilly;3130;93;3223;17222
75;17;05;11;223;Massac;181;2;183;17223
75;17;05;11;224;Matha;2160;80;2240;17224
75;17;02;26;225;Les Mathes;2110;32;2142;17225
75;17;05;18;226;Mazeray;973;14;987;17226
75;17;01;12;227;Mazerolles;221;3;224;17227
75;17;04;22;228;Médis;2992;72;3064;17228
75;17;01;27;229;Mérignac;219;3;222;17229
75;17;02;21;230;Meschers-sur-Gironde;3123;72;3195;17230
75;17;01;27;231;Messac;106;5;111;17231
75;17;04;21;232;Meursac;1530;21;1551;17232
75;17;01;07;233;Meux;325;1;326;17233
75;17;05;18;234;Migré;344;5;349;17234
75;17;04;02;235;Migron;721;14;735;17235
75;17;01;12;236;Mirambeau;1500;29;1529;17236
75;17;02;10;237;MoÃ«ze;585;4;589;17237
75;17;05;11;239;Mons;442;8;450;17239
75;17;01;27;240;Montendre;3226;51;3277;17240
75;17;01;27;241;Montguyon;1565;19;1584;17241
75;17;04;24;242;Montils;869;13;882;17242
75;17;01;27;243;Montlieu-la-Garde;1229;10;1239;17243
75;17;04;21;244;Montpellier-de-Médillan;690;8;698;17244
75;17;03;06;245;Montroy;911;13;924;17245
75;17;02;25;246;Moragne;517;7;524;17246
75;17;02;26;247;Mornac-sur-Seudre;855;12;867;17247
75;17;04;21;248;Mortagne-sur-Gironde;916;20;936;17248
75;17;01;07;249;Mortiers;175;1;176;17249
75;17;01;12;250;Mosnac;476;5;481;17250
75;17;05;18;252;Le Mung;304;7;311;17252
75;17;02;25;253;Muron;1349;16;1365;17253
75;17;05;18;254;Nachamps;187;4;191;17254
75;17;04;19;255;Nancras;798;12;810;17255
75;17;05;02;256;Nantillé;324;12;336;17256
75;17;05;11;257;Néré;683;6;689;17257
75;17;01;07;258;Neuillac;302;5;307;17258
75;17;01;07;259;Neulles;153;2;155;17259
75;17;01;27;260;Neuvicq;466;5;471;17260
75;17;05;11;261;Neuvicq-le-Château;312;6;318;17261
75;17;04;19;262;Nieul-lès-Saintes;1262;22;1284;17262
75;17;01;07;263;Nieul-le-Virouil;585;11;596;17263
75;17;03;08;264;Nieul-sur-Mer;5859;148;6007;17264
75;17;02;10;265;Nieulle-sur-Seudre;1208;20;1228;17265
75;17;05;18;266;Les Nouillers;719;7;726;17266
75;17;03;09;267;Nuaillé-d'Aunis;1165;15;1180;17267
75;17;05;11;268;Nuaillé-sur-Boutonne;191;7;198;17268
75;17;01;27;269;Orignolles;687;7;694;17269
75;17;01;07;270;Ozillac;619;14;633;17270
75;17;05;11;271;Paillé;322;6;328;17271
75;17;01;24;273;Pérignac;1017;13;1030;17273
75;17;03;01;274;Périgny;8684;188;8872;17274
75;17;04;24;275;Pessines;774;26;800;17275
75;17;01;27;276;Le Pin;75;1;76;17276
75;17;05;18;277;Essouvert;1092;86;1178;17277
75;17;04;24;278;Pisany;761;9;770;17278
75;17;01;12;279;Plassac;626;13;639;17279
75;17;04;19;280;Plassay;731;16;747;17280
75;17;01;27;281;Polignac;159;3;162;17281
75;17;01;27;282;Pommiers-Moulons;213;2;215;17282
75;17;01;12;283;Pons;4203;249;4452;17283
75;17;04;19;284;Pont-l'Abbé-d'Arnoult;1776;290;2066;17284
75;17;04;19;285;Port-d'Envaux;1147;27;1174;17285
75;17;03;05;286;Les Portes-en-Ré;594;10;604;17286
75;17;01;27;287;Pouillac;249;0;249;17287
75;17;05;11;288;Poursay-Garnaud;315;6;321;17288
75;17;04;24;289;Préguillac;445;17;462;17289
75;17;05;11;290;Prignac;294;9;303;17290
75;17;03;01;291;Puilboreau;6556;124;6680;17291
75;17;05;18;292;Puy-du-Lac;512;5;517;17292
75;17;02;23;293;Puyravault;695;11;706;17293
75;17;05;18;294;Puyrolland;201;0;201;17294
75;17;01;07;295;Réaux sur Trèfle;794;16;810;17295
75;17;04;24;296;Rétaud;1059;19;1078;17296
75;17;03;05;297;Rivedoux-Plage;2305;43;2348;17297
75;17;04;24;298;Rioux;986;18;1004;17298
75;17;02;13;299;Rochefort;23584;682;24266;17299
75;17;03;99;300;La Rochelle;77205;2128;79333;17300
75;17;05;11;301;Romazières;70;1;71;17301
75;17;04;19;302;Romegoux;593;9;602;17302
75;17;03;09;303;La Ronde;1031;17;1048;17303
75;17;04;24;304;Rouffiac;478;5;483;17304
75;17;01;27;305;Rouffignac;414;9;423;17305
75;17;02;17;306;Royan;18419;527;18946;17306
75;17;04;22;307;Sablonceaux;1391;32;1423;17307
75;17;02;10;308;Saint-Agnant;2700;61;2761;17308
75;17;01;27;309;Saint-Aigulin;1895;39;1934;17309
75;17;04;21;310;Saint-André-de-Lidon;1119;14;1133;17310
75;17;02;26;311;Saint-Augustin;1381;24;1405;17311
75;17;01;12;312;Saint-Bonnet-sur-Gironde;826;14;840;17312
75;17;04;02;313;Saint-Bris-des-Bois;381;9;390;17313
75;17;04;02;314;Saint-Césaire;894;16;910;17314
75;17;03;06;315;Saint-Christophe;1362;28;1390;17315
75;17;01;07;316;Saint-Ciers-Champagne;397;11;408;17316
75;17;01;12;317;Saint-Ciers-du-Taillon;559;5;564;17317
75;17;03;05;318;Saint-Clément-des-Baleines;682;11;693;17318
75;17;01;27;319;Sainte-Colombe;107;1;108;17319
75;17;02;25;320;Saint-Coutant-le-Grand;413;6;419;17320
75;17;02;18;321;Saint-Crépin;361;3;364;17321
75;17;03;09;322;Saint-Cyr-du-Doret;678;4;682;17322
75;17;02;04;323;Saint-Denis-d'Oléron;1283;22;1305;17323
75;17;01;07;324;Saint-Dizant-du-Bois;111;0;111;17324
75;17;01;12;325;Saint-Dizant-du-Gua;538;3;541;17325
75;17;01;07;326;Saint-Eugène;286;5;291;17326
75;17;05;18;327;Saint-Félix;311;3;314;17327
75;17;01;12;328;Saint-Fort-sur-Gironde;902;11;913;17328
75;17;02;10;329;Saint-Froult;357;2;359;17329
75;17;04;19;330;Sainte-Gemme;1340;15;1355;17330
75;17;01;12;331;Saint-Genis-de-Saintonge;1250;50;1300;17331
75;17;01;07;332;Saint-Georges-Antignac;390;6;396;17332
75;17;02;17;333;Saint-Georges-de-Didonne;5342;116;5458;17333
75;17;05;11;334;Saint-Georges-de-Longuepierre;223;4;227;17334
75;17;01;12;335;Saint-Georges-des-Agoûts;288;3;291;17335
75;17;04;19;336;Saint-Georges-des-Coteaux;2741;58;2799;17336
75;17;02;04;337;Saint-Georges-d'Oléron;3742;54;3796;17337
75;17;02;23;338;Saint-Georges-du-Bois;1765;33;1798;17338
75;17;01;07;339;Saint-Germain-de-Lusignan;1278;123;1401;17339
75;17;02;23;340;Saint-Pierre-La-Noue;1536;84;1620;17340
75;17;01;07;341;Saint-Germain-de-Vibrac;181;2;183;17341
75;17;01;12;342;Saint-Germain-du-Seudre;421;9;430;17342
75;17;01;12;343;Saint-Grégoire-d'Ardennes;146;3;149;17343
75;17;05;02;344;Saint-Hilaire-de-Villefranche;1319;15;1334;17344
75;17;01;07;345;Saint-Hilaire-du-Bois;309;15;324;17345
75;17;02;25;346;Saint-Hippolyte;1455;26;1481;17346
75;17;05;18;347;Saint-Jean-d'Angély;6796;434;7230;17347
75;17;02;10;348;Saint-Jean-d'Angle;691;7;698;17348
75;17;03;09;349;Saint-Jean-de-Liversay;2975;43;3018;17349
75;17;05;11;350;Saint-Julien-de-l'Escap;873;16;889;17350
75;17;02;10;351;Saint-Just-Luzac;2026;33;2059;17351
75;17;02;03;353;Saint-Laurent-de-la-Prée;2214;60;2274;17353
75;17;01;12;354;Saint-Léger;645;12;657;17354
75;17;01;07;355;Sainte-Lheurine;503;11;514;17355
75;17;05;18;356;Saint-Loup;306;4;310;17356
75;17;01;07;357;Saint-Maigrin;534;8;542;17357
75;17;05;11;358;Saint-Mandé-sur-Brédoire;311;6;317;17358
75;17;02;23;359;Saint-Mard;1206;20;1226;17359
75;17;03;05;360;Sainte-Marie-de-Ré;3363;106;3469;17360
75;17;05;11;361;Saint-Martial;113;5;118;17361
75;17;01;12;362;Saint-Martial-de-Mirambeau;297;7;304;17362
75;17;01;07;363;Saint-Martial-de-Vitaterne;545;14;559;17363
75;17;01;07;364;Saint-Martial-sur-Né;437;14;451;17364
75;17;01;27;365;Saint-Martin-d'Ary;467;9;476;17365
75;17;01;27;366;Saint-Martin-de-Coux;487;4;491;17366
75;17;05;11;367;Saint-Martin-de-Juillers;157;4;161;17367
75;17;03;05;369;Saint-Martin-de-Ré;2215;20;2235;17369
75;17;01;07;372;Saint-Médard;78;1;79;17372
75;17;03;06;373;Saint-Médard-d'Aunis;2302;43;2345;17373
75;17;05;02;374;Sainte-Même;243;2;245;17374
75;17;02;25;375;Saint-Nazaire-sur-Charente;1201;25;1226;17375
75;17;03;09;376;Saint-Ouen-d'Aunis;1897;32;1929;17376
75;17;05;11;377;Saint-Ouen-la-Thène;125;6;131;17377
75;17;01;27;378;Saint-Palais-de-Négrignac;434;6;440;17378
75;17;01;12;379;Saint-Palais-de-Phiolin;207;3;210;17379
75;17;02;26;380;Saint-Palais-sur-Mer;3907;85;3992;17380
75;17;05;11;381;Saint-Pardoult;228;3;231;17381
75;17;02;23;382;Saint-Pierre-d'Amilly;535;6;541;17382
75;17;05;11;383;Saint-Pierre-de-Juillers;348;4;352;17383
75;17;05;11;384;Saint-Pierre-de-l'Isle;259;4;263;17384
75;17;02;04;385;Saint-Pierre-d'Oléron;6634;98;6732;17385
75;17;01;27;386;Saint-Pierre-du-Palais;353;9;362;17386
75;17;04;19;387;Saint-Porchaire;1896;30;1926;17387
75;17;01;12;388;Saint-Quantin-de-Rançanne;256;7;263;17388
75;17;04;19;389;Sainte-Radegonde;579;9;588;17389
75;17;01;12;390;Sainte-Ramée;116;1;117;17390
75;17;03;06;391;Saint-Rogatien;2352;49;2401;17391
75;17;04;22;393;Saint-Romain-de-Benet;1733;27;1760;17393
75;17;02;23;394;Saint-Saturnin-du-Bois;906;18;924;17394
75;17;04;02;395;Saint-Sauvant;481;8;489;17395
75;17;03;09;396;Saint-Sauveur-d'Aunis;1732;29;1761;17396
75;17;05;18;397;Saint-Savinien;2446;106;2552;17397
75;17;01;12;398;Saint-Seurin-de-Palenne;168;7;175;17398
75;17;04;24;400;Saint-Sever-de-Saintonge;630;13;643;17400
75;17;05;11;401;Saint-Séverin-sur-Boutonne;95;7;102;17401
75;17;01;07;402;Saint-Sigismond-de-Clermont;155;3;158;17402
75;17;01;07;403;Saint-Simon-de-Bordes;747;13;760;17403
75;17;04;21;404;Saint-Simon-de-Pellouaille;659;19;678;17404
75;17;01;12;405;Saint-Sorlin-de-Conac;199;2;201;17405
75;17;02;10;406;Saint-Sornin;413;3;416;17406
75;17;03;06;407;Sainte-Soulle;4846;99;4945;17407
75;17;04;19;408;Saint-Sulpice-d'Arnoult;886;10;896;17408
75;17;02;22;409;Saint-Sulpice-de-Royan;3309;65;3374;17409
75;17;01;12;410;Saint-Thomas-de-Conac;575;9;584;17410
75;17;02;04;411;Saint-Trojan-les-Bains;1145;21;1166;17411
75;17;04;02;412;Saint-Vaize;675;8;683;17412
75;17;03;03;413;Saint-Vivien;1359;21;1380;17413
75;17;03;08;414;Saint-Xandre;5091;163;5254;17414
75;17;04;20;415;Saintes;25287;1407;26694;17415
75;17;05;11;416;Saleignes;59;2;61;17416
75;17;01;12;417;Salignac-de-Mirambeau;165;1;166;17417
75;17;01;24;418;Salignac-sur-Charente;605;16;621;17418
75;17;03;03;420;Salles-sur-Mer;2263;62;2325;17420
75;17;04;22;421;Saujon;7180;117;7297;17421
75;17;05;11;422;Seigné;72;0;72;17422
75;17;01;12;423;Semillac;74;1;75;17423
75;17;01;12;424;Semoussac;382;3;385;17424
75;17;04;22;425;Semussac;2405;45;2450;17425
75;17;04;02;426;Le Seure;252;4;256;17426
75;17;05;11;427;Siecq;216;5;221;17427
75;17;05;11;428;Sonnac;493;10;503;17428
75;17;02;25;429;Soubise;3047;30;3077;17429
75;17;01;12;430;Soubran;401;7;408;17430
75;17;04;19;431;Soulignonne;708;6;714;17431
75;17;01;27;432;Souméras;365;6;371;17432
75;17;01;27;433;Sousmoulins;213;7;220;17433
75;17;02;23;434;Surgères;6786;170;6956;17434
75;17;05;18;435;Taillant;176;1;177;17435
75;17;05;18;436;Taillebourg;756;23;779;17436
75;17;04;21;437;Talmont-sur-Gironde;98;1;99;17437
75;17;04;21;438;Tanzac;303;7;310;17438
75;17;03;09;439;Taugon;784;14;798;17439
75;17;05;18;440;Ternant;374;8;382;17440
75;17;04;24;441;Tesson;1125;24;1149;17441
75;17;04;21;442;Thaims;382;3;385;17442
75;17;03;06;443;Thairé;1723;44;1767;17443
75;17;04;24;444;Thénac;1675;257;1932;17444
75;17;04;24;445;Thézac;330;8;338;17445
75;17;05;11;446;Thors;464;6;470;17446
75;17;02;23;447;Le Thou;1987;31;2018;17447
75;17;05;18;448;Tonnay-Boutonne;1170;14;1184;17448
75;17;02;25;449;Tonnay-Charente;8097;139;8236;17449
75;17;05;18;450;Torxé;230;3;233;17450
75;17;05;11;451;Les Touches-de-Périgny;550;10;560;17451
75;17;02;26;452;La Tremblade;4322;63;4385;17452
75;17;04;19;453;Trizay;1470;33;1503;17453
75;17;01;27;454;Tugéras-Saint-Maurice;375;6;381;17454
75;17;04;19;455;La Vallée;670;11;681;17455
75;17;02;18;457;La Devise;1191;18;1209;17457
75;17;01;27;458;Vanzac;170;0;170;17458
75;17;05;11;459;Varaize;561;10;571;17459
75;17;04;24;460;Varzay;833;17;850;17460
75;17;02;17;461;Vaux-sur-Mer;3926;81;4007;17461
75;17;04;02;462;Vénérand;766;15;781;17462
75;17;02;25;463;Vergeroux;1258;22;1280;17463
75;17;05;18;464;Vergné;151;6;157;17464
75;17;05;18;465;La Vergne;590;8;598;17465
75;17;03;06;466;Vérines;2296;32;2328;17466
75;17;05;11;467;Vervant;235;2;237;17467
75;17;01;07;468;Vibrac;150;3;153;17468
75;17;04;21;469;Villars-en-Pons;575;12;587;17469
75;17;04;02;470;Villars-les-Bois;232;9;241;17470
75;17;05;11;471;La Villedieu;210;3;213;17471
75;17;03;09;472;Villedoux;2278;17;2295;17472
75;17;05;11;473;Villemorin;117;0;117;17473
75;17;05;18;474;Villeneuve-la-Comtesse;739;15;754;17474
75;17;01;07;476;Villexavier;272;3;275;17476
75;17;05;11;477;Villiers-Couture;110;1;111;17477
75;17;05;11;478;Vinax;58;1;59;17478
75;17;04;21;479;Virollet;294;4;298;17479
75;17;02;23;480;Virson;766;10;776;17480
75;17;05;18;481;Voissay;164;3;167;17481
75;17;02;23;482;Vouhé;644;11;655;17482
75;17;03;03;483;Yves;1490;26;1516;17483
75;17;02;25;484;Port-des-Barques;1768;15;1783;17484
75;17;02;04;485;Le Grand-Village-Plage;1070;13;1083;17485
75;17;02;04;486;La Brée-les-Bains;684;6;690;17486
24;18;01;15;001;Achères;380;8;388;18001
24;18;02;08;002;Ainay-le-Vieil;191;4;195;18002
24;18;01;14;003;Les Aix-d'Angillon;1889;28;1917;18003
24;18;01;15;004;Allogny;1070;19;1089;18004
24;18;03;11;005;Allouis;1068;21;1089;18005
24;18;01;17;006;Annoix;237;2;239;18006
24;18;02;10;007;Apremont-sur-Allier;70;3;73;18007
24;18;01;17;008;Arçay;500;10;510;18008
24;18;02;08;009;Arcomps;283;11;294;18009
24;18;02;08;010;Ardenais;199;7;206;18010
24;18;03;01;011;Argent-sur-Sauldre;2063;40;2103;18011
24;18;01;02;012;Argenvières;440;5;445;18012
24;18;02;09;013;Arpheuilles;304;5;309;18013
24;18;01;16;014;Assigny;148;7;155;18014
24;18;03;01;015;Aubigny-sur-Nère;5502;128;5630;18015
24;18;01;14;016;Aubinges;400;3;403;18016
24;18;02;09;017;Augy-sur-Aubois;288;3;291;18017
24;18;01;02;018;Avord;2740;36;2776;18018
24;18;01;14;019;Azy;445;7;452;18019
24;18;01;16;020;Bannay;858;13;871;18020
24;18;02;09;021;Bannegon;273;4;277;18021
24;18;01;16;022;Barlieu;345;8;353;18022
24;18;01;02;023;Baugy;1665;54;1719;18023
24;18;02;08;024;Beddes;99;3;102;18024
24;18;01;02;025;Beffes;617;12;629;18025
24;18;01;16;026;Belleville-sur-Loire;1010;27;1037;18026
24;18;01;02;027;Bengy-sur-Craon;657;67;724;18027
24;18;03;11;028;Berry-Bouy;1183;37;1220;18028
24;18;02;09;029;Bessais-le-Fromental;301;4;305;18029
24;18;03;01;030;Blancafort;1018;22;1040;18030
24;18;02;10;031;Blet;568;5;573;18031
24;18;01;16;032;Boulleret;1396;36;1432;18032
24;18;01;98;033;Bourges;64541;2065;66606;18033
24;18;02;12;034;Bouzais;309;9;318;18034
24;18;01;14;035;Brécy;1043;24;1067;18035
24;18;03;11;036;Brinay;523;7;530;18036
24;18;03;01;037;Brinon-sur-Sauldre;974;14;988;18037
24;18;02;12;038;Bruère-Allichamps;567;4;571;18038
24;18;01;16;039;Bué;318;8;326;18039
24;18;02;09;040;Bussy;362;3;365;18040
24;18;02;08;041;La Celette;192;2;194;18041
24;18;02;12;042;La Celle;353;2;355;18042
24;18;02;08;043;La Celle-Condé;195;0;195;18043
24;18;03;11;044;Cerbois;416;4;420;18044
24;18;02;09;045;Chalivoy-Milon;418;8;426;18045
24;18;02;17;046;Chambon;169;3;172;18046
24;18;03;01;047;La Chapelle-d'Angillon;613;8;621;18047
24;18;02;10;048;La Chapelle-Hugon;381;5;386;18048
24;18;01;02;049;La Chapelle-Montlinard;468;8;476;18049
24;18;01;13;050;La Chapelle-Saint-Ursin;3663;77;3740;18050
24;18;01;14;051;La Chapelotte;136;3;139;18051
24;18;02;09;052;Charenton-du-Cher;1023;21;1044;18052
24;18;01;02;053;Charentonnay;293;8;301;18053
24;18;02;10;054;Charly;246;3;249;18054
24;18;01;07;055;Chârost;941;22;963;18055
24;18;01;02;056;Chassy;239;5;244;18056
24;18;02;08;057;Châteaumeillant;1751;20;1771;18057
24;18;02;17;058;Châteauneuf-sur-Cher;1457;19;1476;18058
24;18;02;08;059;Le Châtelet;943;12;955;18059
24;18;02;09;060;Chaumont;50;2;52;18060
24;18;01;02;061;Chaumoux-Marcilly;90;0;90;18061
24;18;02;10;062;Le Chautay;268;2;270;18062
24;18;02;17;063;Chavannes;162;6;168;18063
24;18;03;11;064;Chéry;216;7;223;18064
24;18;02;08;065;Chezal-Benoît;823;12;835;18065
24;18;01;07;066;Civray;906;15;921;18066
24;18;03;01;067;Clémont;710;9;719;18067
24;18;02;09;068;Cogny;34;2;36;18068
24;18;02;12;069;Colombiers;417;15;432;18069
24;18;01;16;070;Concressault;202;2;204;18070
24;18;02;09;071;Contres;33;0;33;18071
24;18;02;10;072;Cornusse;266;4;270;18072
24;18;02;17;073;Corquoy;203;8;211;18073
24;18;01;16;074;Couargues;200;4;204;18074
24;18;02;10;075;Cours-les-Barres;1013;26;1039;18075
24;18;02;09;076;Coust;442;8;450;18076
24;18;01;02;077;Couy;363;9;372;18077
24;18;02;17;078;Crézançay-sur-Cher;59;1;60;18078
24;18;01;16;079;Crézancy-en-Sancerre;454;6;460;18079
24;18;02;10;080;Croisy;152;2;154;18080
24;18;01;02;081;Crosses;401;3;404;18081
24;18;02;10;082;Cuffy;1032;30;1062;18082
24;18;02;08;083;Culan;750;7;757;18083
24;18;01;16;084;Dampierre-en-Crot;203;4;207;18084
24;18;03;19;085;Dampierre-en-Graçay;240;6;246;18085
24;18;02;12;086;Drevant;549;17;566;18086
24;18;02;09;087;Dun-sur-Auron;3655;76;3731;18087
24;18;03;01;088;Ennordres;212;7;219;18088
24;18;02;08;089;Epineuil-le-Fleuriel;434;10;444;18089
24;18;01;02;090;Etréchy;427;10;437;18090
24;18;02;12;091;Farges-Allichamps;249;6;255;18091
24;18;01;02;092;Farges-en-Septaine;999;24;1023;18092
24;18;02;08;093;Faverdines;139;3;142;18093
24;18;01;16;094;Feux;337;8;345;18094
24;18;02;10;095;Flavigny;180;4;184;18095
24;18;03;11;096;FoÃ«cy;2099;25;2124;18096
24;18;01;15;097;Fussy;1964;32;1996;18097
24;18;01;16;098;Gardefort;129;4;133;18098
24;18;01;02;099;Garigny;223;3;226;18099
24;18;03;19;100;Genouilly;676;16;692;18100
24;18;02;10;101;Germigny-l'Exempt;296;10;306;18101
24;18;02;09;102;Givardon;301;2;303;18102
24;18;03;19;103;Graçay;1432;14;1446;18103
24;18;01;02;104;Groises;133;2;135;18104
24;18;01;02;105;Gron;458;17;475;18105
24;18;02;09;106;Grossouvre;266;3;269;18106
24;18;02;12;107;La Groutte;124;8;132;18107
24;18;02;10;108;La Guerche-sur-l'Aubois;3177;35;3212;18108
24;18;01;14;109;Henrichemont;1729;21;1750;18109
24;18;01;02;110;Herry;967;24;991;18110
24;18;01;14;111;Humbligny;182;1;183;18111
24;18;02;08;112;Ids-Saint-Roch;286;1;287;18112
24;18;02;10;113;Ignol;181;3;184;18113
24;18;02;08;114;Ineuil;226;4;230;18114
24;18;03;01;115;Ivoy-le-Pré;790;8;798;18115
24;18;01;16;116;Jalognes;277;2;279;18116
24;18;01;16;117;Jars;503;5;508;18117
24;18;02;10;118;Jouet-sur-l'Aubois;1322;35;1357;18118
24;18;01;02;119;Jussy-Champagne;203;5;208;18119
24;18;01;02;120;Jussy-le-Chaudrier;593;13;606;18120
24;18;02;09;121;Lantan;92;2;94;18121
24;18;01;17;122;Lapan;215;2;217;18122
24;18;03;11;124;Lazenay;312;3;315;18124
24;18;01;16;125;Léré;1082;23;1105;18125
24;18;01;17;126;Levet;1379;42;1421;18126
24;18;02;08;127;Lignières;1358;27;1385;18127
24;18;03;11;128;Limeux;165;0;165;18128
24;18;01;17;129;Lissay-Lochy;229;6;235;18129
24;18;02;08;130;Loye-sur-Arnon;299;6;305;18130
24;18;02;10;131;Lugny-Bourbonnais;34;0;34;18131
24;18;01;02;132;Lugny-Champagne;137;1;138;18132
24;18;01;07;133;Lunery;1585;15;1600;18133
24;18;03;11;134;Lury-sur-Arnon;659;16;675;18134
24;18;02;08;135;Maisonnais;240;5;245;18135
24;18;02;12;136;Marçais;296;5;301;18136
24;18;01;07;137;Mareuil-sur-Arnon;505;10;515;18137
24;18;01;13;138;Marmagne;1922;57;1979;18138
24;18;01;02;139;Marseilles-lès-Aubigny;655;9;664;18139
24;18;03;11;140;Massay;1365;24;1389;18140
24;18;03;11;141;Mehun-sur-Yèvre;6555;128;6683;18141
24;18;02;12;142;Meillant;686;17;703;18142
24;18;02;10;143;Menetou-Couture;379;7;386;18143
24;18;01;16;144;Menetou-Râtel;467;10;477;18144
24;18;01;15;145;Menetou-Salon;1612;40;1652;18145
24;18;01;16;146;Ménétréol-sous-Sancerre;316;13;329;18146
24;18;03;01;147;Ménétréol-sur-Sauldre;204;3;207;18147
24;18;03;11;148;Méreau;2606;62;2668;18148
24;18;03;01;149;Méry-ès-Bois;575;13;588;18149
24;18;03;19;150;Méry-sur-Cher;694;15;709;18150
24;18;01;14;151;Montigny;352;12;364;18151
24;18;02;08;152;Montlouis;109;2;111;18152
24;18;02;08;153;Morlac;332;3;335;18153
24;18;02;10;154;Mornay-Berry;175;4;179;18154
24;18;02;09;155;Mornay-sur-Allier;430;9;439;18155
24;18;01;14;156;Morogues;436;9;445;18156
24;18;01;07;157;Morthomiers;763;24;787;18157
24;18;01;02;158;Moulins-sur-Yèvre;847;19;866;18158
24;18;03;01;159;Nançay;820;29;849;18159
24;18;02;10;160;Nérondes;1466;30;1496;18160
24;18;02;09;161;Neuilly-en-Dun;219;2;221;18161
24;18;01;14;162;Neuilly-en-Sancerre;255;1;256;18162
24;18;01;14;163;Neuvy-Deux-Clochers;271;5;276;18163
24;18;02;09;164;Neuvy-le-Barrois;132;3;135;18164
24;18;03;01;165;Neuvy-sur-Barangeon;1108;30;1138;18165
24;18;01;02;166;Nohant-en-Goût;574;10;584;18166
24;18;03;19;167;Nohant-en-Graçay;300;2;302;18167
24;18;01;16;168;Le Noyer;217;2;219;18168
24;18;02;12;169;Nozières;213;7;220;18169
24;18;03;01;170;Oizon;668;14;682;18170
24;18;02;12;171;Orcenais;252;4;256;18171
24;18;02;12;172;Orval;1798;44;1842;18172
24;18;02;09;173;Osmery;246;2;248;18173
24;18;01;02;174;Osmoy;263;3;266;18174
24;18;02;10;175;Ourouer-les-Bourdelins;614;3;617;18175
24;18;01;14;176;Parassy;405;5;410;18176
24;18;02;09;177;Parnay;57;0;57;18177
24;18;02;08;178;La Perche;198;3;201;18178
24;18;01;15;179;Pigny;1005;20;1025;18179
24;18;01;17;180;Plaimpied-Givaudins;2069;68;2137;18180
24;18;01;07;181;Plou;539;8;547;18181
24;18;01;07;182;Poisieux;218;5;223;18182
24;18;02;09;183;Le Pondy;148;3;151;18183
24;18;01;02;184;Précy;348;1;349;18184
24;18;03;01;185;Presly;234;1;235;18185
24;18;03;11;186;Preuilly;422;8;430;18186
24;18;02;08;187;Préveranges;512;9;521;18187
24;18;01;07;188;Primelles;249;5;254;18188
24;18;01;15;189;Quantilly;479;4;483;18189
24;18;03;11;190;Quincy;859;18;877;18190
24;18;02;09;191;Raymond;179;2;181;18191
24;18;02;08;192;Reigny;237;3;240;18192
24;18;02;08;193;Rezay;204;5;209;18193
24;18;01;14;194;Rians;971;19;990;18194
24;18;02;09;195;Sagonne;191;5;196;18195
24;18;02;09;196;Saint-Aignan-des-Noyers;82;2;84;18196
24;18;02;12;197;Saint-Amand-Montrond;9488;282;9770;18197
24;18;01;07;198;Saint-Ambroix;371;16;387;18198
24;18;02;08;199;Saint-Baudel;252;4;256;18199
24;18;01;16;200;Saint-Bouize;311;15;326;18200
24;18;01;17;201;Saint-Caprais;771;15;786;18201
24;18;01;14;202;Saint-Céols;13;0;13;18202
24;18;02;08;203;Saint-Christophe-le-Chaudry;97;1;98;18203
24;18;02;09;204;Saint-Denis-de-Palin;290;8;298;18204
24;18;01;13;205;Saint-Doulchard;9607;239;9846;18205
24;18;01;15;206;Saint-Eloy-de-Gy;1549;53;1602;18206
24;18;01;07;207;Saint-Florent-sur-Cher;6442;101;6543;18207
24;18;01;16;208;Sainte-Gemme-en-Sancerrois;411;7;418;18208
24;18;02;08;209;Saint-Georges-de-Poisieux;447;15;462;18209
24;18;03;19;210;Saint-Georges-sur-la-Prée;607;10;617;18210
24;18;01;15;211;Saint-Georges-sur-Moulon;681;12;693;18211
24;18;02;09;212;Saint-Germain-des-Bois;637;15;652;18212
24;18;01;14;213;Saint-Germain-du-Puy;5041;116;5157;18213
24;18;03;19;214;Saint-Hilaire-de-Court;594;2;596;18214
24;18;02;10;215;Saint-Hilaire-de-Gondilly;154;2;156;18215
24;18;02;08;216;Saint-Hilaire-en-Lignières;486;13;499;18216
24;18;02;08;217;Saint-Jeanvrin;147;4;151;18217
24;18;01;17;218;Saint-Just;657;5;662;18218
24;18;03;15;219;Saint-Laurent;508;11;519;18219
24;18;01;02;220;Saint-Léger-le-Petit;349;4;353;18220
24;18;02;17;221;Saint-Loup-des-Chaumes;299;2;301;18221
24;18;01;15;223;Saint-Martin-d'Auxigny;2447;39;2486;18223
24;18;01;02;224;Saint-Martin-des-Champs;297;9;306;18224
24;18;02;08;225;Saint-Maur;277;9;286;18225
24;18;01;14;226;Saint-Michel-de-Volangis;451;15;466;18226
24;18;03;01;227;Sainte-Montaine;172;3;175;18227
24;18;03;19;228;Saint-Outrille;218;3;221;18228
24;18;01;15;229;Saint-Palais;611;19;630;18229
24;18;02;08;230;Saint-Pierre-les-Bois;283;11;294;18230
24;18;02;09;231;Saint-Pierre-les-Etieux;742;18;760;18231
24;18;02;08;232;Saint-Priest-la-Marche;241;3;244;18232
24;18;01;16;233;Saint-Satur;1400;48;1448;18233
24;18;02;08;234;Saint-Saturnin;426;8;434;18234
24;18;01;14;235;Sainte-Solange;1126;18;1144;18235
24;18;02;17;236;Saint-Symphorien;133;2;135;18236
24;18;03;11;237;Sainte-Thorette;478;4;482;18237
24;18;02;08;238;Saint-Vitte;128;3;131;18238
24;18;01;02;240;Sancergues;644;7;651;18240
24;18;01;16;241;Sancerre;1349;30;1379;18241
24;18;02;09;242;Sancoins;2984;33;3017;18242
24;18;01;16;243;Santranges;400;8;408;18243
24;18;01;07;244;Saugy;79;0;79;18244
24;18;02;08;245;Saulzais-le-Potier;487;9;496;18245
24;18;01;16;246;Savigny-en-Sancerre;1107;22;1129;18246
24;18;01;02;247;Savigny-en-Septaine;725;15;740;18247
24;18;01;17;248;Senneçay;468;6;474;18248
24;18;01;16;249;Sens-Beaujeu;402;14;416;18249
24;18;02;17;250;Serruelles;68;2;70;18250
24;18;01;02;251;Sévry;58;2;60;18251
24;18;02;08;252;Sidiailles;295;5;300;18252
24;18;01;14;253;Soulangis;476;13;489;18253
24;18;01;17;254;Soye-en-Septaine;602;16;618;18254
24;18;01;07;255;Le Subdray;1012;204;1216;18255
24;18;01;16;256;Subligny;337;7;344;18256
24;18;01;16;257;Sury-près-Léré;680;14;694;18257
24;18;01;16;258;Sury-en-Vaux;695;16;711;18258
24;18;01;16;259;Sury-ès-Bois;278;3;281;18259
24;18;02;10;260;Tendron;88;2;90;18260
24;18;02;09;261;Thaumiers;410;7;417;18261
24;18;01;16;262;Thauvenay;327;8;335;18262
24;18;03;19;263;Thénioux;663;3;666;18263
24;18;01;16;264;Thou;79;2;81;18264
24;18;02;10;265;Torteron;793;13;806;18265
24;18;02;08;266;Touchay;239;6;245;18266
24;18;01;17;267;Trouy;3953;116;4069;18267
24;18;02;17;268;Uzay-le-Venon;404;10;414;18268
24;18;01;16;269;Vailly-sur-Sauldre;652;13;665;18269
24;18;02;17;270;Vallenay;717;20;737;18270
24;18;01;15;271;Vasselay;1501;34;1535;18271
24;18;01;16;272;Veaugues;632;22;654;18272
24;18;02;17;273;Venesmes;817;16;833;18273
24;18;01;16;274;Verdigny;306;3;309;18274
24;18;02;09;275;Vereaux;142;7;149;18275
24;18;02;09;276;Vernais;189;1;190;18276
24;18;02;09;277;Verneuil;35;0;35;18277
24;18;02;08;278;Vesdun;554;10;564;18278
24;18;03;99;279;Vierzon;25464;522;25986;18279
24;18;01;15;280;Vignoux-sous-les-Aix;717;21;738;18280
24;18;03;15;281;Vignoux-sur-Barangeon;2126;38;2164;18281
24;18;01;02;282;Villabon;581;12;593;18282
24;18;02;08;283;Villecelin;84;0;84;18283
24;18;01;16;284;Villegenon;214;4;218;18284
24;18;01;07;285;Villeneuve-sur-Cher;420;6;426;18285
24;18;01;02;286;Villequiers;464;9;473;18286
24;18;01;16;287;Vinon;292;9;301;18287
24;18;01;17;288;Vorly;243;7;250;18288
24;18;01;02;289;Vornay;591;17;608;18289
24;18;03;15;290;Vouzeron;587;10;597;18290
75;19;02;15;001;Affieux;359;14;373;19001
75;19;03;17;002;Aix;396;8;404;19002
75;19;01;10;003;Albignac;239;9;248;19003
75;19;02;02;004;Albussac;737;10;747;19004
75;19;01;01;005;Allassac;3968;102;4070;19005
75;19;03;12;006;Alleyrat;104;0;104;19006
75;19;01;02;007;Altillac;840;24;864;19007
75;19;03;12;008;Ambrugeat;208;4;212;19008
75;19;02;11;009;Les Angles-sur-Corrèze;122;2;124;19009
75;19;02;02;010;Argentat-sur-Dordogne;2896;112;3008;19010
75;19;01;18;011;Arnac-Pompadour;1136;12;1148;19011
75;19;01;10;012;Astaillac;219;5;224;19012
75;19;01;10;013;Aubazines;887;21;908;19013
75;19;02;02;014;Auriac;225;5;230;19014
75;19;01;19;015;Ayen;701;7;708;19015
75;19;02;11;016;Bar;304;9;313;19016
75;19;02;02;017;Bassignac-le-Bas;87;1;88;19017
75;19;02;02;018;Bassignac-le-Haut;158;4;162;19018
75;19;01;10;019;Beaulieu-sur-Dordogne;1284;20;1304;19019
75;19;02;15;020;Beaumont;110;8;118;19020
75;19;03;12;021;Bellechassagne;91;3;94;19021
75;19;01;18;022;Benayes;223;5;228;19022
75;19;01;10;023;Beynat;1250;20;1270;19023
75;19;01;18;024;Beyssac;598;23;621;19024
75;19;01;18;025;Beyssenac;359;4;363;19025
75;19;01;10;026;Bilhac;250;4;254;19026
75;19;02;12;027;Bonnefond;115;0;115;19027
75;19;03;08;028;Bort-les-Orgues;2648;100;2748;19028
75;19;01;10;029;Branceilles;279;5;284;19029
75;19;01;19;030;Brignac-la-Plaine;962;17;979;19030
75;19;01;99;031;Brive-la-Gaillarde;46330;1285;47615;19031
75;19;03;12;033;Bugeat;793;12;805;19033
75;19;02;02;034;Camps-Saint-Mathurin-Léobazel;220;11;231;19034
75;19;01;19;035;Chabrignac;547;19;566;19035
75;19;02;15;036;Chamberet;1388;15;1403;19036
75;19;02;15;037;Chamboulive;1182;28;1210;19037
75;19;02;11;038;Chameyrat;1521;54;1575;19038
75;19;03;07;039;Champagnac-la-Noaille;227;7;234;19039
75;19;02;14;040;Champagnac-la-Prune;155;5;160;19040
75;19;02;14;041;Chanac-les-Mines;436;18;454;19041
75;19;02;15;042;Chanteix;625;13;638;19042
75;19;01;05;043;La Chapelle-aux-Brocs;442;9;451;19043
75;19;01;10;044;La Chapelle-aux-Saints;279;10;289;19044
75;19;02;02;045;La Chapelle-Saint-Géraud;197;6;203;19045
75;19;03;07;046;Chapelle-Spinasse;113;1;114;19046
75;19;01;13;047;Chartrier-Ferrière;364;6;370;19047
75;19;02;14;048;Le Chastang;356;12;368;19048
75;19;01;13;049;Chasteaux;743;20;763;19049
75;19;01;10;050;Chauffour-sur-Vell;411;10;421;19050
75;19;03;07;051;Chaumeil;163;4;167;19051
75;19;03;12;052;Chavanac;50;1;51;19052
75;19;03;12;053;Chaveroche;258;4;262;19053
75;19;01;10;054;Chenailler-Mascheix;209;4;213;19054
75;19;03;08;055;Chirac-Bellevue;292;12;304;19055
75;19;02;14;056;Clergoux;405;12;417;19056
75;19;01;10;057;Collonges-la-Rouge;483;19;502;19057
75;19;03;12;058;Combressol;341;16;357;19058
75;19;01;19;059;Concèze;392;9;401;19059
75;19;02;18;060;Condat-sur-Ganaveix;688;12;700;19060
75;19;02;14;061;Cornil;1308;12;1320;19061
75;19;02;11;062;Corrèze;1140;48;1188;19062
75;19;01;05;063;Cosnac;2974;79;3053;19063
75;19;03;17;064;Couffy-sur-Sarsonne;72;2;74;19064
75;19;03;17;065;Courteix;71;0;71;19065
75;19;01;13;066;Cublac;1736;36;1772;19066
75;19;01;10;067;Curemonte;208;9;217;19067
75;19;01;09;068;Dampniat;710;6;716;19068
75;19;02;02;069;Darazac;140;3;143;19069
75;19;03;12;070;Darnets;336;12;348;19070
75;19;03;12;071;Davignac;200;3;203;19071
75;19;01;01;072;Donzenac;2678;72;2750;19072
75;19;03;07;073;Egletons;4295;731;5026;19073
75;19;02;15;074;L'Eglise-aux-Bois;54;0;54;19074
75;19;02;14;075;Espagnac;381;14;395;19075
75;19;02;18;076;Espartignac;420;9;429;19076
75;19;01;13;077;Estivals;130;2;132;19077
75;19;01;01;078;Estivaux;419;8;427;19078
75;19;02;18;079;Eyburie;493;10;503;19079
75;19;03;17;080;Eygurande;688;12;700;19080
75;19;02;14;081;Eyrein;506;15;521;19081
75;19;02;11;082;Favars;1097;22;1119;19082
75;19;03;17;083;Feyt;134;2;136;19083
75;19;02;02;084;Forgès;265;12;277;19084
75;19;02;11;085;Gimel-les-Cascades;789;16;805;19085
75;19;02;02;086;Goulles;333;6;339;19086
75;19;02;12;087;Gourdon-Murat;94;3;97;19087
75;19;02;12;088;Grandsaigne;52;1;53;19088
75;19;02;14;089;Gros-Chastang;187;3;190;19089
75;19;02;14;090;Gumond;94;7;101;19090
75;19;02;02;091;Hautefage;317;13;330;19091
75;19;03;07;092;Le Jardin;77;1;78;19092
75;19;01;13;093;Jugeals-Nazareth;964;34;998;19093
75;19;01;19;094;Juillac;1114;26;1140;19094
75;19;02;15;095;Lacelle;136;1;137;19095
75;19;02;14;096;Ladignac-sur-Rondelles;408;11;419;19096
75;19;03;07;097;Lafage-sur-Sombre;134;1;135;19097
75;19;02;14;098;Lagarde-Marc-la-Tour;971;21;992;19098
75;19;01;10;099;Lagleygeolle;220;10;230;19099
75;19;02;15;100;Lagraulière;1097;23;1120;19100
75;19;02;14;101;Laguenne-sur-Avalouze;1542;47;1589;19101
75;19;03;08;102;Lamazière-Basse;297;2;299;19102
75;19;03;17;103;Lamazière-Haute;67;2;69;19103
75;19;02;18;104;Lamongerie;115;1;116;19104
75;19;01;10;105;Lanteuil;487;14;501;19105
75;19;03;07;106;Lapleau;373;2;375;19106
75;19;01;13;107;Larche;1617;45;1662;19107
75;19;03;17;108;Laroche-près-Feyt;60;2;62;19108
75;19;01;19;109;Lascaux;222;7;229;19109
75;19;03;08;110;Latronche;132;0;132;19110
75;19;03;07;111;Laval-sur-Luzège;99;0;99;19111
75;19;02;12;112;Lestards;109;0;109;19112
75;19;03;08;113;Liginiac;644;38;682;19113
75;19;03;12;114;Lignareix;164;10;174;19114
75;19;01;10;115;Ligneyrac;301;8;309;19115
75;19;01;10;116;Liourdres;253;5;258;19116
75;19;01;13;117;Lissac-sur-Couze;698;21;719;19117
75;19;02;15;118;Le Lonzac;810;10;820;19118
75;19;01;10;119;Lostanges;147;1;148;19119
75;19;01;19;120;Louignac;239;1;240;19120
75;19;01;18;121;Lubersac;2236;43;2279;19121
75;19;02;15;122;Madranges;192;10;202;19122
75;19;01;09;123;Malemort;7984;165;8149;19123
75;19;01;13;124;Mansac;1449;22;1471;19124
75;19;03;07;125;Marcillac-la-Croisille;784;17;801;19125
75;19;01;10;126;Marcillac-la-Croze;172;0;172;19126
75;19;03;08;128;Margerides;307;6;313;19128
75;19;02;18;129;Masseret;664;8;672;19129
75;19;03;12;130;Maussac;442;10;452;19130
75;19;02;18;131;Meilhards;538;23;561;19131
75;19;01;10;132;Ménoire;130;1;131;19132
75;19;02;02;133;MercÅ“ur;242;1;243;19133
75;19;03;17;134;Merlines;705;21;726;19134
75;19;03;08;135;Mestes;348;6;354;19135
75;19;03;12;136;Meymac;2308;202;2510;19136
75;19;03;11;137;Meyrignac-l'Eglise;63;0;63;19137
75;19;01;10;138;Meyssac;1264;52;1316;19138
75;19;03;12;139;Millevaches;76;1;77;19139
75;19;02;02;140;Monceaux-sur-Dordogne;635;19;654;19140
75;19;03;17;141;Monestier-Merlines;284;6;290;19141
75;19;03;08;142;Monestier-Port-Dieu;98;3;101;19142
75;19;03;07;143;Montaignac-Saint-Hippolyte;597;14;611;19143
75;19;01;18;144;Montgibaud;235;5;240;19144
75;19;03;07;145;Moustier-Ventadour;445;77;522;19145
75;19;02;11;146;Naves;2336;213;2549;19146
75;19;01;13;147;Nespouls;635;14;649;19147
75;19;03;08;148;Neuvic;1659;252;1911;19148
75;19;02;02;149;Neuville;200;4;204;19149
75;19;01;10;150;Noailhac;363;16;379;19150
75;19;01;13;151;Noailles;935;18;953;19151
75;19;01;10;152;Nonards;436;8;444;19152
75;19;01;19;153;Objat;3624;94;3718;19153
75;19;02;01;154;Orgnac-sur-Vézère;318;9;327;19154
75;19;02;11;155;Orliac-de-Bar;264;5;269;19155
75;19;01;10;156;Palazinges;161;2;163;19156
75;19;03;08;157;Palisse;222;2;224;19157
75;19;02;14;158;Pandrignes;167;4;171;19158
75;19;03;12;159;Péret-Bel-Air;89;1;90;19159
75;19;03;12;160;Pérols-sur-Vézère;192;2;194;19160
75;19;01;19;161;Perpezac-le-Blanc;464;6;470;19161
75;19;02;01;162;Perpezac-le-Noir;1219;17;1236;19162
75;19;01;10;163;Le Pescher;292;7;299;19163
75;19;03;12;164;Peyrelevade;830;11;841;19164
75;19;02;15;165;Peyrissac;122;3;125;19165
75;19;02;15;166;Pierrefitte;93;0;93;19166
75;19;03;08;167;Confolent-Port-Dieu;43;0;43;19167
75;19;02;12;168;Pradines;84;4;88;19168
75;19;01;10;169;Puy-d'Arnac;290;4;294;19169
75;19;01;10;170;Queyssac-les-Vignes;210;9;219;19170
75;19;02;02;171;Reygade;188;3;191;19171
75;19;02;15;172;Rilhac-Treignac;113;5;118;19172
75;19;02;02;173;Rilhac-Xaintrie;305;11;316;19173
75;19;02;14;174;La Roche-Canillac;131;1;132;19174
75;19;03;08;175;Roche-le-Peyroux;94;0;94;19175
75;19;03;07;176;Rosiers-d'Egletons;1086;34;1120;19176
75;19;01;19;177;Rosiers-de-Juillac;176;4;180;19177
75;19;01;01;178;Sadroc;966;23;989;19178
75;19;01;10;179;Saillac;200;6;206;19179
75;19;03;12;180;Saint-Angel;704;18;722;19180
75;19;02;11;181;Saint-Augustin;420;7;427;19181
75;19;01;19;182;Saint-Aulaire;763;23;786;19182
75;19;01;10;184;Saint-Bazile-de-Meyssac;128;4;132;19184
75;19;02;02;186;Saint-Bonnet-Elvert;213;4;217;19186
75;19;01;19;187;Saint-Bonnet-la-Rivière;402;5;407;19187
75;19;01;01;188;Saint-Bonnet-l'Enfantier;413;6;419;19188
75;19;02;02;189;Saint-Bonnet-les-Tours-de-Merle;43;1;44;19189
75;19;03;08;190;Saint-Bonnet-près-Bort;190;5;195;19190
75;19;01;13;191;Saint-Cernin-de-Larche;646;12;658;19191
75;19;02;02;192;Saint-Chamant;499;6;505;19192
75;19;02;02;193;Saint-Cirgues-la-Loutre;174;5;179;19193
75;19;02;15;194;Saint-Clément;1322;36;1358;19194
75;19;01;19;195;Saint-Cyprien;379;6;385;19195
75;19;01;19;196;Saint-Cyr-la-Roche;481;19;500;19196
75;19;01;18;198;Saint-Eloy-les-Tuileries;104;0;104;19198
75;19;03;08;199;Saint-Etienne-aux-Clos;240;5;245;19199
75;19;03;08;200;Saint-Etienne-la-Geneste;89;8;97;19200
75;19;03;08;201;Saint-Exupéry-les-Roches;594;13;607;19201
75;19;01;01;202;Sainte-Féréole;2007;44;2051;19202
75;19;02;14;203;Sainte-Fortunade;1779;92;1871;19203
75;19;03;08;204;Saint-Fréjoux;274;3;277;19204
75;19;02;02;205;Saint-Geniez-ô-Merle;88;2;90;19205
75;19;03;12;206;Saint-Germain-Lavolps;88;2;90;19206
75;19;02;11;207;Saint-Germain-les-Vergnes;1129;32;1161;19207
75;19;03;07;208;Saint-Hilaire-Foissac;185;3;188;19208
75;19;02;15;209;Saint-Hilaire-les-Courbes;165;2;167;19209
75;19;03;08;210;Saint-Hilaire-Luc;66;0;66;19210
75;19;02;11;211;Saint-Hilaire-Peyroux;1004;20;1024;19211
75;19;02;02;212;Saint-Hilaire-Taurieux;104;6;110;19212
75;19;02;15;213;Saint-Jal;624;17;641;19213
75;19;02;02;214;Saint-Julien-aux-Bois;452;3;455;19214
75;19;02;02;215;Saint-Julien-le-Pèlerin;122;2;124;19215
75;19;01;18;216;Saint-Julien-le-Vendômois;247;3;250;19216
75;19;01;10;217;Saint-Julien-Maumont;154;5;159;19217
75;19;03;08;219;Sainte-Marie-Lapanouze;55;1;56;19219
75;19;02;14;220;Saint-Martial-de-Gimel;481;10;491;19220
75;19;02;02;221;Saint-Martial-Entraygues;87;2;89;19221
75;19;02;14;222;Saint-Martin-la-Méanne;340;12;352;19222
75;19;01;18;223;Saint-Martin-Sepert;268;2;270;19223
75;19;03;07;225;Saint-Merd-de-Lapleau;171;2;173;19225
75;19;03;12;226;Saint-Merd-les-Oussines;129;3;132;19226
75;19;02;11;227;Saint-Mexant;1319;35;1354;19227
75;19;03;08;228;Saint-Pantaléon-de-Lapleau;67;1;68;19228
75;19;01;13;229;Saint-Pantaléon-de-Larche;4751;92;4843;19229
75;19;01;18;230;Saint-Pardoux-Corbier;399;8;407;19230
75;19;02;14;231;Saint-Pardoux-la-Croisille;177;2;179;19231
75;19;03;17;232;Saint-Pardoux-le-Neuf;77;2;79;19232
75;19;03;12;233;Saint-Pardoux-le-Vieux;295;14;309;19233
75;19;01;01;234;Saint-Pardoux-l'Ortigier;480;6;486;19234
75;19;02;14;235;Saint-Paul;234;6;240;19235
75;19;02;14;236;Saint-Priest-de-Gimel;482;10;492;19236
75;19;02;02;237;Saint-Privat;1056;22;1078;19237
75;19;03;12;238;Saint-Rémy;222;8;230;19238
75;19;01;19;239;Saint-Robert;295;7;302;19239
75;19;02;15;240;Saint-Salvadour;290;14;304;19240
75;19;03;12;241;Saint-Setiers;285;6;291;19241
75;19;01;19;242;Saint-Solve;458;17;475;19242
75;19;01;18;243;Saint-Sornin-Lavolps;851;17;868;19243
75;19;03;12;244;Saint-Sulpice-les-Bois;85;1;86;19244
75;19;02;02;245;Saint-Sylvain;133;5;138;19245
75;19;01;01;246;Saint-Viance;1877;42;1919;19246
75;19;03;08;247;Saint-Victour;194;8;202;19247
75;19;02;18;248;Saint-Ybard;701;13;714;19248
75;19;03;07;249;Saint-Yrieix-le-Déjalat;342;9;351;19249
75;19;02;18;250;Salon-la-Tour;670;6;676;19250
75;19;03;07;251;Sarran;275;7;282;19251
75;19;03;08;252;Sarroux - Saint Julien;845;16;861;19252
75;19;01;19;253;Segonzac;223;2;225;19253
75;19;01;18;254;Ségur-le-Château;193;1;194;19254
75;19;02;15;255;Seilhac;1778;37;1815;19255
75;19;03;08;256;Sérandon;346;6;352;19256
75;19;01;10;257;Sérilhac;272;7;279;19257
75;19;02;02;258;Servières-le-Château;608;10;618;19258
75;19;02;02;259;Sexcles;234;4;238;19259
75;19;01;10;260;Sioniac;217;7;224;19260
75;19;03;12;261;Sornac;746;15;761;19261
75;19;02;15;262;Soudaine-Lavinadière;155;16;171;19262
75;19;03;12;263;Soudeilles;294;11;305;19263
75;19;03;07;264;Soursac;506;4;510;19264
75;19;02;12;265;Tarnac;344;8;352;19265
75;19;03;08;266;Thalamy;98;4;102;19266
75;19;02;12;268;Toy-Viam;38;0;38;19268
75;19;02;15;269;Treignac;1297;80;1377;19269
75;19;01;01;270;Troche;551;6;557;19270
75;19;01;10;271;Tudeils;241;3;244;19271
75;19;02;16;272;Tulle;14812;663;15475;19272
75;19;01;13;273;Turenne;811;20;831;19273
75;19;01;09;274;Ussac;4215;115;4330;19274
75;19;03;17;275;Ussel;9358;368;9726;19275
75;19;02;18;276;Uzerche;2794;59;2853;19276
75;19;03;08;277;Valiergues;143;5;148;19277
75;19;01;09;278;Varetz;2457;43;2500;19278
75;19;01;19;279;Vars-sur-Roseix;387;10;397;19279
75;19;01;10;280;Végennes;180;4;184;19280
75;19;02;15;281;Veix;72;7;79;19281
75;19;03;08;283;Veyrières;75;1;76;19283
75;19;02;12;284;Viam;87;3;90;19284
75;19;02;01;285;Vigeois;1255;29;1284;19285
75;19;01;19;286;Vignols;535;9;544;19286
75;19;02;07;287;Vitrac-sur-Montane;270;6;276;19287
75;19;01;19;288;Voutezac;1242;164;1406;19288
75;19;01;19;289;Yssandon;668;8;676;19289
27;21;01;20;001;Agencourt;462;52;514;21001
27;21;02;23;002;Agey;266;3;269;21002
27;21;02;14;003;Ahuy;1464;27;1491;21003
27;21;03;05;004;Aignay-le-Duc;269;7;276;21004
27;21;02;15;005;Aiserey;1470;17;1487;21005
27;21;03;05;006;Aisey-sur-Seine;172;1;173;21006
27;21;03;22;007;Aisy-sous-Thil;226;30;256;21007
27;21;03;19;008;Alise-Sainte-Reine;572;7;579;21008
27;21;01;01;009;Allerey;175;1;176;21009
27;21;01;17;010;Aloxe-Corton;136;6;142;21010
27;21;03;05;011;Ampilly-les-Bordes;82;0;82;21011
27;21;03;05;012;Ampilly-le-Sec;344;13;357;21012
27;21;02;23;013;Ancey;450;7;457;21013
27;21;01;01;014;Antheuil;62;0;62;21014
27;21;01;01;015;Antigny-la-Ville;92;0;92;21015
27;21;02;21;016;Arceau;966;19;985;21016
27;21;01;20;017;Arcenant;507;18;525;21017
27;21;02;23;018;Arcey;54;1;55;21018
27;21;01;01;020;Arconcey;224;8;232;21020
27;21;02;21;021;Arc-sur-Tille;2629;49;2678;21021
27;21;01;20;022;Argilly;536;13;549;21022
27;21;01;01;023;Arnay-le-Duc;1384;31;1415;21023
27;21;03;22;024;Arnay-sous-Vitteaux;111;0;111;21024
27;21;03;19;025;Arrans;67;2;69;21025
27;21;03;19;026;Asnières-en-Montagne;189;9;198;21026
27;21;02;14;027;Asnières-lès-Dijon;1312;26;1338;21027
27;21;02;02;028;Athée;781;10;791;21028
27;21;03;19;029;Athie;76;1;77;21029
27;21;01;01;030;Aubaine;88;3;91;21030
27;21;01;04;031;Aubigny-en-Plaine;529;5;534;21031
27;21;01;01;032;Aubigny-la-Ronce;167;5;172;21032
27;21;02;23;033;Aubigny-lès-Sombernon;151;5;156;21033
27;21;03;05;034;Autricourt;131;2;133;21034
27;21;01;04;035;Auvillars-sur-Saône;331;4;335;21035
27;21;01;01;036;Auxant;78;3;81;21036
27;21;01;17;037;Auxey-Duresses;297;12;309;21037
27;21;02;02;038;Auxonne;7614;85;7699;21038
27;21;02;16;039;Avelanges;37;0;37;21039
27;21;03;22;040;Avosnes;95;5;100;21040
27;21;02;16;041;Avot;184;2;186;21041
27;21;01;04;042;Bagnot;161;4;165;21042
27;21;03;05;043;Baigneux-les-Juifs;223;19;242;21043
27;21;03;05;044;Balot;99;1;100;21044
27;21;02;23;045;Barbirey-sur-Ouche;211;8;219;21045
27;21;01;01;046;Bard-le-Régulier;70;2;72;21046
27;21;03;22;047;Bard-lès-Epoisses;69;1;70;21047
27;21;01;20;048;Barges;651;10;661;21048
27;21;02;16;049;Barjon;42;2;44;21049
27;21;01;01;050;Baubigny;207;6;213;21050
27;21;02;23;051;Baulme-la-Roche;85;3;88;21051
27;21;03;05;052;Beaulieu;25;4;29;21052
27;21;02;21;053;Beaumont-sur-Vingeanne;202;4;206;21053
27;21;01;03;054;Beaune;20551;759;21310;21054
27;21;03;05;055;Beaunotte;15;0;15;21055
27;21;02;21;056;Beire-le-Châtel;875;10;885;21056
27;21;02;15;057;Beire-le-Fort;352;5;357;21057
27;21;03;05;058;Belan-sur-Ource;248;5;253;21058
27;21;02;14;059;Bellefond;885;24;909;21059
27;21;02;21;060;Belleneuve;1618;18;1636;21060
27;21;03;05;061;Bellenod-sur-Seine;67;2;69;21061
27;21;01;01;062;Bellenot-sous-Pouilly;220;9;229;21062
27;21;03;05;063;Beneuvre;90;5;95;21063
27;21;03;19;064;Benoisey;112;0;112;21064
27;21;01;01;065;Bessey-en-Chaume;127;4;131;21065
27;21;01;01;066;Bessey-la-Cour;53;1;54;21066
27;21;02;15;067;Bessey-lès-Cîteaux;689;9;698;21067
27;21;01;01;068;Beurey-Bauguay;104;7;111;21068
27;21;03;22;069;Beurizot;121;1;122;21069
27;21;01;18;070;Bévy;139;4;143;21070
27;21;02;21;071;Bèze;701;20;721;21071
27;21;02;21;072;Bézouotte;193;4;197;21072
27;21;02;02;074;Billey;255;4;259;21074
27;21;03;05;075;Billy-lès-Chanceaux;68;1;69;21075
27;21;02;02;076;Binges;827;8;835;21076
27;21;03;05;077;Bissey-la-Côte;127;2;129;21077
27;21;03;05;078;Bissey-la-Pierre;76;2;78;21078
27;21;02;21;079;Blagny-sur-Vingeanne;130;0;130;21079
27;21;02;23;080;Blaisy-Bas;647;13;660;21080
27;21;02;23;081;Blaisy-Haut;128;1;129;21081
27;21;01;01;082;Blancey;64;2;66;21082
27;21;01;01;083;Blanot;124;1;125;21083
27;21;03;19;084;Source-Seine;63;4;67;21084
27;21;02;14;085;Bligny-le-Sec;140;3;143;21085
27;21;01;17;086;Bligny-lès-Beaune;1239;29;1268;21086
27;21;01;01;087;Bligny-sur-Ouche;811;11;822;21087
27;21;01;20;088;Boncourt-le-Bois;281;7;288;21088
27;21;01;04;089;Bonnencontre;437;6;443;21089
27;21;03;05;090;Boudreville;61;3;64;21090
27;21;01;01;091;Bouhey;44;0;44;21091
27;21;01;17;092;Bouilland;222;5;227;21092
27;21;03;05;093;Bouix;152;4;156;21093
27;21;02;21;094;Bourberain;411;4;415;21094
27;21;01;04;095;Bousselange;47;1;48;21095
27;21;02;16;096;Boussenois;107;1;108;21096
27;21;03;22;097;Boussey;38;2;40;21097
27;21;03;19;098;Boux-sous-Salmaise;125;2;127;21098
27;21;01;17;099;Bouze-lès-Beaune;311;6;317;21099
27;21;03;22;100;Brain;34;0;34;21100
27;21;03;22;101;Braux;166;4;170;21101
27;21;01;01;102;Brazey-en-Morvan;142;3;145;21102
27;21;01;04;103;Brazey-en-Plaine;2357;43;2400;21103
27;21;03;05;104;Brémur-et-Vaurois;44;0;44;21104
27;21;02;07;105;Bressey-sur-Tille;1127;12;1139;21105
27;21;02;18;106;Bretenière;929;12;941;21106
27;21;02;14;107;Bretigny;904;24;928;21107
27;21;03;22;108;Brianny;114;1;115;21108
27;21;03;05;109;Brion-sur-Ource;223;7;230;21109
27;21;01;18;110;Brochon;652;131;783;21110
27;21;02;14;111;Brognon;317;3;320;21111
27;21;01;04;112;Broin;415;9;424;21112
27;21;01;20;113;Broindon;198;1;199;21113
27;21;03;19;114;Buffon;159;1;160;21114
27;21;03;05;115;Buncey;369;7;376;21115
27;21;03;05;116;Bure-les-Templiers;134;0;134;21116
27;21;03;05;117;Busseaut;48;2;50;21117
27;21;02;16;118;Busserotte-et-Montenaille;21;3;24;21118
27;21;02;16;119;Bussières;43;0;43;21119
27;21;01;01;120;La Bussière-sur-Ouche;160;2;162;21120
27;21;02;23;121;Bussy-la-Pesle;78;1;79;21121
27;21;03;19;122;Bussy-le-Grand;315;8;323;21122
27;21;03;05;123;Buxerolles;32;5;37;21123
27;21;01;01;124;Censerey;175;6;181;21124
27;21;03;05;125;Cérilly;222;8;230;21125
27;21;02;15;126;Cessey-sur-Tille;617;7;624;21126
27;21;02;16;127;Chaignay;524;8;532;21127
27;21;01;01;128;Chailly-sur-Armançon;242;11;253;21128
27;21;03;05;129;Chambain;22;0;22;21129
27;21;02;15;130;Chambeire;392;4;396;21130
27;21;01;04;131;Chamblanc;464;63;527;21131
27;21;01;18;132;ChambÅ“uf;392;6;398;21132
27;21;01;18;133;Chambolle-Musigny;293;7;300;21133
27;21;03;05;134;Chamesson;242;9;251;21134
27;21;02;21;135;Champagne-sur-Vingeanne;311;8;319;21135
27;21;02;14;136;Champagny;26;0;26;21136
27;21;03;19;137;Champ-d'Oiseau;99;1;100;21137
27;21;02;02;138;Champdôtre;597;8;605;21138
27;21;03;22;139;Champeau-en-Morvan;224;5;229;21139
27;21;01;01;140;Champignolles;75;1;76;21140
27;21;03;22;141;Champrenault;35;1;36;21141
27;21;02;16;142;Chanceaux;213;4;217;21142
27;21;03;05;143;Channay;63;3;66;21143
27;21;03;19;144;Charencey;37;0;37;21144
27;21;03;22;145;Charigny;37;1;38;21145
27;21;02;21;146;Charmes;127;3;130;21146
27;21;03;22;147;Charny;35;1;36;21147
27;21;01;04;148;Charrey-sur-Saône;346;1;347;21148
27;21;03;05;149;Charrey-sur-Seine;140;4;144;21149
27;21;01;17;150;Chassagne-Montrachet;300;11;311;21150
27;21;03;22;151;Chassey;87;5;92;21151
27;21;01;01;152;Châteauneuf;79;2;81;21152
27;21;01;01;153;Châtellenot;155;6;161;21153
27;21;03;05;154;Châtillon-sur-Seine;5347;350;5697;21154
27;21;01;01;155;Chaudenay-la-Ville;41;6;47;21155
27;21;01;01;156;Chaudenay-le-Château;49;0;49;21156
27;21;03;05;157;Chaugey;16;0;16;21157
27;21;02;21;158;Chaume-et-Courchamp;179;5;184;21158
27;21;03;05;159;La Chaume;99;4;103;21159
27;21;03;05;160;Chaume-lès-Baigneux;99;1;100;21160
27;21;03;05;161;Chaumont-le-Bois;79;5;84;21161
27;21;01;20;162;Chaux;483;8;491;21162
27;21;02;16;163;Chazeuil;192;5;197;21163
27;21;01;01;164;Chazilly;143;3;146;21164
27;21;03;05;165;Chemin-d'Aisey;74;4;78;21165
27;21;02;06;166;Chenôve;14025;191;14216;21166
27;21;02;21;167;Cheuge;123;4;127;21167
27;21;03;22;168;Chevannay;40;0;40;21168
27;21;01;18;169;Chevannes;161;4;165;21169
27;21;01;17;170;Chevigny-en-Valière;378;5;383;21170
27;21;02;07;171;Chevigny-Saint-Sauveur;11123;210;11333;21171
27;21;01;04;172;Chivres;304;6;310;21172
27;21;01;17;173;Chorey-les-Beaune;639;15;654;21173
27;21;02;02;175;Cirey-lès-Pontailler;193;1;194;21175
27;21;01;01;176;Civry-en-Montagne;123;2;125;21176
27;21;03;22;177;Clamerey;180;1;181;21177
27;21;01;18;178;Valforêt;306;10;316;21178
27;21;02;14;179;Clénay;898;10;908;21179
27;21;02;02;180;Cléry;153;4;157;21180
27;21;01;01;181;Clomot;141;2;143;21181
27;21;01;18;182;Collonges-lès-Bévy;95;1;96;21182
27;21;02;15;183;Collonges-et-Premières;1055;13;1068;21183
27;21;01;01;184;Colombier;70;0;70;21184
27;21;01;17;185;Combertault;529;20;549;21185
27;21;01;20;186;Comblanchien;616;17;633;21186
27;21;01;01;187;Commarin;123;4;127;21187
27;21;01;17;189;Corberon;436;9;445;21189
27;21;01;17;190;Corcelles-les-Arts;442;19;461;21190
27;21;01;20;191;Corcelles-lès-Cîteaux;811;24;835;21191
27;21;02;13;192;Corcelles-les-Monts;625;10;635;21192
27;21;01;17;193;Corgengoux;366;16;382;21193
27;21;01;20;194;Corgoloin;936;12;948;21194
27;21;01;01;195;Cormot-Vauchignon;219;4;223;21195
27;21;01;17;196;Corpeau;977;16;993;21196
27;21;03;19;197;Corpoyer-la-Chapelle;32;0;32;21197
27;21;03;22;198;Corrombles;255;3;258;21198
27;21;03;22;199;Corsaint;160;2;162;21199
27;21;01;18;200;Couchey;1110;25;1135;21200
27;21;03;05;201;Coulmier-le-Sec;247;5;252;21201
27;21;03;05;202;Courban;148;1;149;21202
27;21;03;22;203;Courcelles-Frémoy;122;2;124;21203
27;21;03;19;204;Courcelles-lès-Montbard;86;1;87;21204
27;21;03;22;205;Courcelles-lès-Semur;240;6;246;21205
27;21;02;16;207;Courlon;79;4;83;21207
27;21;02;16;208;Courtivron;166;4;170;21208
27;21;02;21;209;Couternon;1912;41;1953;21209
27;21;01;01;210;Créancey;526;5;531;21210
27;21;02;16;211;Crécey-sur-Tille;131;2;133;21211
27;21;03;19;212;Crépand;322;4;326;21212
27;21;01;01;214;Crugey;170;4;174;21214
27;21;02;21;215;Cuiserey;185;0;185;21215
27;21;01;01;216;Culètre;105;2;107;21216
27;21;01;18;217;Curley;133;4;137;21217
27;21;02;14;218;Curtil-Saint-Seine;116;0;116;21218
27;21;01;18;219;Curtil-Vergy;141;0;141;21219
27;21;02;16;220;Cussey-les-Forges;144;3;147;21220
27;21;01;01;221;Cussy-la-Colonne;40;2;42;21221
27;21;01;01;222;Cussy-le-Châtel;118;3;121;21222
27;21;02;14;223;Daix;1537;36;1573;21223
27;21;03;22;224;Dampierre-en-Montagne;65;4;69;21224
27;21;02;21;225;Dampierre-et-Flée;131;2;133;21225
27;21;03;19;226;Darcey;343;11;354;21226
27;21;02;14;227;Darois;505;7;512;21227
27;21;01;18;228;Détain-et-Bruant;143;0;143;21228
27;21;01;01;229;Diancey;91;2;93;21229
27;21;02;16;230;Diénay;377;8;385;21230
27;21;02;99;231;Dijon;158002;3378;161380;21231
27;21;03;22;232;Dompierre-en-Morvan;203;5;208;21232
27;21;02;02;233;Drambon;200;1;201;21233
27;21;02;23;234;Drée;61;3;64;21234
27;21;03;05;235;Duesme;53;1;54;21235
27;21;01;17;236;Ebaty;253;6;259;21236
27;21;03;05;237;Echalot;95;3;98;21237
27;21;02;23;238;Echannay;132;2;134;21238
27;21;01;04;239;Echenon;781;11;792;21239
27;21;02;16;240;Echevannes;313;2;315;21240
27;21;01;17;241;Echevronne;292;16;308;21241
27;21;02;15;242;Echigey;298;4;302;21242
27;21;01;01;243;Ecutigny;73;4;77;21243
27;21;01;01;244;Eguilly;67;0;67;21244
27;21;02;16;245;Epagny;318;3;321;21245
27;21;01;20;246;Epernay-sous-Gevrey;182;3;185;21246
27;21;03;22;247;Epoisses;798;13;811;21247
27;21;03;19;248;Eringes;61;1;62;21248
27;21;01;04;249;Esbarres;677;20;697;21249
27;21;03;05;250;Essarois;86;2;88;21250
27;21;01;01;251;Essey;280;27;307;21251
27;21;03;19;252;Etais;79;4;83;21252
27;21;03;05;253;Etalante;138;4;142;21253
27;21;01;18;254;L'Etang-Vergy;208;10;218;21254
27;21;02;14;255;Etaules;325;3;328;21255
27;21;02;02;256;Etevaux;314;7;321;21256
27;21;03;05;257;Etormay;68;2;70;21257
27;21;03;05;258;Etrochey;225;3;228;21258
27;21;03;19;259;Fain-lès-Montbard;287;10;297;21259
27;21;03;19;260;Fain-lès-Moutiers;152;4;156;21260
27;21;02;15;261;Fauverney;619;11;630;21261
27;21;03;05;262;Faverolles-lès-Lucey;30;0;30;21262
27;21;02;18;263;Fénay;1660;41;1701;21263
27;21;01;01;264;Le Fête;43;0;43;21264
27;21;01;18;265;Fixin;750;21;771;21265
27;21;02;14;266;Flacey;192;1;193;21266
27;21;01;20;267;Flagey-Echézeaux;495;13;508;21267
27;21;02;02;268;Flagey-lès-Auxonne;190;3;193;21268
27;21;02;02;269;Flammerans;445;9;454;21269
27;21;02;13;270;Flavignerot;206;7;213;21270
27;21;03;19;271;Flavigny-sur-Ozerain;283;3;286;21271
27;21;03;22;272;Le Val-Larrey;267;4;271;21272
27;21;02;23;273;Fleurey-sur-Ouche;1402;18;1420;21273
27;21;01;01;274;Foissy;165;3;168;21274
27;21;02;16;275;Foncegrive;133;3;136;21275
27;21;03;05;276;Fontaines-en-Duesmois;118;4;122;21276
27;21;02;21;277;Fontaine-Française;886;19;905;21277
27;21;02;14;278;Fontaine-lès-Dijon;8800;204;9004;21278
27;21;03;19;279;Fontaines-les-Sèches;25;0;25;21279
27;21;03;22;280;Fontangy;133;6;139;21280
27;21;02;21;281;Fontenelle;170;2;172;21281
27;21;03;22;282;Forléans;101;2;103;21282
27;21;02;16;283;Fraignot-et-Vesvrotte;65;1;66;21283
27;21;02;16;284;Francheville;292;4;296;21284
27;21;01;04;285;Franxault;497;5;502;21285
27;21;02;16;286;Frénois;88;1;89;21286
27;21;03;19;287;Fresnes;159;7;166;21287
27;21;03;19;288;Frôlois;162;1;163;21288
27;21;01;20;289;Fussey;118;8;126;21289
27;21;02;16;290;Gemeaux;901;13;914;21290
27;21;03;22;291;Genay;365;10;375;21291
27;21;02;15;292;Genlis;5231;44;5275;21292
27;21;02;23;293;Gergueil;118;0;118;21293
27;21;01;20;294;Gerland;433;5;438;21294
27;21;01;18;295;Gevrey-Chambertin;3048;41;3089;21295
27;21;03;05;296;Gevrolles;177;1;178;21296
27;21;01;20;297;Gilly-lès-Cîteaux;720;6;726;21297
27;21;03;22;298;Gissey-le-Vieil;108;3;111;21298
27;21;03;19;299;Gissey-sous-Flavigny;88;1;89;21299
27;21;02;23;300;Gissey-sur-Ouche;354;9;363;21300
27;21;01;04;301;Glanon;267;2;269;21301
27;21;03;05;302;Gomméville;124;2;126;21302
27;21;03;05;303;Les Goulles;9;0;9;21303
27;21;02;16;304;Grancey-le-Château-Neuvelle;255;9;264;21304
27;21;03;05;305;Grancey-sur-Ource;196;2;198;21305
27;21;02;23;306;Grenant-lès-Sombernon;210;3;213;21306
27;21;03;19;307;Grésigny-Sainte-Reine;142;2;144;21307
27;21;03;19;308;Grignon;203;12;215;21308
27;21;03;05;309;Griselles;83;3;86;21309
27;21;02;23;310;Grosbois-en-Montagne;113;2;115;21310
27;21;01;04;311;Grosbois-lès-Tichey;73;1;74;21311
27;21;03;05;312;Gurgy-la-Ville;26;3;29;21312
27;21;03;05;313;Gurgy-le-Château;46;0;46;21313
27;21;03;19;314;Hauteroche;79;2;81;21314
27;21;02;14;315;Hauteville-lès-Dijon;1227;16;1243;21315
27;21;02;02;316;Heuilley-sur-Saône;327;5;332;21316
27;21;02;16;317;Is-sur-Tille;4405;57;4462;21317
27;21;02;15;319;Izeure;894;13;907;21319
27;21;02;15;320;Izier;790;14;804;21320
27;21;03;19;321;Jailly-les-Moulins;77;2;79;21321
27;21;01;04;322;Jallanges;313;14;327;21322
27;21;02;21;323;Jancigny;138;4;142;21323
27;21;03;22;324;Jeux-lès-Bard;51;1;52;21324
27;21;01;01;325;Jouey;183;2;185;21325
27;21;03;05;326;Jours-lès-Baigneux;73;4;77;21326
27;21;01;01;327;Val-Mont;255;4;259;21327
27;21;03;22;328;Juillenay;47;0;47;21328
27;21;03;22;329;Juilly;42;2;44;21329
27;21;02;15;330;Labergement-Foigney;373;3;376;21330
27;21;02;02;331;Labergement-lès-Auxonne;330;4;334;21331
27;21;01;04;332;Labergement-lès-Seurre;996;22;1018;21332
27;21;01;04;333;Labruyère;228;5;233;21333
27;21;01;01;334;Lacanche;512;12;524;21334
27;21;03;22;335;Lacour-d'Arcenay;115;3;118;21335
27;21;03;05;336;Laignes;673;13;686;21336
27;21;02;02;337;Lamarche-sur-Saône;1350;13;1363;21337
27;21;02;16;338;Lamargelle;163;3;166;21338
27;21;02;23;339;Lantenay;511;19;530;21339
27;21;01;04;340;Lanthes;250;5;255;21340
27;21;03;22;341;Lantilly;105;4;109;21341
27;21;01;04;342;Laperrière-sur-Saône;437;9;446;21342
27;21;03;05;343;Larrey;95;1;96;21343
27;21;01;04;344;Lechâtelet;216;5;221;21344
27;21;02;16;345;Léry;188;3;191;21345
27;21;03;05;346;Leuglay;299;3;302;21346
27;21;01;17;347;Levernois;337;17;354;21347
27;21;02;21;348;Licey-sur-Vingeanne;102;1;103;21348
27;21;01;01;349;Liernais;491;8;499;21349
27;21;03;05;350;Lignerolles;54;1;55;21350
27;21;02;15;351;Longchamp;1164;120;1284;21351
27;21;02;15;352;Longeault-Pluvault;1137;16;1153;21352
27;21;02;15;353;Longecourt-en-Plaine;1237;27;1264;21353
27;21;01;01;354;Longecourt-lès-Culêtre;53;0;53;21354
27;21;02;18;355;Longvic;8545;127;8672;21355
27;21;01;04;356;Losne;1596;36;1632;21356
27;21;03;05;357;Louesme;113;3;116;21357
27;21;03;19;358;Lucenay-le-Duc;183;4;187;21358
27;21;03;05;359;Lucey;58;3;61;21359
27;21;01;01;360;Lusigny-sur-Ouche;116;3;119;21360
27;21;02;16;361;Lux;516;12;528;21361
27;21;01;01;362;Maconge;132;3;135;21362
27;21;01;01;363;Magnien;318;6;324;21363
27;21;03;05;364;Magny-Lambert;83;3;86;21364
27;21;03;22;365;Magny-la-Ville;79;0;79;21365
27;21;01;04;366;Magny-lès-Aubigny;214;3;217;21366
27;21;02;02;367;Magny-Montarlot;260;2;262;21367
27;21;01;20;368;Magny-lès-Villers;244;13;257;21368
27;21;02;21;369;Magny-Saint-Médard;316;4;320;21369
27;21;02;07;370;Magny-sur-Tille;902;18;920;21370
27;21;02;02;371;Les Maillys;808;19;827;21371
27;21;03;05;372;Maisey-le-Duc;83;5;88;21372
27;21;02;23;373;Mâlain;783;15;798;21373
27;21;01;01;374;Maligny;191;6;197;21374
27;21;01;01;375;Manlay;187;5;192;21375
27;21;02;02;376;Marandeuil;104;1;105;21376
27;21;03;22;377;Marcellois;47;0;47;21377
27;21;03;05;378;Marcenay;93;2;95;21378
27;21;01;01;379;Marcheseuil;160;1;161;21379
27;21;03;22;380;Marcigny-sous-Thil;56;2;58;21380
27;21;03;22;381;Marcilly-et-Dracy;92;4;96;21381
27;21;01;01;382;Marcilly-Ogny;192;3;195;21382
27;21;02;16;383;Marcilly-sur-Tille;1688;21;1709;21383
27;21;01;20;384;Marey-lès-Fussey;56;5;61;21384
27;21;02;16;385;Marey-sur-Tille;325;8;333;21385
27;21;03;19;386;Marigny-le-CahouÃ«t;323;12;335;21386
27;21;01;17;387;Marigny-lès-Reullée;220;5;225;21387
27;21;02;15;388;Marliens;596;11;607;21388
27;21;03;19;389;Marmagne;207;1;208;21389
27;21;02;06;390;Marsannay-la-Côte;5311;76;5387;21390
27;21;02;16;391;Marsannay-le-Bois;843;10;853;21391
27;21;01;01;392;Martrois;60;1;61;21392
27;21;03;05;393;Massingy;153;8;161;21393
27;21;03;22;394;Massingy-lès-Semur;158;4;162;21394
27;21;03;22;395;Massingy-lès-Vitteaux;91;1;92;21395
27;21;03;05;396;Mauvilly;69;2;71;21396
27;21;01;17;397;Mavilly-Mandelot;179;3;182;21397
27;21;02;02;398;Maxilly-sur-Saône;361;8;369;21398
27;21;01;01;399;Meilly-sur-Rouvres;213;2;215;21399
27;21;02;16;400;Le Meix;48;0;48;21400
27;21;01;17;401;Meloisey;320;5;325;21401
27;21;03;05;402;Menesble;9;0;9;21402
27;21;01;01;403;Ménessaire;86;1;87;21403
27;21;03;19;404;Ménétreux-le-Pitois;420;16;436;21404
27;21;01;17;405;Merceuil;807;22;829;21405
27;21;02;23;406;Mesmont;248;2;250;21406
27;21;01;18;407;Messanges;236;11;247;21407
27;21;02;14;408;Messigny-et-Vantoux;1690;29;1719;21408
27;21;01;20;409;Meuilley;462;13;475;21409
27;21;03;05;410;Meulson;30;2;32;21410
27;21;01;17;411;Meursanges;567;18;585;21411
27;21;01;17;412;Meursault;1408;45;1453;21412
27;21;03;22;413;Millery;397;15;412;21413
27;21;01;01;414;Mimeure;315;9;324;21414
27;21;03;05;415;Minot;178;5;183;21415
27;21;02;21;416;Mirebeau-sur-Bèze;2008;37;2045;21416
27;21;03;22;417;Missery;108;0;108;21417
27;21;03;05;418;Moitron;59;4;63;21418
27;21;03;05;419;Molesme;264;5;269;21419
27;21;01;01;420;Molinot;161;3;164;21420
27;21;02;16;421;Moloy;233;3;236;21421
27;21;03;22;422;Molphey;130;4;134;21422
27;21;01;17;423;Montagny-lès-Beaune;747;23;770;21423
27;21;01;04;424;Montagny-lès-Seurre;111;2;113;21424
27;21;03;19;425;Montbard;4848;132;4980;21425
27;21;03;22;426;Montberthault;206;3;209;21426
27;21;01;01;427;Montceau-et-Echarnant;188;5;193;21427
27;21;01;17;428;Monthelie;166;4;170;21428
27;21;03;19;429;Montigny-Montfort;296;6;302;21429
27;21;03;22;430;Montigny-Saint-Barthélemy;85;5;90;21430
27;21;03;22;431;Montigny-sur-Armançon;147;5;152;21431
27;21;03;05;432;Montigny-sur-Aube;253;4;257;21432
27;21;02;21;433;Montigny-Mornay-Villeneuve-sur-Vingeanne;386;7;393;21433
27;21;03;22;434;Montlay-en-Auxois;192;1;193;21434
27;21;03;05;435;Montliot-et-Courcelles;301;6;307;21435
27;21;01;04;436;Montmain;156;3;159;21436
27;21;02;02;437;Montmançon;243;5;248;21437
27;21;03;05;438;Montmoyen;74;3;77;21438
27;21;02;23;439;Montoillot;88;0;88;21439
27;21;01;04;440;Montot;194;5;199;21440
27;21;01;01;441;Mont-Saint-Jean;239;7;246;21441
27;21;01;18;442;Morey-Saint-Denis;664;11;675;21442
27;21;03;05;444;Mosson;69;0;69;21444
27;21;03;22;445;La Motte-Ternant;144;2;146;21445
27;21;03;19;446;Moutiers-Saint-Jean;261;5;266;21446
27;21;01;01;447;Musigny;81;0;81;21447
27;21;03;19;448;Mussy-la-Fosse;87;1;88;21448
27;21;03;22;449;Nan-sous-Thil;182;3;185;21449
27;21;01;17;450;Nantoux;166;5;171;21450
27;21;03;19;451;Nesle-et-Massoult;76;3;79;21451
27;21;02;07;452;Neuilly-Crimolois;3036;34;3070;21452
27;21;03;05;454;Nicey;111;0;111;21454
27;21;03;05;455;Nod-sur-Seine;199;8;207;21455
27;21;03;19;456;Nogent-lès-Montbard;153;8;161;21456
27;21;03;22;457;Noidan;73;5;78;21457
27;21;01;20;458;Noiron-sous-Gevrey;1153;16;1169;21458
27;21;02;21;459;Noiron-sur-Bèze;233;5;238;21459
27;21;03;05;460;Noiron-sur-Seine;65;1;66;21460
27;21;01;01;461;Nolay;1435;22;1457;21461
27;21;02;14;462;Norges-la-Ville;948;18;966;21462
27;21;03;22;463;Normier;56;1;57;21463
27;21;01;20;464;Nuits-Saint-Georges;5362;91;5453;21464
27;21;03;05;465;Obtrée;77;1;78;21465
27;21;03;05;466;Oigny;40;4;44;21466
27;21;02;21;467;Oisilly;128;4;132;21467
27;21;02;21;468;Orain;88;1;89;21468
27;21;02;14;469;Orgeux;459;13;472;21469
27;21;03;05;470;Origny;51;3;54;21470
27;21;03;05;471;Orret;15;0;15;21471
27;21;02;16;472;Orville;170;1;171;21472
27;21;02;18;473;Ouges;1604;11;1615;21473
27;21;01;04;474;Pagny-la-Ville;415;11;426;21474
27;21;01;04;475;Pagny-le-Château;506;10;516;21475
27;21;01;01;476;Painblanc;163;5;168;21476
27;21;02;14;477;Panges;83;2;85;21477
27;21;02;23;478;Pasques;285;5;290;21478
27;21;02;16;479;Pellerey;90;1;91;21479
27;21;01;17;480;Pernand-Vergelesses;236;9;245;21480
27;21;02;18;481;Perrigny-lès-Dijon;2138;33;2171;21481
27;21;02;02;482;Perrigny-sur-l'Ognon;635;15;650;21482
27;21;02;16;483;Pichanges;294;5;299;21483
27;21;03;19;484;Planay;65;5;70;21484
27;21;02;23;485;Plombières-lès-Dijon;2542;46;2588;21485
27;21;02;15;487;Pluvet;411;3;414;21487
27;21;03;05;488;Poinçon-lès-Larrey;192;2;194;21488
27;21;02;16;489;Poiseul-la-Grange;55;4;59;21489
27;21;03;05;490;Poiseul-la-Ville-et-Laperrière;157;7;164;21490
27;21;02;16;491;Poiseul-lès-Saulx;69;1;70;21491
27;21;01;17;492;Pommard;454;12;466;21492
27;21;02;02;493;Poncey-lès-Athée;571;7;578;21493
27;21;02;16;494;Poncey-sur-l'Ignon;83;0;83;21494
27;21;02;02;495;Pont;155;1;156;21495
27;21;02;02;496;Pontailler-sur-Saône;1301;20;1321;21496
27;21;03;22;497;Pont-et-Massène;173;15;188;21497
27;21;03;22;498;Posanges;49;2;51;21498
27;21;03;05;499;Pothières;203;4;207;21499
27;21;03;19;500;Pouillenay;551;9;560;21500
27;21;01;01;501;Pouilly-en-Auxois;1537;119;1656;21501
27;21;01;04;502;Pouilly-sur-Saône;602;7;609;21502
27;21;02;21;503;Pouilly-sur-Vingeanne;132;4;136;21503
27;21;02;23;504;Prâlon;91;3;94;21504
27;21;03;22;505;Précy-sous-Thil;710;10;720;21505
27;21;01;20;506;Premeaux-Prissey;373;5;378;21506
27;21;02;14;508;Prenois;446;8;454;21508
27;21;03;05;510;Prusly-sur-Ource;155;1;156;21510
27;21;03;05;511;Puits;128;4;132;21511
27;21;01;17;512;Puligny-Montrachet;383;10;393;21512
27;21;03;05;514;Quemigny-sur-Seine;102;3;105;21514
27;21;02;07;515;Quetigny;9099;381;9480;21515
27;21;03;19;516;Quincerot;77;4;81;21516
27;21;01;20;517;Quincey;507;12;519;21517
27;21;03;19;518;Quincy-le-Vicomte;204;2;206;21518
27;21;03;05;519;Recey-sur-Ource;351;8;359;21519
27;21;02;23;520;Remilly-en-Montagne;151;0;151;21520
27;21;02;21;521;Remilly-sur-Tille;892;11;903;21521
27;21;02;21;522;Renève;447;5;452;21522
27;21;01;18;523;Reulle-Vergy;150;2;152;21523
27;21;03;05;524;Riel-les-Eaux;92;0;92;21524
27;21;03;22;525;La Roche-en-Brenil;889;14;903;21525
27;21;03;05;526;Rochefort-sur-Brévon;41;0;41;21526
27;21;01;01;527;La Rochepot;285;9;294;21527
27;21;03;19;528;La Roche-Vanneau;141;2;143;21528
27;21;03;22;529;Roilly;49;1;50;21529
27;21;03;19;530;Rougemont;149;1;150;21530
27;21;03;22;531;Rouvray;484;5;489;21531
27;21;02;15;532;Rouvres-en-Plaine;1155;11;1166;21532
27;21;01;01;533;Rouvres-sous-Meilly;87;3;90;21533
27;21;01;17;534;Ruffey-lès-Beaune;731;42;773;21534
27;21;02;14;535;Ruffey-lès-Echirey;1328;10;1338;21535
27;21;02;16;536;Sacquenay;291;11;302;21536
27;21;03;22;537;Saffres;115;2;117;21537
27;21;03;22;538;Saint-Andeux;118;4;122;21538
27;21;02;23;539;Saint-Anthot;56;1;57;21539
27;21;02;21;540;Saint-Apollinaire;7546;101;7647;21540
27;21;01;17;541;Saint-Aubin;221;8;229;21541
27;21;01;20;542;Saint-Bernard;450;0;450;21542
27;21;03;05;543;Saint-Broing-les-Moines;193;8;201;21543
27;21;03;22;544;Sainte-Colombe-en-Auxois;58;6;64;21544
27;21;03;05;545;Sainte-Colombe-sur-Seine;929;15;944;21545
27;21;03;22;546;Saint-Didier;207;4;211;21546
27;21;03;22;547;Saint-Euphrône;199;3;202;21547
27;21;03;22;548;Saint-Germain-de-Modéon;182;3;185;21548
27;21;03;05;549;Saint-Germain-le-Rocheux;82;4;86;21549
27;21;03;19;550;Saint-Germain-lès-Senailly;131;5;136;21550
27;21;03;22;552;Saint-Hélier;36;1;37;21552
27;21;02;23;553;Saint-Jean-de-BÅ“uf;109;3;112;21553
27;21;01;04;554;Saint-Jean-de-Losne;1063;7;1070;21554
27;21;02;14;555;Saint-Julien;1500;21;1521;21555
27;21;02;02;556;Saint-Léger-Triey;243;3;246;21556
27;21;03;05;557;Saint-Marc-sur-Seine;109;3;112;21557
27;21;01;17;558;Sainte-Marie-la-Blanche;900;31;931;21558
27;21;02;23;559;Sainte-Marie-sur-Ouche;692;11;703;21559
27;21;01;01;560;Saint-Martin-de-la-Mer;300;2;302;21560
27;21;02;14;561;Saint-Martin-du-Mont;453;1;454;21561
27;21;02;21;562;Saint-Maurice-sur-Vingeanne;198;6;204;21562
27;21;03;22;563;Saint-Mesmin;121;2;123;21563
27;21;01;20;564;Saint-Nicolas-lès-Cîteaux;407;9;416;21564
27;21;01;20;565;Saint-Philibert;508;8;516;21565
27;21;01;01;566;Saint-Pierre-en-Vaux;142;3;145;21566
27;21;01;01;567;Saint-Prix-lès-Arnay;215;5;220;21567
27;21;03;19;568;Saint-Rémy;691;11;702;21568
27;21;01;17;569;Saint-Romain;220;6;226;21569
27;21;01;01;570;Sainte-Sabine;169;16;185;21570
27;21;02;02;571;Saint-Sauveur;238;2;240;21571
27;21;01;04;572;Saint-Seine-en-Bâche;399;5;404;21572
27;21;02;14;573;Saint-Seine-l'Abbaye;372;3;375;21573
27;21;02;21;574;Saint-Seine-sur-Vingeanne;386;9;395;21574
27;21;01;04;575;Saint-Symphorien-sur-Saône;344;4;348;21575
27;21;03;22;576;Saint-Thibault;161;4;165;21576
27;21;01;04;577;Saint-Usage;1344;25;1369;21577
27;21;02;23;578;Saint-Victor-sur-Ouche;322;4;326;21578
27;21;02;16;579;Salives;208;6;214;21579
27;21;03;19;580;Salmaise;135;2;137;21580
27;21;01;04;581;Samerey;145;2;147;21581
27;21;01;17;582;Santenay;908;12;920;21582
27;21;01;01;583;Santosse;55;2;57;21583
27;21;03;22;584;Saulieu;2372;109;2481;21584
27;21;01;20;585;Saulon-la-Chapelle;969;14;983;21585
27;21;01;20;586;Saulon-la-Rue;718;10;728;21586
27;21;02;16;587;Saulx-le-Duc;246;4;250;21587
27;21;01;01;588;Saussey;68;1;69;21588
27;21;02;14;589;Saussy;102;1;103;21589
27;21;01;17;590;Savigny-lès-Beaune;1288;41;1329;21590
27;21;02;14;591;Savigny-le-Sec;861;14;875;21591
27;21;02;23;592;Savigny-sous-Mâlain;228;11;239;21592
27;21;01;01;593;Savilly;79;1;80;21593
27;21;03;05;594;Savoisy;193;3;196;21594
27;21;02;21;595;Savolles;163;4;167;21595
27;21;01;20;596;Savouges;385;6;391;21596
27;21;01;18;597;Segrois;53;1;54;21597
27;21;03;19;598;Seigny;174;2;176;21598
27;21;02;16;599;Selongey;2407;34;2441;21599
27;21;01;01;600;Semarey;124;4;128;21600
27;21;01;18;601;Semezanges;96;4;100;21601
27;21;03;05;602;Semond;26;0;26;21602
27;21;03;22;603;Semur-en-Auxois;4120;353;4473;21603
27;21;03;19;604;Senailly;140;4;144;21604
27;21;02;07;605;Sennecey-lès-Dijon;1966;52;2018;21605
27;21;01;17;606;Ladoix-Serrigny;1809;46;1855;21606
27;21;01;04;607;Seurre;2310;22;2332;21607
27;21;03;22;608;Sincey-lès-Rouvray;98;4;102;21608
27;21;02;02;609;Soirans;497;7;504;21609
27;21;02;02;610;Soissons-sur-Nacey;362;7;369;21610
27;21;02;23;611;Sombernon;915;13;928;21611
27;21;03;22;612;Souhey;87;1;88;21612
27;21;03;22;613;Soussey-sur-Brionne;157;8;165;21613
27;21;02;16;614;Spoy;399;4;403;21614
27;21;01;01;615;Sussey;241;8;249;21615
27;21;01;17;616;Tailly;190;7;197;21616
27;21;02;23;617;Talant;11713;226;11939;21617
27;21;02;02;618;Talmay;579;8;587;21618
27;21;02;21;619;Tanay;218;6;224;21619
27;21;02;16;620;Tarsul;159;5;164;21620
27;21;02;15;622;Tart-le-Bas;255;4;259;21622
27;21;02;15;623;Tart;1578;34;1612;21623
27;21;02;02;624;Tellecey;141;1;142;21624
27;21;01;18;625;Ternant;81;3;84;21625
27;21;03;05;626;Terrefondrée;60;2;62;21626
27;21;03;19;627;Thenissey;95;9;104;21627
27;21;03;05;628;Thoires;65;0;65;21628
27;21;03;22;629;Thoisy-la-Berchère;305;5;310;21629
27;21;01;01;630;Thoisy-le-Désert;213;8;221;21630
27;21;01;01;631;Thomirey;54;0;54;21631
27;21;02;15;632;Thorey-en-Plaine;1040;31;1071;21632
27;21;03;22;633;Thorey-sous-Charny;188;1;189;21633
27;21;01;01;634;Thorey-sur-Ouche;137;0;137;21634
27;21;03;22;635;Thoste;104;6;110;21635
27;21;01;01;636;Thury;254;8;262;21636
27;21;01;04;637;Tichey;213;3;216;21637
27;21;02;16;638;Til-Châtel;1138;7;1145;21638
27;21;02;02;639;Tillenay;746;14;760;21639
27;21;03;22;640;Torcy-et-Pouligny;215;5;220;21640
27;21;03;19;641;Touillon;457;12;469;21641
27;21;03;22;642;Toutry;423;8;431;21642
27;21;02;02;643;Tréclun;445;8;453;21643
27;21;02;21;644;Trochères;170;4;174;21644
27;21;01;04;645;Trouhans;598;16;614;21645
27;21;02;14;646;Trouhaut;123;3;126;21646
27;21;01;04;647;Trugny;119;1;120;21647
27;21;02;14;648;Turcey;175;1;176;21648
27;21;03;22;649;Uncey-le-Franc;53;0;53;21649
27;21;01;18;650;Urcy;149;4;153;21650
27;21;02;14;651;Val-Suzon;202;4;206;21651
27;21;01;01;652;Vandenesse-en-Auxois;297;7;304;21652
27;21;03;05;653;Vannaire;51;2;53;21653
27;21;03;05;655;Vanvey;232;10;242;21655
27;21;02;15;656;Varanges;697;11;708;21656
27;21;02;21;657;Varois-et-Chaignot;1944;49;1993;21657
27;21;02;16;659;Vaux-Saules;168;10;178;21659
27;21;01;01;660;Veilly;49;1;50;21660
27;21;02;23;661;Velars-sur-Ouche;1744;26;1770;21661
27;21;03;22;662;Velogny;33;0;33;21662
27;21;03;19;663;Venarey-les-Laumes;2846;37;2883;21663
27;21;03;19;664;Verdonnet;82;4;86;21664
27;21;02;16;665;Vernois-lès-Vesvres;170;0;170;21665
27;21;02;16;666;Vernot;94;3;97;21666
27;21;02;16;667;Véronnes;399;7;406;21667
27;21;02;23;669;Verrey-sous-Drée;81;0;81;21669
27;21;03;19;670;Verrey-sous-Salmaise;281;4;285;21670
27;21;03;05;671;Vertault;52;1;53;21671
27;21;03;22;672;Vesvres;28;1;29;21672
27;21;01;01;673;Veuvey-sur-Ouche;215;2;217;21673
27;21;03;05;674;Veuxhaulles-sur-Aube;201;3;204;21674
27;21;01;01;675;Vianges;39;1;40;21675
27;21;03;22;676;Vic-de-Chassenay;215;5;220;21676
27;21;01;01;677;Vic-des-Prés;116;1;117;21677
27;21;03;22;678;Vic-sous-Thil;185;3;188;21678
27;21;02;23;679;Vieilmoulin;129;2;131;21679
27;21;02;02;680;Vielverge;504;7;511;21680
27;21;03;22;681;Vieux-Château;86;1;87;21681
27;21;02;21;682;Viévigne;269;1;270;21682
27;21;01;01;683;Viévy;356;3;359;21683
27;21;01;17;684;Vignoles;951;49;1000;21684
27;21;03;05;685;Villaines-en-Duesmois;252;6;258;21685
27;21;03;19;686;Villaines-les-Prévôtes;144;2;146;21686
27;21;03;22;687;Villargoix;139;5;144;21687
27;21;01;20;688;Villars-Fontaine;113;4;117;21688
27;21;03;22;689;Villars-et-Villenotte;168;7;175;21689
27;21;03;22;690;Villeberny;92;2;94;21690
27;21;01;20;691;Villebichot;396;7;403;21691
27;21;02;16;692;Villecomte;252;4;256;21692
27;21;03;05;693;Villedieu;69;1;70;21693
27;21;03;22;694;Villeferry;26;0;26;21694
27;21;03;19;695;La Villeneuve-les-Convers;60;1;61;21695
27;21;03;22;696;Villeneuve-sous-Charigny;96;2;98;21696
27;21;01;20;698;Villers-la-Faye;385;9;394;21698
27;21;02;02;699;Villers-les-Pots;1167;13;1180;21699
27;21;03;05;700;Villers-Patras;86;3;89;21700
27;21;02;02;701;Villers-Rotin;126;5;131;21701
27;21;02;16;702;Villey-sur-Tille;266;7;273;21702
27;21;01;01;703;Villiers-en-Morvan;48;0;48;21703
27;21;03;05;704;Villiers-le-Duc;100;0;100;21704
27;21;02;14;705;Villotte-Saint-Seine;77;1;78;21705
27;21;03;05;706;Villotte-sur-Ource;104;1;105;21706
27;21;03;22;707;Villy-en-Auxois;217;4;221;21707
27;21;01;20;708;Villy-le-Moutier;331;12;343;21708
27;21;03;19;709;Viserny;178;2;180;21709
27;21;03;22;710;Vitteaux;1064;18;1082;21710
27;21;03;05;711;Vix;102;4;106;21711
27;21;01;17;712;Volnay;233;15;248;21712
27;21;02;02;713;Vonges;342;5;347;21713
27;21;01;20;714;Vosne-Romanée;339;9;348;21714
27;21;01;01;715;Voudenay;192;1;193;21715
27;21;01;20;716;Vougeot;171;5;176;21716
27;21;03;05;717;Voulaines-les-Templiers;276;11;287;21717
53;22;04;10;001;Allineuc;599;18;617;22001
53;22;04;06;002;Andel;1144;36;1180;22002
53;22;01;04;003;Aucaleuc;928;77;1005;22003
53;22;02;01;004;Bégard;4809;92;4901;22004
53;22;02;03;005;Belle-Isle-en-Terre;1026;16;1042;22005
53;22;03;01;006;Berhet;268;9;277;22006
53;22;01;08;008;Bobital;1125;40;1165;22008
53;22;04;13;009;Le Bodéo;160;1;161;22009
53;22;02;15;011;Boqueho;1062;27;1089;22011
53;22;04;17;012;La Bouillie;881;17;898;22012
53;22;02;03;013;Bourbriac;2122;44;2166;22013
53;22;01;14;014;Bourseul;1165;29;1194;22014
53;22;04;16;015;Bréhand;1680;30;1710;22015
53;22;04;11;016;ÃŽle-de-Bréhat;352;6;358;22016
53;22;02;01;018;Brélidy;295;5;300;22018
53;22;02;15;019;Bringolo;488;13;501;22019
53;22;01;02;020;Broons;2902;68;2970;22020
53;22;01;08;021;Brusvily;1176;25;1201;22021
53;22;02;03;023;Bulat-Pestivien;421;1;422;22023
53;22;02;03;024;Calanhel;227;1;228;22024
53;22;02;03;025;Callac;2229;33;2262;22025
53;22;01;08;026;Calorguen;744;8;752;22026
53;22;04;09;027;Le Cambout;417;12;429;22027
53;22;03;27;028;Camlez;841;25;866;22028
53;22;02;23;029;Canihuel;348;13;361;22029
53;22;03;01;030;CaouÃ«nnec-Lanvézéac;889;21;910;22030
53;22;02;03;031;CarnoÃ«t;653;9;662;22031
53;22;01;02;032;Caulnes;2495;144;2639;22032
53;22;04;10;033;Caurel;359;11;370;22033
53;22;03;01;034;Cavan;1532;58;1590;22034
53;22;01;08;035;Les Champs-Géraux;1036;15;1051;22035
53;22;01;02;036;La Chapelle-Blanche;210;4;214;22036
53;22;02;03;037;La Chapelle-Neuve;386;4;390;22037
53;22;04;09;039;La Chèze;554;27;581;22039
53;22;02;03;040;Coadout;582;9;591;22040
53;22;03;01;041;Coatascorn;263;3;266;22041
53;22;03;27;042;Coatréven;495;15;510;22042
53;22;04;09;043;CoÃ«tlogon;211;5;216;22043
53;22;04;06;044;CoÃ«tmieux;1781;50;1831;22044
53;22;02;15;045;Cohiniac;345;7;352;22045
53;22;04;16;046;Le Mené;6396;115;6511;22046
53;22;04;10;047;Corlay;934;18;952;22047
53;22;01;14;048;Corseul;2197;47;2244;22048
53;22;01;14;049;Créhen;1629;44;1673;22049
53;22;01;04;050;Dinan;14407;587;14994;22050
53;22;02;03;052;Duault;370;7;377;22052
53;22;04;02;053;Eréac;682;13;695;22053
53;22;04;17;054;Erquy;3922;92;4014;22054
53;22;04;22;055;Binic-Etables-sur-Mer;6934;215;7149;22055
53;22;01;08;056;Evran;1757;26;1783;22056
53;22;02;22;057;Le FaouÃ«t;399;12;411;22057
53;22;04;15;059;Le FÅ“il;1412;40;1452;22059
53;22;04;10;060;Gausson;605;19;624;22060
53;22;02;23;061;Glomel;1363;40;1403;22061
53;22;04;02;062;Gomené;544;10;554;22062
53;22;02;22;063;Gommenec'h;555;9;564;22063
53;22;02;23;064;Gouarec;948;30;978;22064
53;22;02;05;065;Goudelin;1729;36;1765;22065
53;22;02;05;067;Grâces;2545;59;2604;22067
53;22;04;10;068;Grâce-Uzel;430;8;438;22068
53;22;01;02;069;Guenroc;217;5;222;22069
53;22;02;05;070;Guingamp;7069;553;7622;22070
53;22;01;02;071;Guitté;714;9;723;22071
53;22;02;03;072;Gurunhuel;407;9;416;22072
53;22;04;15;073;La Harmoye;375;16;391;22073
53;22;04;10;074;Le Haut-Corlay;644;17;661;22074
53;22;04;10;075;Hémonstoir;720;7;727;22075
53;22;04;17;076;Hénanbihen;1325;36;1361;22076
53;22;04;06;077;Hénansal;1195;15;1210;22077
53;22;04;13;079;Hénon;2268;36;2304;22079
53;22;04;26;081;Hillion;4183;97;4280;22081
53;22;01;08;082;Le Hinglé;906;32;938;22082
53;22;04;02;083;Illifaut;679;12;691;22083
53;22;04;16;084;Jugon-les-Lacs - Commune nouvelle;2520;51;2571;22084
53;22;03;27;085;Kerbors;289;8;297;22085
53;22;02;11;086;Kerfot;658;12;670;22086
53;22;02;23;087;Kergrist-MoÃ«lou;653;25;678;22087
53;22;02;03;088;Kerien;253;3;256;22088
53;22;03;12;090;Kermaria-Sulard;1067;20;1087;22090
53;22;02;01;091;Kermoroc'h;442;9;451;22091
53;22;02;03;092;Kerpert;269;3;272;22092
53;22;04;89;093;Lamballe-Armor;16688;470;17158;22093
53;22;01;19;094;Lancieux;1558;63;1621;22094
53;22;02;01;095;LandebaÃ«ron;180;10;190;22095
53;22;01;14;096;Landébia;459;3;462;22096
53;22;01;14;097;La Landec;726;18;744;22097
53;22;04;06;098;Landéhen;1425;34;1459;22098
53;22;04;15;099;Lanfains;1098;17;1115;22099
53;22;03;27;101;Langoat;1133;25;1158;22101
53;22;01;19;103;Langrolay-sur-Rance;958;39;997;22103
53;22;01;14;104;Languédias;526;28;554;22104
53;22;01;14;105;Languenan;1146;23;1169;22105
53;22;04;26;106;Langueux;7801;263;8064;22106
53;22;02;23;107;Bon Repos sur Blavet;1256;39;1295;22107
53;22;02;11;108;Lanleff;122;2;124;22108
53;22;02;11;109;Lanloup;210;5;215;22109
53;22;03;27;110;Lanmérin;601;12;613;22110
53;22;03;27;111;Lanmodez;404;7;411;22111
53;22;02;22;112;Lannebert;437;5;442;22112
53;22;03;07;113;Lannion;20210;936;21146;22113
53;22;04;02;114;Lanrelas;847;17;864;22114
53;22;02;23;115;Lanrivain;441;16;457;22115
53;22;02;15;116;Lanrodec;1351;23;1374;22116
53;22;04;22;117;Lantic;1716;33;1749;22117
53;22;01;08;118;Lanvallay;4195;96;4291;22118
53;22;03;20;119;Lanvellec;591;10;601;22119
53;22;02;22;121;Lanvollon;1780;29;1809;22121
53;22;04;02;122;Laurenan;735;12;747;22122
53;22;02;23;124;LescouÃ«t-Gouarec;218;8;226;22124
53;22;04;15;126;Le Leslay;158;1;159;22126
53;22;03;27;127;Lézardrieux;1480;38;1518;22127
53;22;02;23;128;Locarn;410;15;425;22128
53;22;02;03;129;Loc-Envel;67;3;70;22129
53;22;03;20;131;Loguivy-Plougras;813;13;826;22131
53;22;02;03;132;Lohuec;252;4;256;22132
53;22;04;02;133;LoscouÃ«t-sur-Meu;626;15;641;22133
53;22;03;12;134;Louannec;3077;117;3194;22134
53;22;02;03;135;Louargat;2329;45;2374;22135
53;22;04;09;136;Loudéac;9605;384;9989;22136
53;22;02;23;137;MaÃ«l-Carhaix;1469;30;1499;22137
53;22;02;03;138;MaÃ«l-Pestivien;360;5;365;22138
53;22;02;03;139;Magoar;89;1;90;22139
53;22;04;06;140;La Malhoure;598;16;614;22140
53;22;03;01;141;Mantallot;237;6;243;22141
53;22;01;17;143;Matignon;1697;23;1720;22143
53;22;04;21;144;La Méaugon;1326;34;1360;22144
53;22;01;02;145;Mégrit;836;11;847;22145
53;22;02;23;146;Mellionnec;391;17;408;22146
53;22;04;02;147;Merdrignac;2937;230;3167;22147
53;22;04;02;148;Mérillac;234;4;238;22148
53;22;04;10;149;Merléac;431;17;448;22149
53;22;02;05;150;Le Merzer;947;27;974;22150
53;22;03;27;152;Minihy-Tréguier;1262;41;1303;22152
53;22;04;13;153;Moncontour;790;17;807;22153
53;22;04;10;155;La Motte;2141;32;2173;22155
53;22;02;03;156;Moustéru;649;15;664;22156
53;22;02;23;157;Le Moustoir;670;17;687;22157
53;22;04;10;158;Guerlédan;2439;64;2503;22158
53;22;04;06;160;Noyal;946;18;964;22160
53;22;02;05;161;Pabu;2748;107;2855;22161
53;22;02;11;162;Paimpol;7179;335;7514;22162
53;22;02;23;163;Paule;691;20;711;22163
53;22;02;01;164;Pédernec;1839;26;1865;22164
53;22;04;16;165;Penguily;607;19;626;22165
53;22;03;27;166;Penvénan;2494;63;2557;22166
53;22;03;12;168;Perros-Guirec;7089;196;7285;22168
53;22;02;23;169;Peumerit-Quintin;173;4;177;22169
53;22;04;15;170;Plaine-Haute;1633;34;1667;22170
53;22;04;13;171;Plaintel;4441;91;4532;22171
53;22;01;14;172;PlancoÃ«t;2981;54;3035;22172
53;22;01;17;174;Pléboulle;869;5;874;22174
53;22;04;16;175;Plédéliac;1464;20;1484;22175
53;22;04;21;176;Plédran;6839;111;6950;22176
53;22;02;22;177;Pléguien;1353;29;1382;22177
53;22;02;11;178;Pléhédel;1325;34;1359;22178
53;22;01;17;179;Fréhel;1602;27;1629;22179
53;22;01;14;180;Plélan-le-Petit;1901;31;1932;22180
53;22;02;23;181;Plélauff;629;27;656;22181
53;22;02;15;182;Plélo;3242;75;3317;22182
53;22;04;09;183;Plémet;3697;126;3823;22183
53;22;04;13;184;Plémy;1587;30;1617;22184
53;22;04;16;185;Plénée-Jugon;2429;73;2502;22185
53;22;04;17;186;Pléneuf-Val-André;4083;129;4212;22186
53;22;04;18;187;Plérin;14309;487;14796;22187
53;22;02;15;188;Plerneuf;1090;10;1100;22188
53;22;02;03;189;Plésidy;580;10;590;22189
53;22;01;19;190;Pleslin-Trigavou;3775;76;3851;22190
53;22;04;16;193;Plestan;1617;25;1642;22193
53;22;03;20;194;Plestin-les-Grèves;3620;98;3718;22194
53;22;03;27;195;Pleubian;2298;42;2340;22195
53;22;03;27;196;Pleudaniel;936;21;957;22196
53;22;01;08;197;Pleudihen-sur-Rance;2968;80;3048;22197
53;22;03;12;198;Pleumeur-Bodou;3857;165;4022;22198
53;22;03;27;199;Pleumeur-Gautier;1197;19;1216;22199
53;22;01;14;200;Pléven;593;11;604;22200
53;22;01;17;201;Plévenon;754;13;767;22201
53;22;02;23;202;Plévin;754;15;769;22202
53;22;04;13;203;PlÅ“uc-L'Hermitage;4103;77;4180;22203
53;22;02;01;204;PloÃ«zal;1232;20;1252;22204
53;22;01;14;205;Plorec-sur-Arguenon;417;3;420;22205
53;22;02;15;206;Châtelaudren-Plouagat;3916;55;3971;22206
53;22;03;20;207;Plouaret;2176;45;2221;22207
53;22;01;08;208;Plouasne;1711;33;1744;22208
53;22;01;19;209;Beaussais-sur-Mer;3757;63;3820;22209
53;22;02;11;210;Ploubazlanec;3039;125;3164;22210
53;22;03;20;211;Ploubezre;3687;117;3804;22211
53;22;02;01;212;PlouÃ«c-du-Trieux;1140;33;1173;22212
53;22;01;19;213;PlouÃ«r-sur-Rance;3551;108;3659;22213
53;22;02;11;214;Plouézec;3140;56;3196;22214
53;22;04;21;215;Ploufragan;11383;356;11739;22215
53;22;02;03;216;Plougonver;731;12;743;22216
53;22;03;20;217;Plougras;408;14;422;22217
53;22;03;27;218;Plougrescant;1166;36;1202;22218
53;22;04;10;219;Plouguenast-Langast;2448;59;2507;22219
53;22;02;23;220;Plouguernével;1643;53;1696;22220
53;22;03;27;221;Plouguiel;1733;37;1770;22221
53;22;02;22;222;Plouha;4541;88;4629;22222
53;22;02;05;223;Plouisy;1989;268;2257;22223
53;22;03;07;224;Ploulec'h;1579;57;1636;22224
53;22;02;05;225;Ploumagoar;5409;113;5522;22225
53;22;03;20;226;Ploumilliau;2464;57;2521;22226
53;22;03;20;227;Plounérin;776;11;787;22227
53;22;03;20;228;Plounévez-MoÃ«dec;1462;29;1491;22228
53;22;02;23;229;Plounévez-Quintin;1071;25;1096;22229
53;22;02;03;231;Plourac'h;317;4;321;22231
53;22;04;22;232;Plourhan;1991;39;2030;22232
53;22;02;11;233;Plourivo;2263;55;2318;22233
53;22;02;15;234;Plouvara;1160;22;1182;22234
53;22;03;20;235;Plouzélambre;237;4;241;22235
53;22;02;22;236;Pludual;715;7;722;22236
53;22;01;14;237;Pluduno;2188;65;2253;22237
53;22;03;20;238;Plufur;531;12;543;22238
53;22;01;02;239;Plumaudan;1333;37;1370;22239
53;22;01;02;240;Plumaugat;1077;15;1092;22240
53;22;04;09;241;Plumieux;1024;30;1054;22241
53;22;04;17;242;Plurien;1559;23;1582;22242
53;22;02;03;243;Plusquellec;539;17;556;22243
53;22;04;10;244;Plussulien;484;18;502;22244
53;22;03;01;245;Pluzunet;966;14;980;22245
53;22;04;06;246;Pommeret;2103;32;2135;22246
53;22;02;05;248;Pommerit-le-Vicomte;1807;37;1844;22248
53;22;02;03;249;Pont-Melvez;611;10;621;22249
53;22;02;01;250;Pontrieux;1009;25;1034;22250
53;22;04;18;251;Pordic;7300;208;7508;22251
53;22;03;01;254;Prat;1117;22;1139;22254
53;22;04;09;255;La Prénessaye;879;21;900;22255
53;22;02;01;256;Quemper-Guézennec;1078;26;1104;22256
53;22;03;01;257;Quemperven;381;8;389;22257
53;22;04;13;258;Quessoy;3856;225;4081;22258
53;22;01;04;259;Quévert;3976;111;4087;22259
53;22;04;10;260;Le Quillio;556;7;563;22260
53;22;04;06;261;Quintenic;362;11;373;22261
53;22;04;15;262;Quintin;2867;200;3067;22262
53;22;01;08;263;Le Quiou;333;3;336;22263
53;22;03;27;264;La Roche-Jaudy;2713;576;3289;22264
53;22;03;07;265;Rospez;1763;56;1819;22265
53;22;02;23;266;Rostrenen;3056;324;3380;22266
53;22;04;02;267;Rouillac;392;3;395;22267
53;22;01;17;268;Ruca;600;10;610;22268
53;22;02;01;269;Runan;250;6;256;22269
53;22;02;03;271;Saint-Adrien;353;7;360;22271
53;22;02;05;272;Saint-Agathon;2289;53;2342;22272
53;22;04;17;273;Saint-Alban;2176;32;2208;22273
53;22;01;08;274;Saint-André-des-Eaux;372;6;378;22274
53;22;04;09;275;Saint-Barnabé;1238;25;1263;22275
53;22;04;15;276;Saint-Bihy;269;0;269;22276
53;22;04;15;277;Saint-Brandan;2309;49;2358;22277
53;22;04;99;278;Saint-Brieuc;43605;1494;45099;22278
53;22;04;10;279;Saint-Caradec;1119;37;1156;22279
53;22;01;08;280;Saint-Carné;1051;36;1087;22280
53;22;04;13;281;Saint-Carreuc;1519;25;1544;22281
53;22;01;17;282;Saint-Cast-le-Guildo;3308;77;3385;22282
53;22;02;01;283;Saint-Clet;877;26;903;22283
53;22;02;23;284;Saint-Connan;290;9;299;22284
53;22;04;10;285;Saint-Connec;258;8;266;22285
53;22;04;17;286;Saint-Denoual;474;14;488;22286
53;22;04;21;287;Saint-Donan;1453;36;1489;22287
53;22;04;09;288;Saint-Etienne-du-Gué-de-l'Isle;351;6;357;22288
53;22;02;15;289;Saint-Fiacre;213;1;214;22289
53;22;04;15;291;Saint-Gildas;251;8;259;22291
53;22;02;22;293;Saint-Gilles-les-Bois;408;13;421;22293
53;22;02;23;294;Saint-Gilles-Pligeaux;305;6;311;22294
53;22;04;10;295;Saint-Gilles-Vieux-Marché;358;8;366;22295
53;22;04;16;296;Saint-Glen;646;11;657;22296
53;22;01;08;299;Saint-Hélen;1512;43;1555;22299
53;22;04;10;300;Saint-Hervé;392;9;401;22300
53;22;01;14;302;Saint-Jacut-de-la-Mer;911;19;930;22302
53;22;02;15;304;Saint-Jean-Kerdaniel;650;9;659;22304
53;22;01;02;305;Saint-Jouan-de-l'Isle;495;5;500;22305
53;22;01;08;306;Saint-Judoce;555;14;569;22306
53;22;04;21;307;Saint-Julien;2029;50;2079;22307
53;22;01;08;308;Saint-Juvat;646;18;664;22308
53;22;04;02;309;Saint-Launeuc;195;4;199;22309
53;22;02;01;310;Saint-Laurent;468;15;483;22310
53;22;01;14;311;Saint-Lormel;874;35;909;22311
53;22;01;02;312;Saint-Maden;226;8;234;22312
53;22;04;10;313;Saint-Martin-des-Prés;306;11;317;22313
53;22;04;09;314;Saint-Maudan;403;7;410;22314
53;22;01;14;315;Saint-Maudez;284;11;295;22315
53;22;04;10;316;Saint-Mayeux;469;11;480;22316
53;22;01;14;317;Saint-Méloir-des-Bois;265;2;267;22317
53;22;01;14;318;Saint-Michel-de-Plélan;307;8;315;22318
53;22;03;20;319;Saint-Michel-en-Grève;456;13;469;22319
53;22;02;03;320;Saint-Nicodème;168;3;171;22320
53;22;02;23;321;Saint-Nicolas-du-Pélem;1594;45;1639;22321
53;22;02;15;322;Saint-Péver;387;8;395;22322
53;22;01;17;323;Saint-Pôtan;815;13;828;22323
53;22;03;12;324;Saint-Quay-Perros;1290;55;1345;22324
53;22;04;22;325;Saint-Quay-Portrieux;3121;222;3343;22325
53;22;04;06;326;Saint-Rieul;546;5;551;22326
53;22;01;19;327;Saint-Samson-sur-Rance;1637;27;1664;22327
53;22;02;03;328;Saint-Servais;408;6;414;22328
53;22;04;10;330;Saint-Thélo;395;12;407;22330
53;22;02;23;331;Sainte-Tréphine;185;2;187;22331
53;22;04;16;332;Saint-TrimoÃ«l;521;9;530;22332
53;22;04;02;333;Saint-Vran;761;29;790;22333
53;22;02;23;334;Saint-Igeaux;127;7;134;22334
53;22;02;03;335;Senven-Léhart;236;0;236;22335
53;22;04;02;337;Sévignac;1107;25;1132;22337
53;22;02;01;338;Squiffiec;760;26;786;22338
53;22;01;19;339;Taden;2524;76;2600;22339
53;22;03;01;340;Tonquédec;1196;27;1223;22340
53;22;04;16;341;Tramain;692;10;702;22341
53;22;01;14;342;Trébédan;427;9;436;22342
53;22;03;12;343;Trébeurden;3641;126;3767;22343
53;22;02;23;344;Trébrivan;748;16;764;22344
53;22;04;16;345;Trébry;784;15;799;22345
53;22;04;13;346;Trédaniel;900;24;924;22346
53;22;03;27;347;Trédarzec;1060;19;1079;22347
53;22;04;02;348;Trédias;495;9;504;22348
53;22;03;20;349;Trédrez-Locquémeau;1449;39;1488;22349
53;22;03;20;350;Tréduder;195;3;198;22350
53;22;02;23;351;Treffrin;544;13;557;22351
53;22;01;08;352;Tréfumel;274;2;276;22352
53;22;03;12;353;Trégastel;2535;74;2609;22353
53;22;02;03;354;Tréglamus;1074;23;1097;22354
53;22;02;15;356;Trégomeur;943;24;967;22356
53;22;02;01;358;Trégonneau;578;7;585;22358
53;22;03;20;359;Trégrom;416;6;422;22359
53;22;04;26;360;Trégueux;8459;166;8625;22360
53;22;02;22;361;Tréguidel;627;12;639;22361
53;22;03;27;362;Tréguier;2416;267;2683;22362
53;22;03;12;363;Trélévern;1243;32;1275;22363
53;22;01;04;364;Trélivan;2862;82;2944;22364
53;22;02;23;365;Trémargat;187;14;201;22365
53;22;03;20;366;Trémel;405;5;410;22366
53;22;01;19;368;Tréméreuc;711;28;739;22368
53;22;04;02;369;Trémeur;783;17;800;22369
53;22;02;22;370;Tréméven;348;8;356;22370
53;22;04;02;371;Trémorel;1142;20;1162;22371
53;22;04;18;372;Trémuson;2148;36;2184;22372
53;22;02;23;373;Tréogan;102;4;106;22373
53;22;02;22;375;Tressignaux;695;11;706;22375
53;22;04;10;376;Trévé;1692;31;1723;22376
53;22;04;22;377;Tréveneuc;797;21;818;22377
53;22;02;22;378;Trévérec;216;7;223;22378
53;22;03;12;379;Trévou-Tréguignec;1483;41;1524;22379
53;22;01;08;380;Trévron;685;14;699;22380
53;22;03;27;381;Trézény;351;8;359;22381
53;22;03;27;383;Troguéry;224;6;230;22383
53;22;04;10;384;Uzel;1053;25;1078;22384
53;22;01;19;385;La Vicomté-sur-Rance;1092;24;1116;22385
53;22;04;15;386;Le Vieux-Bourg;776;20;796;22386
53;22;03;20;387;Le Vieux-Marché;1285;30;1315;22387
53;22;01;04;388;Vildé-Guingalan;1239;21;1260;22388
53;22;04;26;389;Yffiniac;4990;104;5094;22389
53;22;02;11;390;Yvias;777;18;795;22390
53;22;01;02;391;Yvignac-la-Tour;1129;16;1145;22391
75;23;02;01;001;Ahun;1410;230;1640;23001
75;23;02;14;002;Ajain;1075;15;1090;23002
75;23;01;02;003;Alleyrat;139;0;139;23003
75;23;02;14;004;Anzême;555;9;564;23004
75;23;01;08;005;Arfeuille-Châtain;198;4;202;23005
75;23;02;11;006;Arrènes;212;2;214;23006
75;23;02;01;007;Ars;236;10;246;23007
75;23;01;02;008;Aubusson;3248;183;3431;23008
75;23;01;08;009;Auge;93;0;93;23009
75;23;02;11;010;Augères;118;2;120;23010
75;23;02;11;011;Aulon;160;4;164;23011
75;23;02;05;012;Auriat;109;2;111;23012
75;23;01;03;013;Auzances;1208;25;1233;23013
75;23;02;11;014;Azat-Châtenet;121;3;124;23014
75;23;02;07;015;Azerables;813;16;829;23015
75;23;02;01;016;Banize;182;2;184;23016
75;23;01;03;017;Basville;164;2;166;23017
75;23;02;07;018;Bazelat;247;11;258;23018
75;23;01;03;019;Beissat;25;0;25;23019
75;23;01;02;020;Bellegarde-en-Marche;410;7;417;23020
75;23;02;11;021;Bénévent-l'Abbaye;765;11;776;23021
75;23;01;06;022;Bétête;373;7;380;23022
75;23;01;10;023;Blaudeix;105;1;106;23023
75;23;01;02;024;Blessac;532;12;544;23024
75;23;02;04;025;Bonnat;1342;24;1366;23025
75;23;01;06;026;Bord-Saint-Georges;351;10;361;23026
75;23;02;05;027;Bosmoreau-les-Mines;235;7;242;23027
75;23;01;02;028;Bosroger;107;2;109;23028
75;23;02;04;029;Le Bourg-d'Hem;219;2;221;23029
75;23;02;05;030;Bourganeuf;2478;213;2691;23030
75;23;01;06;031;Boussac;1249;18;1267;23031
75;23;01;06;032;Boussac-Bourg;695;11;706;23032
75;23;02;14;033;La Brionne;445;8;453;23033
75;23;01;03;034;Brousse;28;0;28;23034
75;23;01;08;035;Budelière;707;10;717;23035
75;23;02;14;036;Bussière-Dunoise;1030;14;1044;23036
75;23;01;03;037;Bussière-Nouvelle;79;3;82;23037
75;23;01;06;038;Bussière-Saint-Georges;253;3;256;23038
75;23;02;07;039;La Celle-Dunoise;541;24;565;23039
75;23;01;10;040;La Celle-sous-Gouzon;154;1;155;23040
75;23;02;04;041;La Cellette;243;4;247;23041
75;23;02;11;042;Ceyroux;125;1;126;23042
75;23;02;01;043;Chamberaud;96;0;96;23043
75;23;02;04;044;Chambon-Sainte-Croix;80;1;81;23044
75;23;01;08;045;Chambon-sur-Voueize;868;12;880;23045
75;23;01;08;046;Chambonchard;81;4;85;23046
75;23;02;11;047;Chamborand;241;3;244;23047
75;23;01;02;048;Champagnat;471;10;481;23048
75;23;02;04;049;Champsanglard;249;6;255;23049
75;23;02;07;050;La Chapelle-Baloue;128;1;129;23050
75;23;02;01;051;La Chapelle-Saint-Martial;78;1;79;23051
75;23;02;13;052;La Chapelle-Taillefert;431;10;441;23052
75;23;01;03;053;Chard;205;2;207;23053
75;23;01;03;054;Charron;230;9;239;23054
75;23;01;03;055;Châtelard;30;0;30;23055
75;23;02;11;056;Châtelus-le-Marcheix;294;6;300;23056
75;23;02;04;057;Châtelus-Malvaleix;551;12;563;23057
75;23;01;10;058;Le Chauchet;105;2;107;23058
75;23;01;02;059;La Chaussade;101;6;107;23059
75;23;02;01;060;Chavanat;143;3;146;23060
75;23;01;10;061;Chénérailles;755;12;767;23061
75;23;02;04;062;Chéniers;559;9;568;23062
75;23;01;03;063;Clairavaux;155;1;156;23063
75;23;01;06;064;Clugnat;650;3;653;23064
75;23;02;07;065;Colondannes;274;9;283;23065
75;23;01;03;066;Le Compas;194;11;205;23066
75;23;01;03;067;La Courtine;788;9;797;23067
75;23;01;10;068;Cressat;528;7;535;23068
75;23;01;03;069;Crocq;412;6;418;23069
75;23;02;07;070;Crozant;439;14;453;23070
75;23;01;09;071;Croze;191;6;197;23071
75;23;01;10;072;Domeyrot;231;3;234;23072
75;23;01;03;073;Dontreix;425;5;430;23073
75;23;02;01;074;Le Donzeil;186;5;191;23074
75;23;02;07;075;Dun-le-Palestel;1094;24;1118;23075
75;23;01;08;076;Evaux-les-Bains;1328;32;1360;23076
75;23;01;09;077;Faux-la-Montagne;439;11;450;23077
75;23;02;05;078;Faux-Mazuras;189;4;193;23078
75;23;01;09;079;Felletin;1550;186;1736;23079
75;23;01;09;080;Féniers;94;0;94;23080
75;23;01;03;081;Flayat;300;4;304;23081
75;23;02;11;082;Fleurat;316;6;322;23082
75;23;01;08;083;Fontanières;247;1;248;23083
75;23;02;04;084;La Forêt-du-Temple;146;1;147;23084
75;23;02;01;086;Fransèches;244;3;247;23086
75;23;02;07;087;Fresselines;488;11;499;23087
75;23;02;14;088;Gartempe;121;0;121;23088
75;23;02;04;089;Genouillac;728;11;739;23089
75;23;01;09;090;Gentioux-Pigerolles;378;6;384;23090
75;23;01;09;091;Gioux;161;3;164;23091
75;23;02;14;092;Glénic;680;12;692;23092
75;23;01;10;093;Gouzon;1567;22;1589;23093
75;23;02;11;095;Le Grand-Bourg;1220;43;1263;23095
75;23;02;99;096;Guéret;12734;637;13371;23096
75;23;01;10;097;Issoudun-Létrieix;298;3;301;23097
75;23;02;06;098;Jalesches;90;3;93;23098
75;23;02;01;099;Janaillat;318;5;323;23099
75;23;01;10;100;Jarnages;439;10;449;23100
75;23;02;14;101;Jouillat;387;13;400;23101
75;23;01;10;102;Ladapeyre;346;3;349;23102
75;23;02;07;103;Lafat;323;14;337;23103
75;23;01;06;104;Lavaufranche;239;1;240;23104
75;23;01;10;105;Lavaveix-les-Mines;635;2;637;23105
75;23;01;08;106;Lépaud;366;4;370;23106
75;23;02;01;107;Lépinas;129;5;134;23107
75;23;01;06;108;Leyrat;142;1;143;23108
75;23;02;04;109;Linard-Malval;211;5;216;23109
75;23;01;03;110;Lioux-les-Monges;60;1;61;23110
75;23;02;11;111;Lizières;251;1;252;23111
75;23;02;04;112;Lourdoueix-Saint-Pierre;746;11;757;23112
75;23;01;02;113;Lupersat;299;6;305;23113
75;23;01;08;114;Lussat;410;7;417;23114
75;23;01;03;115;Magnat-l'Etrange;247;2;249;23115
75;23;01;02;116;Mainsat;543;11;554;23116
75;23;02;07;117;Maison-Feyne;302;7;309;23117
75;23;02;01;118;Maisonnisses;180;6;186;23118
75;23;01;03;119;Malleret;43;0;43;23119
75;23;01;06;120;Malleret-Boussac;187;3;190;23120
75;23;02;05;122;Mansat-la-Courrière;70;4;74;23122
75;23;01;03;123;Les Mars;187;2;189;23123
75;23;02;11;124;Marsac;652;17;669;23124
75;23;01;03;125;Le Mas-d'Artige;99;1;100;23125
75;23;01;02;127;Mautes;198;6;204;23127
75;23;02;01;128;Mazeirat;126;6;132;23128
75;23;01;03;129;La Mazière-aux-Bons-Hommes;65;1;66;23129
75;23;02;04;130;Méasnes;530;6;536;23130
75;23;01;03;131;Mérinchal;693;13;706;23131
75;23;02;13;132;Montaigut-le-Blanc;411;6;417;23132
75;23;02;05;133;Montboucher;345;12;357;23133
75;23;02;09;134;Le Monteil-au-Vicomte;200;47;247;23134
75;23;02;04;136;Mortroux;277;9;286;23136
75;23;02;11;137;Mourioux-Vieilleville;516;12;528;23137
75;23;02;01;138;Moutier-d'Ahun;169;1;170;23138
75;23;02;04;139;Moutier-Malcard;542;6;548;23139
75;23;01;09;140;Moutier-Rozeille;419;9;428;23140
75;23;02;07;141;Naillat;630;16;646;23141
75;23;01;02;142;Néoux;287;3;290;23142
75;23;02;15;143;Noth;491;13;504;23143
75;23;01;09;144;La Nouaille;240;3;243;23144
75;23;01;08;145;Nouhant;279;7;286;23145
75;23;01;06;146;Nouzerines;241;7;248;23146
75;23;02;07;147;Nouzerolles;96;2;98;23147
75;23;02;04;148;Nouziers;245;2;247;23148
75;23;01;10;149;Parsac-Rimondeix;709;14;723;23149
75;23;02;01;150;Peyrabout;156;2;158;23150
75;23;01;10;151;Peyrat-la-Nonière;431;8;439;23151
75;23;01;10;152;Pierrefitte;70;0;70;23152
75;23;01;10;154;Pionnat;737;11;748;23154
75;23;02;01;155;Pontarion;364;6;370;23155
75;23;01;03;156;Pontcharraud;83;1;84;23156
75;23;02;01;157;La Pouge;96;0;96;23157
75;23;01;09;158;Poussanges;158;0;158;23158
75;23;01;10;159;Puy-Malsignat;150;3;153;23159
75;23;01;08;160;Reterre;276;1;277;23160
75;23;02;04;162;Roches;369;3;372;23162
75;23;01;03;164;Rougnat;484;11;495;23164
75;23;02;09;165;Royère-de-Vassivière;577;5;582;23165
75;23;02;07;166;Sagnat;192;7;199;23166
75;23;01;08;167;Sannat;334;8;342;23167
75;23;02;01;168;Sardent;769;18;787;23168
75;23;02;12;169;La Saunière;632;13;645;23169
75;23;02;12;170;Savennes;213;11;224;23170
75;23;01;03;171;Sermur;116;1;117;23171
75;23;01;02;172;La Serre-Bussière-Vieille;122;1;123;23172
75;23;02;05;173;Soubrebost;139;3;142;23173
75;23;01;06;174;Soumans;584;7;591;23174
75;23;02;01;175;Sous-Parsat;114;1;115;23175
75;23;02;15;176;La Souterraine;4982;231;5213;23176
75;23;02;15;177;Saint-Agnant-de-Versillat;1088;29;1117;23177
75;23;01;03;178;Saint-Agnant-près-Crocq;175;0;175;23178
75;23;01;02;179;Saint-Alpinien;279;4;283;23179
75;23;01;02;180;Saint-Amand;486;3;489;23180
75;23;02;05;181;Saint-Amand-Jartoudeix;158;2;160;23181
75;23;01;02;182;Saint-Avit-de-Tardes;173;2;175;23182
75;23;02;01;183;Saint-Avit-le-Pauvre;77;2;79;23183
75;23;01;03;184;Saint-Bard;99;3;102;23184
75;23;01;10;185;Saint-Chabrais;284;3;287;23185
75;23;02;13;186;Saint-Christophe;154;6;160;23186
75;23;01;10;187;Saint-Dizier-la-Tour;195;2;197;23187
75;23;02;04;188;Saint-Dizier-les-Domaines;196;2;198;23188
75;23;02;05;189;Saint-Dizier-Masbaraud;1133;25;1158;23189
75;23;01;02;190;Saint-Domet;167;1;168;23190
75;23;02;13;191;Saint-Eloi;195;7;202;23191
75;23;02;11;192;Fursac;1466;21;1487;23192
75;23;02;12;193;Sainte-Feyre;2482;59;2541;23193
75;23;01;09;194;Sainte-Feyre-la-Montagne;123;3;126;23194
75;23;02;14;195;Saint-Fiel;1049;26;1075;23195
75;23;01;09;196;Saint-Frion;255;5;260;23196
75;23;02;01;197;Saint-Georges-la-Pouge;369;2;371;23197
75;23;01;03;198;Saint-Georges-Nigremont;143;1;144;23198
75;23;02;07;199;Saint-Germain-Beaupré;386;8;394;23199
75;23;02;11;200;Saint-Goussaud;165;8;173;23200
75;23;02;01;201;Saint-Hilaire-la-Plaine;212;5;217;23201
75;23;02;01;202;Saint-Hilaire-le-Château;229;7;236;23202
75;23;01;08;203;Saint-Julien-la-Genête;219;7;226;23203
75;23;01;10;204;Saint-Julien-le-Châtel;142;3;145;23204
75;23;02;05;205;Saint-Junien-la-Bregère;143;1;144;23205
75;23;02;12;206;Saint-Laurent;689;13;702;23206
75;23;02;15;207;Saint-Léger-Bridereix;195;3;198;23207
75;23;02;14;208;Saint-Léger-le-Guérétois;415;9;424;23208
75;23;01;10;209;Saint-Loup;184;1;185;23209
75;23;01;02;210;Saint-Maixant;253;2;255;23210
75;23;01;02;211;Saint-Marc-Ã -Frongier;426;9;435;23211
75;23;01;09;212;Saint-Marc-Ã -Loubaud;129;1;130;23212
75;23;01;06;213;Saint-Marien;181;2;183;23213
75;23;02;01;214;Saint-Martial-le-Mont;272;5;277;23214
75;23;01;03;215;Saint-Martial-le-Vieux;139;4;143;23215
75;23;02;09;216;Saint-Martin-Château;146;5;151;23216
75;23;02;05;217;Saint-Martin-Sainte-Catherine;343;5;348;23217
75;23;01;03;218;Saint-Maurice-près-Crocq;98;1;99;23218
75;23;02;15;219;Saint-Maurice-la-Souterraine;1222;28;1250;23219
75;23;01;10;220;Saint-Médard-la-Rochette;566;12;578;23220
75;23;01;03;221;Saint-Merd-la-Breuille;193;5;198;23221
75;23;02;01;222;Saint-Michel-de-Veisse;161;3;164;23222
75;23;02;05;223;Saint-Moreil;215;0;215;23223
75;23;01;03;224;Saint-Oradoux-de-Chirouze;72;0;72;23224
75;23;01;03;225;Saint-Oradoux-près-Crocq;104;1;105;23225
75;23;01;03;226;Saint-Pardoux-d'Arnet;169;6;175;23226
75;23;02;05;227;Saint-Pardoux-Morterolles;201;8;209;23227
75;23;01;02;228;Saint-Pardoux-le-Neuf;197;5;202;23228
75;23;01;10;229;Saint-Pardoux-les-Cards;284;2;286;23229
75;23;02;05;230;Saint-Pierre-Chérignat;166;5;171;23230
75;23;02;05;232;Saint-Pierre-Bellevue;209;1;210;23232
75;23;01;06;233;Saint-Pierre-le-Bost;126;7;133;23233
75;23;01;08;234;Saint-Priest;155;1;156;23234
75;23;02;15;235;Saint-Priest-la-Feuille;777;13;790;23235
75;23;02;11;236;Saint-Priest-la-Plaine;257;8;265;23236
75;23;02;05;237;Saint-Priest-Palus;55;0;55;23237
75;23;01;09;238;Saint-Quentin-la-Chabanne;385;7;392;23238
75;23;02;07;239;Saint-Sébastien;632;11;643;23239
75;23;01;06;240;Saint-Silvain-Bas-le-Roc;405;5;410;23240
75;23;01;02;241;Saint-Silvain-Bellegarde;215;3;218;23241
75;23;02;13;242;Saint-Silvain-Montaigut;226;3;229;23242
75;23;01;10;243;Saint-Silvain-sous-Toulx;154;2;156;23243
75;23;02;07;244;Saint-Sulpice-le-Dunois;587;14;601;23244
75;23;02;14;245;Saint-Sulpice-le-Guérétois;1935;57;1992;23245
75;23;01;02;246;Saint-Sulpice-les-Champs;350;9;359;23246
75;23;02;14;247;Saint-Vaury;1738;114;1852;23247
75;23;02;13;248;Saint-Victor-en-Marche;359;8;367;23248
75;23;01;09;249;Saint-Yrieix-la-Montagne;221;7;228;23249
75;23;02;01;250;Saint-Yrieix-les-Bois;289;3;292;23250
75;23;01;08;251;Tardes;126;2;128;23251
75;23;02;06;252;Tercillat;156;3;159;23252
75;23;02;01;253;Thauron;175;6;181;23253
75;23;01;06;254;Toulx-Sainte-Croix;254;2;256;23254
75;23;01;10;255;Trois-Fonds;122;0;122;23255
75;23;01;09;257;Vallière;715;18;733;23257
75;23;02;15;258;Vareilles;306;9;315;23258
75;23;01;08;259;Verneiges;120;1;121;23259
75;23;02;01;260;Vidaillat;180;0;180;23260
75;23;01;08;261;Viersat;288;5;293;23261
75;23;01;10;262;Vigeville;164;2;166;23262
75;23;02;07;263;Villard;374;5;379;23263
75;23;01;09;264;La Villedieu;47;1;48;23264
75;23;01;03;265;La Villeneuve;54;0;54;23265
75;23;01;03;266;La Villetelle;171;1;172;23266
75;24;02;13;001;Abjat-sur-Bandiat;622;7;629;24001
75;24;03;22;002;Agonac;1772;23;1795;24002
75;24;04;05;004;Ajat;296;3;299;24004
75;24;01;08;005;Alles-sur-Dordogne;385;9;394;24005
75;24;04;23;006;Allas-les-Mines;196;10;206;24006
75;24;03;16;007;Allemans;500;13;513;24007
75;24;02;06;008;Angoisse;588;10;598;24008
75;24;02;06;009;Anlhiac;268;8;276;24009
75;24;03;17;010;Annesse-et-Beaulieu;1419;49;1468;24010
75;24;03;22;011;Antonne-et-Trigonant;1297;19;1316;24011
75;24;04;20;012;Archignac;380;9;389;24012
75;24;04;25;014;Aubas;622;20;642;24014
75;24;04;23;015;Audrix;268;4;272;24015
75;24;02;13;016;Augignac;821;20;841;24016
75;24;04;05;018;Auriac-du-Périgord;399;10;409;24018
75;24;04;05;019;Azerat;436;7;443;24019
75;24;04;05;020;La Bachellerie;894;20;914;24020
75;24;04;05;021;Badefols-d'Ans;391;8;399;24021
75;24;01;08;022;Badefols-sur-Dordogne;210;5;215;24022
75;24;01;08;023;Baneuil;328;11;339;24023
75;24;01;19;024;Bardou;48;0;48;24024
75;24;04;05;025;Bars;239;7;246;24025
75;24;03;89;026;Bassillac et Auberoche;4410;82;4492;24026
75;24;01;08;027;Bayac;360;1;361;24027
75;24;01;08;028;Beaumontois en Périgord;1842;42;1884;24028
75;24;03;24;029;Beaupouyet;525;7;532;24029
75;24;04;05;030;Beauregard-de-Terrasson;684;16;700;24030
75;24;03;12;031;Beauregard-et-Bassac;255;5;260;24031
75;24;03;24;032;Beauronne;371;10;381;24032
75;24;03;12;034;Beleymas;273;7;280;24034
75;24;04;23;035;Pays de Belvès;1350;36;1386;24035
75;24;04;23;036;Berbiguières;177;3;180;24036
75;24;01;98;037;Bergerac;26693;715;27408;24037
75;24;03;16;038;Bertric-Burée;432;12;444;24038
75;24;04;23;039;Besse;161;4;165;24039
75;24;04;18;040;Beynac-et-Cazenac;544;9;553;24040
75;24;02;03;042;Biras;670;7;677;24042
75;24;01;08;043;Biron;144;10;154;24043
75;24;01;19;045;Boisse;246;4;250;24045
75;24;04;05;046;Boisseuilh;120;1;121;24046
75;24;01;11;048;Bonneville-et-Saint-Avit-de-Fumadières;322;7;329;24048
75;24;04;20;050;Borrèze;341;12;353;24050
75;24;01;10;051;Bosset;213;6;219;24051
75;24;01;08;052;Bouillac;127;0;127;24052
75;24;03;07;053;Boulazac Isle Manoire;10737;341;11078;24053
75;24;01;19;054;Bouniagues;609;20;629;24054
75;24;02;03;055;Bourdeilles;765;16;781;24055
75;24;02;13;056;Le Bourdeix;227;4;231;24056
75;24;03;16;057;Bourg-des-Maisons;67;0;67;24057
75;24;03;16;058;Bourg-du-Bost;218;3;221;24058
75;24;03;24;059;Bourgnac;349;6;355;24059
75;24;01;08;060;Bourniquel;71;1;72;24060
75;24;03;12;061;Bourrou;124;6;130;24061
75;24;03;16;062;Bouteilles-Saint-Sébastien;175;3;178;24062
75;24;04;23;063;Bouzic;150;3;153;24063
75;24;02;03;064;Brantôme en Périgord;3670;56;3726;24064
75;24;02;06;066;Brouchaud;213;5;218;24066
75;24;04;25;067;Le Bugue;2588;42;2630;24067
75;24;01;08;068;Le Buisson-de-Cadouin;1927;60;1987;24068
75;24;02;03;069;Bussac;395;2;397;24069
75;24;02;13;070;Busserolles;506;9;515;24070
75;24;02;13;071;Bussière-Badil;374;2;376;24071
75;24;01;08;073;Calès;378;12;390;24073
75;24;04;20;074;Calviac-en-Périgord;510;21;531;24074
75;24;04;23;075;Campagnac-lès-Quercy;319;8;327;24075
75;24;04;25;076;Campagne;403;14;417;24076
75;24;03;12;077;Campsegret;394;8;402;24077
75;24;01;08;080;Capdrot;476;12;488;24080
75;24;04;20;081;Carlux;634;10;644;24081
75;24;04;20;082;Carsac-Aillac;1529;28;1557;24082
75;24;01;11;083;Carsac-de-Gurson;185;4;189;24083
75;24;04;23;084;Carves;104;4;108;24084
75;24;04;20;085;La Cassagne;154;1;155;24085
75;24;04;23;086;Castelnaud-la-Chapelle;448;7;455;24086
75;24;04;23;087;Castels et Bézenac;815;19;834;24087
75;24;01;08;088;Cause-de-Clérans;347;7;354;24088
75;24;04;20;089;Cazoulès;450;13;463;24089
75;24;03;16;090;Celles;589;11;600;24090
75;24;04;23;091;Cénac-et-Saint-Julien;1204;32;1236;24091
75;24;03;12;094;Chalagnac;439;9;448;24094
75;24;02;21;095;Chalais;405;9;414;24095
75;24;02;03;096;Champagnac-de-Belair;789;14;803;24096
75;24;03;16;097;Champagne-et-Fontaine;354;10;364;24097
75;24;03;22;098;Champcevinel;2965;90;3055;24098
75;24;02;13;100;Champniers-et-Reilhac;453;3;456;24100
75;24;02;13;101;Champs-Romain;282;8;290;24101
75;24;03;04;102;Chancelade;4378;82;4460;24102
75;24;03;24;104;Chantérac;617;7;624;24104
75;24;03;03;105;Chapdeuil;135;1;136;24105
75;24;04;25;106;La Chapelle-Aubareil;533;23;556;24106
75;24;02;03;107;La Chapelle-Faucher;395;6;401;24107
75;24;03;17;108;La Chapelle-Gonaguet;1074;16;1090;24108
75;24;03;16;109;La Chapelle-Grésignac;104;2;106;24109
75;24;03;16;110;La Chapelle-Montabourlet;61;4;65;24110
75;24;02;03;111;La Chapelle-Montmoreau;72;1;73;24111
75;24;04;05;113;La Chapelle-Saint-Jean;91;1;92;24113
75;24;03;16;114;Chassaignes;68;2;70;24114
75;24;03;22;115;Château-l'Evêque;2148;31;2179;24115
75;24;04;05;116;Châtres;187;1;188;24116
75;24;04;20;117;Les Coteaux Périgourdins;572;18;590;24117
75;24;03;16;119;Cherval;250;4;254;24119
75;24;02;06;120;Cherveix-Cubas;554;12;566;24120
75;24;04;05;121;Chourgnac;59;2;61;24121
75;24;04;23;122;Cladech;110;1;111;24122
75;24;03;12;123;Clermont-de-Beauregard;119;1;120;24123
75;24;02;06;124;Clermont-d'Excideuil;235;5;240;24124
75;24;01;19;126;Colombier;266;12;278;24126
75;24;03;16;128;Comberanche-et-Epeluche;166;3;169;24128
75;24;02;03;129;Condat-sur-Trincou;478;8;486;24129
75;24;04;20;130;Condat-sur-Vézère;880;16;896;24130
75;24;02;13;131;Connezac;71;0;71;24131
75;24;01;19;132;Conne-de-Labarde;258;4;262;24132
75;24;02;21;133;La Coquille;1276;18;1294;24133
75;24;02;21;134;Corgnac-sur-l'Isle;838;13;851;24134
75;24;03;22;135;Cornille;683;12;695;24135
75;24;04;05;136;Coubjours;118;6;124;24136
75;24;02;06;137;Coulaures;726;77;803;24137
75;24;03;04;138;Coulounieix-Chamiers;7387;296;7683;24138
75;24;03;17;139;Coursac;2211;48;2259;24139
75;24;01;02;140;Cours-de-Pile;1563;34;1597;24140
75;24;03;16;141;Coutures;182;1;183;24141
75;24;04;23;142;Coux et Bigaroque-Mouzens;1219;42;1261;24142
75;24;01;08;143;Couze-et-Saint-Front;725;8;733;24143
75;24;03;03;144;Creyssac;95;0;95;24144
75;24;01;02;145;Creysse;1749;30;1779;24145
75;24;03;12;146;Creyssensac-et-Pissot;255;9;264;24146
75;24;02;06;147;Cubjac-Auvézère-Val d'Ans;1090;10;1100;24147
75;24;01;19;148;Cunèges;285;5;290;24148
75;24;04;23;150;Daglan;529;19;548;24150
75;24;04;23;151;Doissat;103;2;105;24151
75;24;04;23;152;Domme;909;22;931;24152
75;24;04;20;153;La Dornac;398;11;409;24153
75;24;03;03;154;Douchapt;354;10;364;24154
75;24;03;12;155;Douville;465;11;476;24155
75;24;03;07;156;La Douze;1165;16;1181;24156
75;24;03;24;157;Douzillac;792;11;803;24157
75;24;02;06;158;Dussac;399;4;403;24158
75;24;03;09;159;Echourgnac;392;7;399;24159
75;24;03;12;160;Eglise-Neuve-de-Vergt;563;2;565;24160
75;24;03;12;161;Eglise-Neuve-d'Issac;129;1;130;24161
75;24;03;22;162;Escoire;408;9;417;24162
75;24;02;13;163;Etouars;159;1;160;24163
75;24;02;06;164;Excideuil;1171;40;1211;24164
75;24;03;09;165;Eygurande-et-Gardedeuil;415;7;422;24165
75;24;01;19;167;Eymet;2564;40;2604;24167
75;24;01;19;168;Plaisance;431;13;444;24168
75;24;02;21;171;Eyzerac;557;8;565;24171
75;24;04;25;172;Les Eyzies;1097;16;1113;24172
75;24;04;25;174;Fanlac;138;1;139;24174
75;24;04;25;175;Les Farges;316;17;333;24175
75;24;01;19;176;Faurilles;36;0;36;24176
75;24;01;19;177;FALSE;644;10;654;24177
75;24;04;20;179;La Feuillade;770;28;798;24179
75;24;02;21;180;Firbeix;317;9;326;24180
75;24;01;10;182;Le Fleix;1488;53;1541;24182
75;24;04;25;183;Fleurac;281;3;284;24183
75;24;04;23;184;Florimont-Gaumier;147;2;149;24184
75;24;01;19;186;Fonroque;332;2;334;24186
75;24;04;05;188;Fossemagne;537;13;550;24188
75;24;01;11;189;Fougueyrolles;447;16;463;24189
75;24;03;12;190;Fouleix;263;8;271;24190
75;24;01;10;191;Fraisse;173;1;174;24191
75;24;04;05;192;Gabillou;91;3;94;24192
75;24;01;19;193;Gageac-et-Rouillac;477;9;486;24193
75;24;01;10;194;Gardonne;1600;25;1625;24194
75;24;01;08;195;Gaugeac;109;1;110;24195
75;24;02;06;196;Génis;490;4;494;24196
75;24;01;10;197;Ginestet;721;14;735;24197
75;24;03;16;199;Gout-Rossignol;370;7;377;24199
75;24;03;03;200;Grand-Brassac;543;11;554;24200
75;24;04;05;202;Granges-d'Ans;146;4;150;24202
75;24;03;17;205;Grignols;670;5;675;24205
75;24;04;23;206;Grives;109;4;113;24206
75;24;04;23;207;Groléjac;652;16;668;24207
75;24;03;12;208;Grun-Bordas;242;4;246;24208
75;24;02;13;209;Hautefaye;139;1;140;24209
75;24;04;05;210;Hautefort;859;20;879;24210
75;24;03;12;211;Issac;435;3;438;24211
75;24;01;19;212;Issigeac;740;10;750;24212
75;24;03;17;213;Jaure;171;2;173;24213
75;24;02;13;214;Javerlhac-et-la-Chapelle-Saint-Robert;835;10;845;24214
75;24;04;20;215;Jayac;178;3;181;24215
75;24;03;16;216;La Jemaye-Ponteyraud;153;3;156;24216
75;24;04;25;217;Journiac;451;8;459;24217
75;24;02;21;218;Jumilhac-le-Grand;1175;44;1219;24218
75;24;03;12;220;Lacropte;674;8;682;24220
75;24;02;03;221;Rudeau-Ladosse;158;3;161;24221
75;24;01;10;222;La Force;2653;96;2749;24222
75;24;01;08;223;Lalinde;2770;37;2807;24223
75;24;01;02;224;Lamonzie-Montastruc;694;12;706;24224
75;24;01;10;225;Lamonzie-Saint-Martin;2609;35;2644;24225
75;24;01;11;226;Lamothe-Montravel;1377;21;1398;24226
75;24;02;06;227;Lanouaille;981;24;1005;24227
75;24;01;08;228;Lanquais;496;13;509;24228
75;24;04;05;229;Le Lardin-Saint-Lazare;1688;38;1726;24229
75;24;04;23;230;Larzac;148;1;149;24230
75;24;01;08;231;Lavalade;94;1;95;24231
75;24;04;23;232;Lavaur;70;2;72;24232
75;24;03;24;234;Les Lèches;370;2;372;24234
75;24;03;17;236;Léguillac-de-l'Auche;994;15;1009;24236
75;24;01;02;237;Lembras;1208;24;1232;24237
75;24;02;21;238;Lempzours;137;5;142;24238
75;24;04;12;240;Limeuil;334;7;341;24240
75;24;04;05;241;Limeyrat;443;10;453;24241
75;24;01;08;242;Liorac-sur-Louyre;256;1;257;24242
75;24;03;03;243;Lisle;836;11;847;24243
75;24;01;08;244;Lolme;193;2;195;24244
75;24;04;23;245;Loubejac;261;3;264;24245
75;24;01;10;246;Lunas;411;5;416;24246
75;24;03;16;247;Lusignac;167;3;170;24247
75;24;02;13;248;Lussas-et-Nontronneau;283;7;290;24248
75;24;03;17;251;Manzac-sur-Vern;568;9;577;24251
75;24;04;18;252;Marcillac-Saint-Quentin;815;20;835;24252
75;24;02;03;253;Mareuil en Périgord;2280;47;2327;24253
75;24;04;23;254;Marnac;186;1;187;24254
75;24;04;18;255;Marquay;584;9;593;24255
75;24;03;04;256;Marsac-sur-l'Isle;3142;75;3217;24256
75;24;01;08;257;Marsalès;233;5;238;24257
75;24;03;12;259;Eyraud-Crempse-Maurens;1572;31;1603;24259
75;24;01;08;260;Mauzac-et-Grand-Castang;868;9;877;24260
75;24;04;25;261;Mauzens-et-Miremont;289;10;299;24261
75;24;02;06;262;Mayac;346;7;353;24262
75;24;04;23;263;Mazeyrolles;303;13;316;24263
75;24;03;09;264;Ménesplet;1850;15;1865;24264
75;24;03;17;266;Mensignac;1524;27;1551;24266
75;24;01;19;267;Mescoules;178;1;179;24267
75;24;04;23;268;Meyrals;660;13;673;24268
75;24;02;21;269;Mialet;628;7;635;24269
75;24;02;13;271;Milhac-de-Nontron;492;13;505;24271
75;24;01;11;272;Minzac;468;5;473;24272
75;24;01;08;273;Molières;335;10;345;24273
75;24;01;19;274;Monbazillac;804;88;892;24274
75;24;01;19;276;Monestier;404;4;408;24276
75;24;01;10;277;Monfaucon;290;4;294;24277
75;24;01;19;278;Monmadalès;83;1;84;24278
75;24;01;19;279;Monmarvès;63;1;64;24279
75;24;01;08;280;Monpazier;459;8;467;24280
75;24;01;08;281;Monsac;193;7;200;24281
75;24;01;19;282;Monsaguel;145;7;152;24282
75;24;04;05;284;Montagnac-d'Auberoche;137;5;142;24284
75;24;03;12;285;Montagnac-la-Crempse;410;13;423;24285
75;24;03;03;286;Montagrier;496;10;506;24286
75;24;01;19;287;Montaut;125;2;127;24287
75;24;01;11;288;Montazeau;285;4;289;24288
75;24;01;11;289;Montcaret;1476;21;1497;24289
75;24;01;08;290;Montferrand-du-Périgord;156;5;161;24290
75;24;04;25;291;Montignac-Lascaux;2753;55;2808;24291
75;24;01;11;292;Montpeyroux;458;7;465;24292
75;24;04;23;293;Monplaisant;300;4;304;24293
75;24;03;09;294;Montpon-Ménestérol;5704;69;5773;24294
75;24;03;17;295;Montrem;1214;20;1234;24295
75;24;01;02;296;Mouleydier;1139;15;1154;24296
75;24;03;09;297;Moulin-Neuf;942;13;955;24297
75;24;03;24;299;Mussidan;2762;50;2812;24299
75;24;04;23;300;Nabirat;369;10;379;24300
75;24;04;20;301;Nadaillac;384;4;388;24301
75;24;04;05;302;Nailhac;308;2;310;24302
75;24;03;16;303;Nanteuil-Auriac-de-Bourzac;231;3;234;24303
75;24;02;21;304;Nantheuil;974;23;997;24304
75;24;02;21;305;Nanthiat;237;2;239;24305
75;24;01;11;306;Nastringues;126;4;130;24306
75;24;01;08;307;Naussannes;265;5;270;24307
75;24;02;21;308;Négrondes;797;10;807;24308
75;24;03;24;309;Neuvic;3611;67;3678;24309
75;24;02;13;311;Nontron;3055;111;3166;24311
75;24;03;88;312;Sanilhac;4604;101;4705;24312
75;24;04;23;313;Orliac;53;0;53;24313
75;24;04;20;314;Orliaguet;109;9;118;24314
75;24;03;09;316;Parcoul-Chenaud;789;16;805;24316
75;24;04;20;317;Paulin;254;8;262;24317
75;24;03;12;318;Paunat;312;8;320;24318
75;24;03;03;319;Paussac-et-Saint-Vivien;474;7;481;24319
75;24;02;06;320;Payzac;974;17;991;24320
75;24;04;20;321;Pazayac;893;13;906;24321
75;24;03;99;322;Périgueux;29896;1580;31476;24322
75;24;03;16;323;Petit-Bersac;183;5;188;24323
75;24;04;05;324;Peyrignac;570;9;579;24324
75;24;04;20;325;Peyrillac-et-Millac;206;4;210;24325
75;24;04;25;326;Peyzac-le-Moustier;187;2;189;24326
75;24;01;08;327;Pezuls;127;3;130;24327
75;24;02;13;328;Piégut-Pluviers;1179;20;1199;24328
75;24;03;09;329;Le Pizou;1325;19;1344;24329
75;24;04;25;330;Plazac;688;27;715;24330
75;24;01;19;331;Pomport;721;23;744;24331
75;24;01;08;334;Pontours;188;5;193;24334
75;24;01;11;335;Port-Sainte-Foy-et-Ponchapt;2478;46;2524;24335
75;24;04;20;336;Prats-de-Carlux;529;19;548;24336
75;24;04;23;337;Prats-du-Périgord;147;2;149;24337
75;24;01;08;338;Pressignac-Vicq;426;11;437;24338
75;24;02;06;339;Preyssac-d'Excideuil;148;0;148;24339
75;24;01;10;340;Prigonrieux;4143;80;4223;24340
75;24;04;18;341;Proissans;1043;20;1063;24341
75;24;01;02;345;Queyssac;467;15;482;24345
75;24;02;03;346;Quinsac;377;9;386;24346
75;24;01;08;347;Rampieux;145;0;145;24347
75;24;01;19;348;Razac-d'Eymet;305;1;306;24348
75;24;01;19;349;Razac-de-Saussignac;339;10;349;24349
75;24;03;04;350;Razac-sur-l'Isle;2392;41;2433;24350
75;24;01;19;351;Ribagnac;310;6;316;24351
75;24;03;16;352;Ribérac;3844;148;3992;24352
75;24;02;03;353;La Rochebeaucourt-et-Argentine;331;9;340;24353
75;24;03;09;354;La Roche-Chalais;3022;52;3074;24354
75;24;04;18;355;La Roque-Gageac;427;4;431;24355
75;24;04;25;356;Rouffignac-Saint-Cernin-de-Reilhac;1628;35;1663;24356
75;24;01;19;357;Rouffignac-de-Sigoulès;301;6;307;24357
75;24;01;19;359;Sadillac;122;0;122;24359
75;24;04;23;360;Sagelat;319;5;324;24360
75;24;01;08;361;Saint-Agne;445;8;453;24361
75;24;03;12;362;Val de Louyre et Caudeau;1588;26;1614;24362
75;24;04;25;364;Coly-Saint-Amand;567;20;587;24364
75;24;03;12;365;Saint-Amand-de-Vergt;240;8;248;24365
75;24;04;18;366;Saint-André-d'Allas;856;20;876;24366
75;24;03;16;367;Saint-André-de-Double;179;2;181;24367
75;24;01;11;370;Saint-Antoine-de-Breuilh;1860;39;1899;24370
75;24;03;24;371;Saint-Aquilin;468;3;471;24371
75;24;03;17;372;Saint-Astier;5352;94;5446;24372
75;24;01;19;373;Saint-Aubin-de-Cadelech;341;8;349;24373
75;24;01;19;374;Saint-Aubin-de-Lanquais;353;4;357;24374
75;24;04;23;375;Saint-Aubin-de-Nabirat;148;3;151;24375
75;24;03;09;376;Saint Aulaye-Puymangou;1426;19;1445;24376
75;24;04;25;377;Saint-Avit-de-Vialard;158;7;165;24377
75;24;01;08;378;Saint-Avit-Rivière;81;1;82;24378
75;24;01;08;379;Saint-Avit-Sénieur;418;4;422;24379
75;24;03;09;380;Saint-Barthélemy-de-Bellegarde;484;2;486;24380
75;24;02;13;381;Saint-Barthélemy-de-Bussière;213;8;221;24381
75;24;01;08;382;Saint-Capraise-de-Lalinde;526;9;535;24382
75;24;01;19;383;Saint-Capraise-d'Eymet;164;2;166;24383
75;24;01;08;384;Saint-Cassien;37;1;38;24384
75;24;01;19;385;Saint-Cernin-de-Labarde;225;2;227;24385
75;24;04;23;386;Saint-Cernin-de-l'Herm;215;10;225;24386
75;24;04;25;388;Saint-Chamassy;493;15;508;24388
75;24;03;07;390;Saint-Crépin-d'Auberoche;342;9;351;24390
75;24;04;20;392;Saint-Crépin-et-Carlucet;519;10;529;24392
75;24;01;08;393;Sainte-Croix;88;0;88;24393
75;24;02;03;394;Sainte-Croix-de-Mareuil;155;7;162;24394
75;24;04;23;395;Saint-Cybranet;368;6;374;24395
75;24;04;23;396;Saint-Cyprien;1548;34;1582;24396
75;24;02;06;397;Saint-Cyr-les-Champagnes;236;7;243;24397
75;24;02;13;398;Saint-Estèphe;599;7;606;24398
75;24;03;24;399;Saint-Etienne-de-Puycorbier;105;4;109;24399
75;24;04;05;401;Sainte-Eulalie-d'Ans;294;4;298;24401
75;24;02;03;403;Saint-Félix-de-Bourdeilles;65;0;65;24403
75;24;04;25;404;Saint-Félix-de-Reillac-et-Mortemart;176;5;181;24404
75;24;01;08;405;Saint-Félix-de-Villadeix;327;9;336;24405
75;24;04;23;406;Sainte-Foy-de-Belvès;140;2;142;24406
75;24;01;08;407;Sainte-Foy-de-Longas;240;7;247;24407
75;24;02;21;408;Saint-Front-d'Alemps;258;4;262;24408
75;24;03;24;409;Saint-Front-de-Pradoux;1188;16;1204;24409
75;24;02;13;410;Saint-Front-la-Rivière;497;8;505;24410
75;24;02;13;411;Saint-Front-sur-Nizonne;162;2;164;24411
75;24;04;20;412;Saint-Geniès;914;26;940;24412
75;24;01;10;413;Saint-Georges-Blancaneix;269;0;269;24413
75;24;03;12;414;Saint-Georges-de-Montclard;287;5;292;24414
75;24;01;11;415;Saint-Géraud-de-Corps;251;2;253;24415
75;24;04;23;416;Saint-Germain-de-Belvès;172;9;181;24416
75;24;02;06;417;Saint-Germain-des-Prés;471;8;479;24417
75;24;03;24;418;Saint-Germain-du-Salembre;946;7;953;24418
75;24;01;02;419;Saint-Germain-et-Mons;864;19;883;24419
75;24;01;10;420;Saint-Géry;243;2;245;24420
75;24;03;07;421;Saint-Geyrac;197;6;203;24421
75;24;03;12;422;Saint-Hilaire-d'Estissac;116;2;118;24422
75;24;01;19;423;Saint-Julien-Innocence-Eulalie;310;3;313;24423
75;24;03;24;424;Saint-Jean-d'Ataux;133;3;136;24424
75;24;02;21;425;Saint-Jean-de-Côle;364;6;370;24425
75;24;03;12;426;Saint-Jean-d'Estissac;166;6;172;24426
75;24;02;21;428;Saint-Jory-de-Chalais;601;38;639;24428
75;24;02;06;429;Saint-Jory-las-Bloux;236;8;244;24429
75;24;04;20;432;Saint-Julien-de-Lampon;637;17;654;24432
75;24;03;03;434;Saint-Just;144;2;146;24434
75;24;03;24;436;Saint-Laurent-des-Hommes;1024;18;1042;24436
75;24;01;10;437;Saint-Laurent-des-Vignes;918;14;932;24437
75;24;04;23;438;Saint-Laurent-la-Vallée;236;9;245;24438
75;24;01;19;441;Saint-Léon-d'Issigeac;136;3;139;24441
75;24;03;17;442;Saint-Léon-sur-l'Isle;2031;23;2054;24442
75;24;04;25;443;Saint-Léon-sur-Vézère;416;11;427;24443
75;24;03;24;444;Saint-Louis-en-l'Isle;304;7;311;24444
75;24;01;08;445;Saint-Marcel-du-Périgord;146;5;151;24445
75;24;01;08;446;Saint-Marcory;50;3;53;24446
75;24;02;06;448;Saint-Martial-d'Albarède;474;9;483;24448
75;24;03;09;449;Saint-Martial-d'Artenset;941;7;948;24449
75;24;04;23;450;Saint-Martial-de-Nabirat;575;4;579;24450
75;24;02;13;451;Saint-Martial-de-Valette;796;18;814;24451
75;24;03;16;452;Saint-Martial-Viveyrol;189;2;191;24452
75;24;02;21;453;Saint-Martin-de-Fressengeas;362;6;368;24453
75;24;01;11;454;Saint-Martin-de-Gurson;655;7;662;24454
75;24;03;16;455;Saint-Martin-de-Ribérac;734;10;744;24455
75;24;03;12;456;Saint-Martin-des-Combes;193;8;201;24456
75;24;03;24;457;Saint-Martin-l'Astier;138;1;139;24457
75;24;02;13;458;Saint-Martin-le-Pin;267;7;274;24458
75;24;03;12;459;Saint-Mayme-de-Péreyrol;284;9;293;24459
75;24;03;16;460;Saint-Méard-de-Drône;497;6;503;24460
75;24;01;11;461;Saint-Méard-de-Gurçon;822;17;839;24461
75;24;03;24;462;Saint-Médard-de-Mussidan;1706;24;1730;24462
75;24;02;06;463;Saint-Médard-d'Excideuil;547;15;562;24463
75;24;02;06;464;Saint-Mesmin;325;6;331;24464
75;24;03;24;465;Saint-Michel-de-Double;236;6;242;24465
75;24;01;11;466;Saint-Michel-de-Montaigne;326;5;331;24466
75;24;03;12;468;Saint-Michel-de-Villadeix;305;6;311;24468
75;24;04;20;470;Sainte-Mondane;258;5;263;24470
75;24;04;18;471;Sainte-Nathalène;625;12;637;24471
75;24;01;02;472;Saint-Nexans;986;18;1004;24472
75;24;04;05;473;Sainte-Orse;353;6;359;24473
75;24;02;03;474;Saint-Pancrace;168;1;169;24474
75;24;02;06;476;Saint-Pantaly-d'Excideuil;159;3;162;24476
75;24;03;16;477;Saint-Pardoux-de-Drône;193;5;198;24477
75;24;04;23;478;Saint-Pardoux-et-Vielvic;191;0;191;24478
75;24;02;13;479;Saint-Pardoux-la-Rivière;1168;13;1181;24479
75;24;03;12;480;Saint-Paul-de-Serre;304;8;312;24480
75;24;02;21;481;Saint-Paul-la-Roche;519;0;519;24481
75;24;03;16;482;Saint-Paul-Lizonne;277;3;280;24482
75;24;01;19;483;Saint-Perdoux;140;7;147;24483
75;24;03;07;484;Saint-Pierre-de-Chignac;885;17;902;24484
75;24;02;21;485;Saint-Pierre-de-Côle;420;2;422;24485
75;24;02;21;486;Saint-Pierre-de-Frugie;404;3;407;24486
75;24;01;10;487;Saint-Pierre-d'Eyraud;1811;15;1826;24487
75;24;04;23;488;Saint-Pompont;352;5;357;24488
75;24;02;21;489;Saint-Priest-les-Fougères;380;5;385;24489
75;24;03;09;490;Saint Privat en Périgord;1115;14;1129;24490
75;24;04;05;491;Saint-Rabier;579;9;588;24491
75;24;01;19;492;Sainte-Radegonde;61;1;62;24492
75;24;02;06;493;Saint-RaphaÃ«l;93;2;95;24493
75;24;01;11;494;Saint-Rémy;508;4;512;24494
75;24;01;08;495;Saint-Romain-de-Monpazier;113;3;116;24495
75;24;02;21;496;Saint-Romain-et-Saint-Clément;328;4;332;24496
75;24;02;13;498;Saint-Saud-Lacoussière;827;22;849;24498
75;24;01;02;499;Saint-Sauveur;859;21;880;24499
75;24;03;09;500;Saint-Sauveur-Lalande;149;7;156;24500
75;24;01;11;501;Saint-Seurin-de-Prats;494;8;502;24501
75;24;03;24;502;Saint-Séverin-d'Estissac;90;0;90;24502
75;24;03;16;504;Saint-Sulpice-de-Roumagnac;283;1;284;24504
75;24;02;06;505;Saint-Sulpice-d'Excideuil;352;3;355;24505
75;24;04;05;507;Sainte-Trie;110;2;112;24507
75;24;03;03;508;Saint-Victor;210;5;215;24508
75;24;03;16;509;Saint-Vincent-de-Connezac;673;12;685;24509
75;24;04;18;510;Saint-Vincent-de-Cosse;361;12;373;24510
75;24;03;09;511;Saint-Vincent-Jalmoutiers;253;3;256;24511
75;24;04;18;512;Saint-Vincent-le-Paluel;287;10;297;24512
75;24;02;06;513;Saint-Vincent-sur-l'Isle;310;3;313;24513
75;24;01;11;514;Saint-Vivien;245;2;247;24514
75;24;02;06;515;Salagnac;729;4;733;24515
75;24;04;20;516;Salignac-Eyvigues;1177;54;1231;24516
75;24;04;23;517;Salles-de-Belvès;72;2;74;24517
75;24;03;12;518;Salon;280;4;284;24518
75;24;02;06;519;Sarlande;435;0;435;24519
75;24;04;18;520;Sarlat-la-Canéda;8816;409;9225;24520
75;24;03;22;521;Sarliac-sur-l'Isle;1027;19;1046;24521
75;24;02;06;522;Sarrazac;368;11;379;24522
75;24;01;19;523;Saussignac;426;13;439;24523
75;24;04;25;524;Savignac-de-Miremont;179;5;184;24524
75;24;02;13;525;Savignac-de-Nontron;194;2;196;24525
75;24;02;06;526;Savignac-Lédrier;713;9;722;24526
75;24;03;06;527;Savignac-les-Eglises;934;16;950;24527
75;24;02;13;528;Sceau-Saint-Angel;127;2;129;24528
75;24;03;03;529;Segonzac;201;2;203;24529
75;24;04;25;531;Sergeac;212;3;215;24531
75;24;01;19;532;Serres-et-Montguyard;248;3;251;24532
75;24;03;09;533;Servanches;80;4;84;24533
75;24;01;19;534;Sigoulès-et-Flaugeac;1202;240;1442;24534
75;24;04;20;535;Simeyrols;254;3;257;24535
75;24;01;19;536;Singleyrac;297;5;302;24536
75;24;03;16;537;Siorac-de-Ribérac;249;4;253;24537
75;24;04;23;538;Siorac-en-Périgord;1059;11;1070;24538
75;24;03;21;540;Sorges et Ligueux en Périgord;1590;28;1618;24540
75;24;02;13;541;Soudat;88;0;88;24541
75;24;01;08;542;Soulaures;80;3;83;24542
75;24;03;24;543;Sourzac;1107;14;1121;24543
75;24;04;18;544;Tamniès;386;10;396;24544
75;24;04;05;545;Teillots;99;1;100;24545
75;24;04;05;546;Temple-Laguyon;38;0;38;24546
75;24;04;20;547;Terrasson-Lavilledieu;6266;106;6372;24547
75;24;02;13;548;Teyjat;274;5;279;24548
75;24;01;19;549;Thénac;499;10;509;24549
75;24;04;05;550;Thenon;1257;16;1273;24550
75;24;02;21;551;Thiviers;2871;185;3056;24551
75;24;04;25;552;Thonac;250;4;254;24552
75;24;03;03;553;Tocane-Saint-Apre;1742;37;1779;24553
75;24;03;16;554;La Tour-Blanche-Cercles;574;13;587;24554
75;24;04;05;555;Tourtoirac;641;10;651;24555
75;24;03;22;557;Trélissac;7006;201;7207;24557
75;24;01;12;558;Trémolat;637;5;642;24558
75;24;04;25;559;Tursac;332;10;342;24559
75;24;01;08;560;Urval;116;7;123;24560
75;24;03;24;562;Vallereuil;270;11;281;24562
75;24;04;25;563;Valojoulx;277;7;284;24563
75;24;03;16;564;Vanxains;690;106;796;24564
75;24;02;13;565;Varaignes;372;8;380;24565
75;24;01;08;566;Varennes;472;4;476;24566
75;24;02;21;567;Vaunac;252;3;255;24567
75;24;01;11;568;Vélines;1059;11;1070;24568
75;24;03;16;569;Vendoire;127;2;129;24569
75;24;01;08;570;Verdon;42;1;43;24570
75;24;03;12;571;Vergt;1693;14;1707;24571
75;24;01;08;572;Vergt-de-Biron;191;5;196;24572
75;24;03;16;573;Verteillac;590;14;604;24573
75;24;04;20;574;Veyrignac;343;8;351;24574
75;24;04;23;575;Veyrines-de-Domme;231;22;253;24575
75;24;03;12;576;Veyrines-de-Vergt;242;10;252;24576
75;24;04;18;577;Vézac;524;10;534;24577
75;24;04;05;580;Villac;265;2;267;24580
75;24;03;12;581;Villamblard;906;19;925;24581
75;24;02;03;582;Villars;454;9;463;24582
75;24;01;11;584;Villefranche-de-Lonchat;972;18;990;24584
75;24;04;23;585;Villefranche-du-Périgord;676;12;688;24585
75;24;03;16;586;Villetoureix;921;22;943;24586
75;24;04;18;587;Vitrac;817;21;838;24587
27;25;01;17;001;Abbans-Dessous;252;6;258;25001
27;25;01;17;002;Abbans-Dessus;305;5;310;25002
27;25;01;02;003;Abbenans;323;6;329;25003
27;25;02;12;004;Abbévillers;1059;20;1079;25004
27;25;02;03;005;Accolans;90;1;91;25005
27;25;01;02;006;Adam-lès-Passavant;88;2;90;25006
27;25;03;18;007;Adam-lès-Vercel;105;3;108;25007
27;25;02;03;008;Aibre;467;4;471;25008
27;25;01;02;009;Aïssey;163;3;166;25009
27;25;02;10;011;Allenjoie;740;16;756;25011
27;25;03;15;012;Les Alliés;166;5;171;25012
27;25;02;03;013;Allondans;260;3;263;25013
27;25;01;08;014;Amagney;929;11;940;25014
27;25;01;15;015;Amancey;704;21;725;25015
27;25;01;15;016;Amathay-Vésigneux;164;4;168;25016
27;25;01;15;017;Amondans;92;3;95;25017
27;25;02;03;018;Anteuil;624;23;647;25018
27;25;02;03;019;Appenans;381;11;392;25019
27;25;02;01;020;Arbouans;910;9;919;25020
27;25;01;17;021;Arc-et-Senans;1619;30;1649;25021
27;25;02;03;022;Arcey;1468;39;1507;25022
27;25;03;15;024;Arçon;900;30;930;25024
27;25;03;15;025;Arc-sous-Cicon;707;14;721;25025
27;25;03;11;026;Arc-sous-Montenot;214;5;219;25026
27;25;03;15;029;Aubonne;244;3;247;25029
27;25;01;05;030;Audeux;430;11;441;25030
27;25;02;01;031;Audincourt;13341;208;13549;25031
27;25;01;02;032;Autechaux;425;10;435;25032
27;25;02;12;033;Autechaux-Roide;518;10;528;25033
27;25;01;06;035;Les Auxons;2515;46;2561;25035
27;25;01;04;036;Avanne-Aveney;2227;31;2258;25036
27;25;01;02;038;Avilley;161;4;165;25038
27;25;03;18;039;Avoudrey;914;16;930;25039
27;25;02;01;040;Badevel;810;14;824;25040
27;25;03;11;041;Bannans;366;10;376;25041
27;25;03;14;042;Le Barboux;228;8;236;25042
27;25;02;13;043;Bart;1951;53;2004;25043
27;25;01;17;044;Bartherans;59;0;59;25044
27;25;01;02;045;Battenans-les-Mines;48;1;49;25045
27;25;02;18;046;Battenans-Varin;74;2;76;25046
27;25;01;02;047;Baume-les-Dames;4989;162;5151;25047
27;25;02;03;048;Bavans;3616;75;3691;25048
27;25;02;12;049;Belfays;137;5;142;25049
27;25;03;14;050;Le Bélieu;500;5;505;25050
27;25;02;18;051;Belleherbe;623;14;637;25051
27;25;03;18;052;Belmont;67;0;67;25052
27;25;02;03;053;Belvoir;96;6;102;25053
27;25;02;03;054;Berche;524;13;537;25054
27;25;01;17;055;Berthelange;350;8;358;25055
27;25;01;99;056;Besançon;117912;3232;121144;25056
27;25;02;10;057;Bethoncourt;5441;72;5513;25057
27;25;01;09;058;Beure;1345;11;1356;25058
27;25;02;03;059;Beutal;270;5;275;25059
27;25;03;15;060;Bians-les-Usiers;698;24;722;25060
27;25;02;12;061;Bief;116;1;117;25061
27;25;03;14;062;Le Bizot;301;11;312;25062
27;25;02;12;063;Blamont;1210;26;1236;25063
27;25;01;02;065;Blarians;55;4;59;25065
27;25;02;03;066;Blussangeaux;84;1;85;25066
27;25;02;03;067;Blussans;191;3;194;25067
27;25;01;15;070;Bolandoz;373;15;388;25070
27;25;02;12;071;Bondeval;475;11;486;25071
27;25;01;02;072;Bonnal;21;1;22;25072
27;25;01;02;073;Bonnay;830;6;836;25073
27;25;03;14;074;Bonnétage;978;21;999;25074
27;25;03;11;075;Bonnevaux;398;11;409;25075
27;25;03;14;077;La Bosse;72;0;72;25077
27;25;01;02;078;Bouclans;1064;24;1088;25078
27;25;03;11;079;Boujailles;438;11;449;25079
27;25;02;19;082;Bourguignon;894;23;917;25082
27;25;02;03;083;Bournois;191;1;192;25083
27;25;01;09;084;Boussières;1166;17;1183;25084
27;25;03;11;085;Bouverans;388;8;396;25085
27;25;01;07;086;Braillans;210;2;212;25086
27;25;02;03;087;Branne;179;3;182;25087
27;25;01;02;088;Breconchaux;88;5;93;25088
27;25;03;18;089;Bremondans;94;2;96;25089
27;25;01;17;090;Brères;67;0;67;25090
27;25;02;12;091;Les Bréseux;471;8;479;25091
27;25;01;02;092;La Bretenière;70;2;72;25092
27;25;02;03;093;Bretigney;76;0;76;25093
27;25;01;02;094;Bretigney-Notre-Dame;116;0;116;25094
27;25;03;18;095;Bretonvillers;278;3;281;25095
27;25;03;11;096;Brey-et-Maison-du-Bois;143;2;145;25096
27;25;02;10;097;Brognard;478;12;490;25097
27;25;01;17;098;Buffard;181;4;185;25098
27;25;03;15;099;Bugny;225;6;231;25099
27;25;03;11;100;Bulle;472;7;479;25100
27;25;01;17;101;Burgille;571;12;583;25101
27;25;02;12;102;Burnevillers;48;2;50;25102
27;25;01;09;103;Busy;636;14;650;25103
27;25;01;17;104;By;85;1;86;25104
27;25;01;17;105;Byans-sur-Doubs;588;6;594;25105
27;25;01;15;106;Cademène;69;0;69;25106
27;25;01;02;107;Cendrey;192;0;192;25107
27;25;02;12;108;Cernay-l'Eglise;309;9;318;25108
27;25;01;17;109;Cessey;326;10;336;25109
27;25;03;16;110;Chaffois;1020;19;1039;25110
27;25;01;07;111;Chalèze;362;12;374;25111
27;25;01;07;112;Chalezeule;1312;26;1338;25112
27;25;03;18;113;Chamesey;142;3;145;25113
27;25;02;12;114;Chamesol;386;6;392;25114
27;25;01;05;115;Champagney;279;3;282;25115
27;25;01;02;116;Champlive;246;6;252;25116
27;25;01;07;117;Champoux;91;0;91;25117
27;25;01;05;119;Champvans-les-Moulins;325;10;335;25119
27;25;01;15;120;Chantrans;398;10;408;25120
27;25;03;11;121;Chapelle-des-Bois;255;16;271;25121
27;25;03;11;122;Chapelle-d'Huin;525;7;532;25122
27;25;02;12;124;Charmauvillers;269;7;276;25124
27;25;02;18;125;Charmoille;324;5;329;25125
27;25;01;17;126;Charnay;476;8;484;25126
27;25;02;12;127;Charquemont;2741;50;2791;25127
27;25;01;15;129;Chassagne-Saint-Denis;111;3;114;25129
27;25;01;15;130;Châteauvieux-les-Fossés;11;0;11;25130
27;25;03;11;131;Châtelblanc;110;5;115;25131
27;25;01;02;132;Châtillon-Guyotte;138;4;142;25132
27;25;01;06;133;Châtillon-le-Duc;2023;56;2079;25133
27;25;01;17;134;Châtillon-sur-Lison;8;0;8;25134
27;25;01;05;136;Chaucenne;502;13;515;25136
27;25;02;12;138;Les Terres-de-Chaux;125;5;130;25138
27;25;03;15;139;La Chaux;602;10;612;25139
27;25;03;18;141;Chaux-lès-Passavant;122;6;128;25141
27;25;03;11;142;Chaux-Neuve;327;3;330;25142
27;25;01;17;143;Chay;207;11;218;25143
27;25;02;03;145;Chazot;120;1;121;25145
27;25;01;04;147;Chemaudin et Vaux;2021;39;2060;25147
27;25;03;14;148;La Chenalotte;502;5;507;25148
27;25;01;17;149;Chenecey-Buillon;506;11;517;25149
27;25;01;17;150;Chevigney-sur-l'Ognon;291;3;294;25150
27;25;03;18;151;Chevigney-lès-Vercel;133;5;138;25151
27;25;01;08;152;La Chevillotte;158;0;158;25152
27;25;01;02;153;Chevroz;132;1;133;25153
27;25;01;17;154;Chouzelot;266;8;274;25154
27;25;01;15;155;Cléron;299;13;312;25155
27;25;02;03;156;Pays-de-Clerval;1169;22;1191;25156
27;25;03;16;157;La Cluse-et-Mijoux;1299;28;1327;25157
27;25;02;03;159;Colombier-Fontaine;1220;24;1244;25159
27;25;03;14;160;Les Combes;750;27;777;25160
27;25;03;18;161;Consolation-Maisonnettes;30;5;35;25161
27;25;01;17;162;Corcelles-Ferrières;208;6;214;25162
27;25;01;02;163;Corcelle-Mieslot;107;1;108;25163
27;25;01;17;164;Corcondray;144;2;146;25164
27;25;01;02;166;Côtebrune;84;6;90;25166
27;25;02;13;170;Courcelles-lès-Montbéliard;1356;41;1397;25170
27;25;01;17;171;Courcelles;105;2;107;25171
27;25;01;17;172;Courchapon;232;3;235;25172
27;25;02;18;173;Cour-Saint-Maurice;148;1;149;25173
27;25;02;12;174;Courtefontaine;244;3;247;25174
27;25;03;18;175;Courtetain-et-Salans;89;1;90;25175
27;25;03;11;176;Courvières;315;5;320;25176
27;25;02;03;177;Crosey-le-Grand;150;5;155;25177
27;25;02;03;178;Crosey-le-Petit;124;3;127;25178
27;25;03;11;179;Le Crouzet;60;2;62;25179
27;25;01;15;180;Crouzet-Migette;115;6;121;25180
27;25;01;02;181;Cubrial;146;6;152;25181
27;25;01;02;182;Cubry;92;0;92;25182
27;25;01;02;183;Cusance;74;2;76;25183
27;25;01;02;184;Cuse-et-Adrisans;281;12;293;25184
27;25;01;17;185;Cussey-sur-Lison;62;3;65;25185
27;25;01;02;186;Cussey-sur-l'Ognon;1044;24;1068;25186
27;25;02;19;187;Dambelin;502;6;508;25187
27;25;02;10;188;Dambenois;750;26;776;25188
27;25;01;02;189;Dammartin-les-Templiers;189;6;195;25189
27;25;02;01;190;Dampierre-les-Bois;1598;27;1625;25190
27;25;02;03;191;Dampierre-sur-le-Doubs;452;10;462;25191
27;25;02;12;192;Dampjoux;170;4;174;25192
27;25;02;12;193;Damprichard;1856;46;1902;25193
27;25;02;12;194;Dannemarie;112;0;112;25194
27;25;01;04;195;Dannemarie-sur-Crète;1522;290;1812;25195
27;25;02;01;196;Dasle;1392;26;1418;25196
27;25;01;08;197;Deluz;616;5;621;25197
27;25;02;03;198;Désandans;726;21;747;25198
27;25;01;15;199;Déservillers;344;12;356;25199
27;25;01;02;200;Devecey;1379;36;1415;25200
27;25;03;16;201;Dommartin;737;15;752;25201
27;25;03;11;202;Dompierre-les-Tilleuls;314;5;319;25202
27;25;03;18;203;Domprel;189;4;193;25203
27;25;03;16;204;Doubs;3198;95;3293;25204
27;25;02;03;207;Dung;624;17;641;25207
27;25;01;15;208;Durnes;178;4;182;25208
27;25;01;17;209;Echay;131;4;135;25209
27;25;02;03;210;Echenans;159;4;163;25210
27;25;01;15;211;Echevannes;88;1;89;25211
27;25;01;05;212;Ecole-Valentin;2633;49;2682;25212
27;25;02;12;213;Les Ecorces;736;22;758;25213
27;25;02;19;214;Ecot;491;10;501;25214
27;25;01;02;215;L'Ecouvotte;89;0;89;25215
27;25;02;12;216;Ecurcey;265;10;275;25216
27;25;01;17;217;Emagny;597;10;607;25217
27;25;03;18;218;Epenouse;160;7;167;25218
27;25;03;18;219;Epenoy;635;14;649;25219
27;25;01;17;220;Epeugney;594;15;609;25220
27;25;01;02;221;Esnans;65;0;65;25221
27;25;03;18;222;Etalans;1595;36;1631;25222
27;25;01;15;223;Eternoz;327;8;335;25223
27;25;02;03;224;Etouvans;835;13;848;25224
27;25;01;17;225;Etrabonne;188;1;189;25225
27;25;02;03;226;Etrappe;218;4;222;25226
27;25;03;18;227;Etray;281;0;281;25227
27;25;02;10;228;Etupes;3724;64;3788;25228
27;25;03;15;229;Evillers;389;4;393;25229
27;25;02;10;230;Exincourt;3237;54;3291;25230
27;25;03;18;231;Eysson;119;2;121;25231
27;25;02;03;232;Faimbe;100;2;102;25232
27;25;03;18;233;Fallerans;289;8;297;25233
27;25;02;12;234;Ferrières-le-Lac;175;7;182;25234
27;25;01;17;235;Ferrières-les-Bois;317;3;320;25235
27;25;01;15;236;Fertans;288;3;291;25236
27;25;02;10;237;Fesches-le-Châtel;2172;34;2206;25237
27;25;02;12;238;Fessevillers;157;2;159;25238
27;25;02;19;239;Feule;177;1;178;25239
27;25;03;14;240;Les Fins;3202;151;3353;25240
27;25;01;15;241;Flagey;147;6;153;25241
27;25;01;02;242;Flagey-Rigney;119;0;119;25242
27;25;03;18;243;Flangebouche;788;19;807;25243
27;25;02;12;244;Fleurey;84;3;87;25244
27;25;01;08;245;Fontain;1251;22;1273;25245
27;25;02;03;246;Fontaine-lès-Clerval;280;10;290;25246
27;25;01;02;247;Fontenelle-Montby;87;3;90;25247
27;25;03;14;248;Les Fontenelles;549;112;661;25248
27;25;01;02;249;Fontenotte;61;2;63;25249
27;25;01;02;251;Fourbanne;174;8;182;25251
27;25;03;11;252;Fourcatier-et-Maison-Neuve;115;0;115;25252
27;25;01;17;253;Fourg;393;4;397;25253
27;25;03;11;254;Les Fourgs;1405;31;1436;25254
27;25;02;12;255;Fournet-Blancheroche;349;13;362;25255
27;25;02;12;256;Frambouhans;906;14;920;25256
27;25;01;17;257;Franey;268;4;272;25257
27;25;01;04;258;Franois;2295;39;2334;25258
27;25;03;11;259;Frasne;1926;37;1963;25259
27;25;02;12;261;Froidevaux;80;1;81;25261
27;25;03;18;262;Fuans;466;24;490;25262
27;25;03;11;263;Gellin;250;2;252;25263
27;25;02;03;264;Gémonval;84;2;86;25264
27;25;01;02;265;Geneuille;1317;20;1337;25265
27;25;02;03;266;Geney;116;3;119;25266
27;25;01;08;267;Gennes;682;20;702;25267
27;25;03;18;268;Germéfontaine;115;2;117;25268
27;25;01;02;269;Germondans;61;1;62;25269
27;25;01;15;270;Gevresin;121;6;127;25270
27;25;03;15;271;Gilley;1691;38;1729;25271
27;25;01;02;273;Glamondans;207;4;211;25273
27;25;02;12;274;Glay;339;2;341;25274
27;25;02;12;275;Glère;201;4;205;25275
27;25;01;02;276;Gondenans-Montby;171;2;173;25276
27;25;01;02;277;Gondenans-les-Moulins;73;0;73;25277
27;25;01;02;278;Gonsans;558;13;571;25278
27;25;01;02;279;Gouhelans;119;1;120;25279
27;25;02;12;280;Goumois;157;4;161;25280
27;25;02;19;281;Goux-lès-Dambelin;282;0;282;25281
27;25;03;15;282;Goux-les-Usiers;763;13;776;25282
27;25;01;17;283;Goux-sous-Landet;64;1;65;25283
27;25;02;10;284;Grand-Charmont;5786;73;5859;25284
27;25;03;14;285;Grand'Combe-Châteleu;1484;26;1510;25285
27;25;03;14;286;Grand'Combe-des-Bois;125;5;130;25286
27;25;01;04;287;Grandfontaine;1771;42;1813;25287
27;25;03;18;288;Fournets-Luisans;719;19;738;25288
27;25;03;18;289;Grandfontaine-sur-Creuse;73;3;76;25289
27;25;02;18;290;La Grange;95;3;98;25290
27;25;03;16;293;Granges-Narboz;1267;51;1318;25293
27;25;03;11;295;Les Grangettes;298;5;303;25295
27;25;03;14;296;Les Gras;788;28;816;25296
27;25;01;08;297;Le Gratteris;169;3;172;25297
27;25;01;02;298;Grosbois;242;8;250;25298
27;25;01;02;299;Guillon-les-Bains;110;1;111;25299
27;25;01;18;300;Guyans-Durnes;297;5;302;25300
27;25;03;18;301;Guyans-Vennes;860;26;886;25301
27;25;03;15;303;Hauterive-la-Fresse;226;6;232;25303
27;25;02;01;304;Hérimoncourt;3662;62;3724;25304
27;25;01;15;305;L'Hôpital-du-Grosbois;593;17;610;25305
27;25;02;03;306;L'Hôpital-Saint-Lieffroy;124;5;129;25306
27;25;03;11;307;Les Hôpitaux-Neufs;913;11;924;25307
27;25;03;11;308;Les Hôpitaux-Vieux;463;6;469;25308
27;25;03;16;309;Houtaud;1128;36;1164;25309
27;25;01;02;310;Huanne-Montmartin;98;1;99;25310
27;25;02;03;311;Hyémondans;207;4;211;25311
27;25;01;02;312;Hyèvre-Magny;67;1;68;25312
27;25;01;02;313;Hyèvre-Paroisse;195;3;198;25313
27;25;02;12;314;Indevillers;268;2;270;25314
27;25;02;03;315;L'Isle-sur-le-Doubs;2865;70;2935;25315
27;25;02;03;316;Issans;235;12;247;25316
27;25;01;17;317;Jallerange;265;5;270;25317
27;25;03;11;318;Jougne;1801;33;1834;25318
27;25;03;11;320;Labergement-Sainte-Marie;1221;34;1255;25320
27;25;03;14;321;Villers-le-Lac;5188;116;5304;25321
27;25;02;03;322;Laire;406;10;416;25322
27;25;01;02;323;Laissey;445;6;451;25323
27;25;01;03;324;Lanans;162;8;170;25324
27;25;03;18;325;Landresse;232;8;240;25325
27;25;01;17;326;Lantenne-Vertière;529;13;542;25326
27;25;02;03;327;Lanthenans;70;0;70;25327
27;25;01;09;328;Larnod;786;11;797;25328
27;25;03;14;329;Laval-le-Prieuré;36;1;37;25329
27;25;01;17;330;Lavans-Quingey;181;3;184;25330
27;25;01;15;331;Lavans-Vuillafans;242;5;247;25331
27;25;01;17;332;Lavernay;575;10;585;25332
27;25;03;18;333;Laviron;343;15;358;25333
27;25;03;11;334;Levier;2236;243;2479;25334
27;25;02;12;335;Liebvillers;152;5;157;25335
27;25;01;17;336;Liesle;543;5;548;25336
27;25;01;15;338;Lizine;97;1;98;25338
27;25;01;15;339;Lods;223;2;225;25339
27;25;01;17;340;Lombard;188;4;192;25340
27;25;01;02;341;Lomont-sur-Crête;178;6;184;25341
27;25;03;18;342;Longechaux;79;3;82;25342
27;25;03;18;343;Longemaison;165;3;168;25343
27;25;03;18;344;Longevelle-lès-Russey;45;0;45;25344
27;25;02;03;345;Longevelle-sur-Doubs;670;14;684;25345
27;25;01;15;346;Longeville;180;3;183;25346
27;25;03;15;347;La Longeville;823;21;844;25347
27;25;03;11;348;Longevilles-Mont-d'Or;609;16;625;25348
27;25;03;18;349;Loray;564;15;579;25349
27;25;02;03;350;Lougres;736;22;758;25350
27;25;03;14;351;Le Luhier;234;1;235;25351
27;25;01;02;354;Luxiol;159;0;159;25354
27;25;03;18;355;Magny-Châtelard;62;0;62;25355
27;25;02;12;356;Maîche;4266;103;4369;25356
27;25;03;15;357;Maisons-du-Bois-Lièvremont;852;8;860;25357
27;25;01;15;359;Malans;160;5;165;25359
27;25;01;15;360;Malbrans;171;4;175;25360
27;25;03;11;361;Malbuisson;844;25;869;25361
27;25;03;11;362;Malpas;284;12;296;25362
27;25;01;08;364;Mamirolle;1795;18;1813;25364
27;25;02;03;365;Mancenans;305;5;310;25365
27;25;02;12;366;Mancenans-Lizerne;193;6;199;25366
27;25;02;19;367;Mandeure;4795;150;4945;25367
27;25;01;07;368;Marchaux-Chaudefontaine;1479;21;1500;25368
27;25;02;03;369;Marvelise;162;3;165;25369
27;25;02;19;370;Mathay;2152;37;2189;25370
27;25;01;05;371;Mazerolles-le-Salin;211;7;218;25371
27;25;02;03;372;Médière;275;12;287;25372
27;25;03;14;373;Le Mémont;46;2;48;25373
27;25;01;17;374;Mercey-le-Grand;555;16;571;25374
27;25;01;15;375;Mérey-sous-Montrond;442;10;452;25375
27;25;01;02;376;Mérey-Vieilley;154;5;159;25376
27;25;01;02;377;Mésandans;231;6;237;25377
27;25;02;12;378;Meslières;346;8;354;25378
27;25;01;17;379;Mesmay;71;4;75;25379
27;25;03;11;380;Métabief;1339;36;1375;25380
27;25;01;06;381;Miserey-Salines;2555;37;2592;25381
27;25;01;02;382;Moncey;609;6;615;25382
27;25;01;17;383;Moncley;276;6;282;25383
27;25;01;02;384;Mondon;97;1;98;25384
27;25;01;02;385;Montagney-Servigney;128;3;131;25385
27;25;02;12;386;Montancy;126;3;129;25386
27;25;02;12;387;Montandon;385;9;394;25387
27;25;02;13;388;Montbéliard;25806;559;26365;25388
27;25;03;14;389;Montbéliardot;113;4;117;25389
27;25;03;15;390;Montbenoît;399;12;411;25390
27;25;03;14;391;Mont-de-Laval;179;6;185;25391
27;25;02;12;392;Mont-de-Vougney;192;5;197;25392
27;25;02;12;393;Montécheroux;549;7;556;25393
27;25;02;03;394;Montenois;1472;43;1515;25394
27;25;01;08;395;Montfaucon;1570;49;1619;25395
27;25;01;09;397;Montferrand-le-Château;2180;42;2222;25397
27;25;03;15;398;Montflovin;115;4;119;25398
27;25;01;15;400;Montgesoye;472;9;481;25400
27;25;01;02;401;Montivernage;26;0;26;25401
27;25;02;12;402;Montjoie-le-Château;24;1;25;25402
27;25;03;14;403;Montlebon;2129;71;2200;25403
27;25;01;15;404;Montmahoux;91;2;93;25404
27;25;03;11;405;Montperreux;899;41;940;25405
27;25;01;17;406;Montrond-le-Château;566;14;580;25406
27;25;01;02;408;Montussaint;56;1;57;25408
27;25;01;08;410;Morre;1342;62;1404;25410
27;25;03;14;411;Morteau;6853;336;7189;25411
27;25;03;11;413;Mouthe;1047;36;1083;25413
27;25;01;17;414;Le Moutherot;123;2;125;25414
27;25;01;15;415;Mouthier-Haute-Pierre;341;5;346;25415
27;25;01;17;416;Myon;183;4;187;25416
27;25;01;02;417;Naisey-les-Granges;804;20;824;25417
27;25;01;08;418;Nancray;1259;29;1288;25418
27;25;01;02;419;Nans;94;4;98;25419
27;25;01;15;420;Nans-sous-Sainte-Anne;166;4;170;25420
27;25;03;14;421;Narbief;72;4;76;25421
27;25;02;19;422;Neuchâtel-Urtière;178;4;182;25422
27;25;03;18;424;Les Premiers Sapins;1544;32;1576;25424
27;25;03;14;425;NoÃ«l-Cerneux;455;16;471;25425
27;25;02;19;426;Noirefontaine;335;6;341;25426
27;25;01;05;427;Noironte;394;5;399;25427
27;25;02;10;428;Nommay;1619;38;1657;25428
27;25;01;08;429;Novillars;1497;41;1538;25429
27;25;01;02;430;Ollans;39;0;39;25430
27;25;02;03;431;Onans;339;13;352;25431
27;25;03;18;432;Orchamps-Vennes;2149;58;2207;25432
27;25;02;12;433;Orgeans-Blanchefontaine;41;1;42;25433
27;25;01;15;434;Ornans;4423;104;4527;25434
27;25;03;18;435;Orsans;163;4;167;25435
27;25;02;03;436;Orve;57;2;59;25436
27;25;01;02;437;Osse;345;3;348;25437
27;25;01;09;438;Osselle-Routelle;956;15;971;25438
27;25;01;02;439;Ougney-Douvot;254;2;256;25439
27;25;03;15;440;Ouhans;376;8;384;25440
27;25;03;18;441;Ouvans;65;1;66;25441
27;25;03;11;442;Oye-et-Pallet;728;12;740;25442
27;25;01;17;443;Palantine;78;1;79;25443
27;25;01;02;444;Palise;141;4;145;25444
27;25;01;17;445;Paroy;124;2;126;25445
27;25;01;02;446;Passavant;191;10;201;25446
27;25;03;18;447;Passonfontaine;344;5;349;25447
27;25;01;05;448;Pelousey;1526;29;1555;25448
27;25;02;18;449;Péseux;138;1;139;25449
27;25;01;17;450;Pessans;86;3;89;25450
27;25;03;11;451;Petite-Chaux;142;3;145;25451
27;25;02;12;452;Pierrefontaine-lès-Blamont;470;12;482;25452
27;25;03;18;453;Pierrefontaine-les-Varans;1396;39;1435;25453
27;25;01;05;454;Pirey;2127;42;2169;25454
27;25;01;17;455;Placey;198;4;202;25455
27;25;03;14;456;Plaimbois-du-Miroir;268;9;277;25456
27;25;03;18;457;Plaimbois-Vennes;109;0;109;25457
27;25;02;12;458;Les Plains-et-Grands-Essarts;214;5;219;25458
27;25;03;11;459;La Planée;314;10;324;25459
27;25;01;17;460;Le Val;242;24;266;25460
27;25;02;03;461;Pompierre-sur-Doubs;304;2;306;25461
27;25;03;16;462;Pontarlier;17542;898;18440;25462
27;25;02;19;463;Pont-de-Roide-Vermondans;4124;74;4198;25463
27;25;03;11;464;Les Pontets;132;4;136;25464
27;25;01;02;465;Pont-les-Moulins;203;3;206;25465
27;25;01;17;466;Pouilley-Français;828;18;846;25466
27;25;01;05;467;Pouilley-les-Vignes;1982;42;2024;25467
27;25;01;02;468;Pouligney-Lusans;846;19;865;25468
27;25;02;03;469;Présentevillers;458;12;470;25469
27;25;02;03;470;La Prétière;157;5;162;25470
27;25;02;18;471;Provenchère;138;3;141;25471
27;25;01;02;472;Puessans;31;3;34;25472
27;25;01;09;473;Pugey;731;21;752;25473
27;25;01;02;474;Le Puy;113;3;116;25474
27;25;01;17;475;Quingey;1441;14;1455;25475
27;25;02;03;476;Rahon;125;0;125;25476
27;25;01;04;477;Rancenay;396;6;402;25477
27;25;02;03;478;Randevillers;122;2;124;25478
27;25;02;03;479;Rang;401;4;405;25479
27;25;02;03;481;Raynans;334;5;339;25481
27;25;01;17;482;Recologne;667;3;670;25482
27;25;03;11;483;Reculfoz;39;3;42;25483
27;25;02;19;485;Rémondans-Vaivre;233;4;237;25485
27;25;03;11;486;Remoray-Boujeons;425;11;436;25486
27;25;03;15;487;Renédale;46;3;49;25487
27;25;01;17;488;Rennes-sur-Loue;109;6;115;25488
27;25;01;15;489;Reugney;284;27;311;25489
27;25;01;02;490;Rigney;375;19;394;25490
27;25;01;02;491;Rignosot;116;3;119;25491
27;25;01;02;492;Rillans;94;3;97;25492
27;25;03;11;493;La Rivière-Drugeon;920;26;946;25493
27;25;03;11;494;Rochejean;711;24;735;25494
27;25;01;08;495;Roche-lez-Beaupré;2157;26;2183;25495
27;25;02;03;496;Roche-lès-Clerval;101;0;101;25496
27;25;02;12;497;Roches-lès-Blamont;617;14;631;25497
27;25;01;02;498;Rognon;48;0;48;25498
27;25;01;02;499;Romain;124;2;126;25499
27;25;01;17;500;Ronchaux;87;1;88;25500
27;25;03;11;501;Rondefontaine;37;1;38;25501
27;25;01;17;502;Roset-Fluans;546;4;550;25502
27;25;02;18;503;Rosières-sur-Barbèche;116;4;120;25503
27;25;03;18;504;Rosureux;80;2;82;25504
27;25;01;02;505;Rougemont;1035;27;1062;25505
27;25;01;02;506;Rougemontot;92;0;92;25506
27;25;01;17;507;Rouhe;75;2;77;25507
27;25;01;02;508;Roulans;1130;23;1153;25508
27;25;01;17;510;Ruffey-le-Château;361;9;370;25510
27;25;01;17;511;Rurey;348;6;354;25511
27;25;03;14;512;Le Russey;2408;52;2460;25512
27;25;01;15;513;Sainte-Anne;47;0;47;25513
27;25;03;11;514;Saint-Antoine;341;17;358;25514
27;25;03;16;515;Sainte-Colombe;428;8;436;25515
27;25;02;03;516;Saint-Georges-Armont;124;6;130;25516
27;25;03;15;517;Saint-Gorgon-Main;284;4;288;25517
27;25;01;02;518;Saint-Hilaire;157;9;166;25518
27;25;02;12;519;Saint-Hippolyte;887;13;900;25519
27;25;01;02;520;Saint-Juan;176;3;179;25520
27;25;02;03;521;Saint-Julien-lès-Montbéliard;163;5;168;25521
27;25;03;14;522;Saint-Julien-lès-Russey;187;3;190;25522
27;25;02;03;523;Sainte-Marie;680;15;695;25523
27;25;02;03;524;Saint-Maurice-Colombier;903;26;929;25524
27;25;03;11;525;Saint-Point-Lac;292;12;304;25525
27;25;02;13;526;Sainte-Suzanne;1455;41;1496;25526
27;25;01;17;527;Saint-Vit;4922;73;4995;25527
27;25;01;17;528;Samson;74;0;74;25528
27;25;02;03;529;Sancey;1308;27;1335;25529
27;25;01;08;532;Saône;3231;69;3300;25532
27;25;01;15;533;Saraz;15;0;15;25533
27;25;03;11;534;Sarrageois;193;4;197;25534
27;25;01;15;535;Saules;229;6;235;25535
27;25;01;17;536;Sauvagney;187;2;189;25536
27;25;01;15;537;Scey-Maisières;284;9;293;25537
27;25;01;02;538;Séchin;116;4;120;25538
27;25;02;01;539;Seloncourt;5726;143;5869;25539
27;25;02;03;540;Semondans;307;6;313;25540
27;25;03;15;541;Septfontaines;371;8;379;25541
27;25;01;05;542;Serre-les-Sapins;1764;30;1794;25542
27;25;01;03;544;Servin;208;9;217;25544
27;25;01;15;545;Silley-Amancey;144;2;146;25545
27;25;01;02;546;Silley-Bléfond;60;1;61;25546
27;25;02;10;547;Sochaux;3829;41;3870;25547
27;25;02;19;548;Solemont;139;7;146;25548
27;25;03;15;549;Sombacour;632;7;639;25549
27;25;03;18;550;La Sommette;242;7;249;25550
27;25;02;12;551;Soulce-Cernay;131;1;132;25551
27;25;02;03;552;Sourans;117;2;119;25552
27;25;02;03;553;Soye;399;9;408;25553
27;25;02;03;554;Surmont;116;3;119;25554
27;25;02;01;555;Taillecourt;1098;25;1123;25555
27;25;01;02;556;Tallans;47;3;50;25556
27;25;01;06;557;Tallenay;425;8;433;25557
27;25;01;15;558;Tarcenay-Foucherans;1528;24;1552;25558
27;25;02;12;559;Thiébouhans;257;6;263;25559
27;25;01;07;560;Thise;3020;42;3062;25560
27;25;01;09;561;Thoraise;348;9;357;25561
27;25;02;12;562;Thulay;213;6;219;25562
27;25;01;02;563;Thurey-le-Mont;122;2;124;25563
27;25;01;09;564;Torpes;1019;16;1035;25564
27;25;03;11;565;Touillon-et-Loutelet;275;13;288;25565
27;25;01;02;566;La Tour-de-Sçay;300;4;304;25566
27;25;01;02;567;Tournans;117;3;120;25567
27;25;01;15;569;Trépot;540;11;551;25569
27;25;01;02;570;Tressandans;26;1;27;25570
27;25;02;12;571;Trévillers;498;11;509;25571
27;25;01;02;572;Trouvans;105;5;110;25572
27;25;02;12;573;Urtière;13;0;13;25573
27;25;01;02;574;Uzelle;175;1;176;25574
27;25;01;08;575;Vaire;807;10;817;25575
27;25;03;18;578;Valdahon;5748;101;5849;25578
27;25;01;02;579;Val-de-Roulans;206;3;209;25579
27;25;02;19;580;Valentigney;11272;169;11441;25580
27;25;01;02;582;Valleroy;142;2;144;25582
27;25;02;03;583;Valonne;251;5;256;25583
27;25;02;12;584;Valoreille;125;4;129;25584
27;25;02;01;586;Vandoncourt;815;31;846;25586
27;25;02;18;588;Vaucluse;120;30;150;25588
27;25;02;18;589;Vauclusotte;84;1;85;25589
27;25;01;03;590;Vaudrivillers;84;2;86;25590
27;25;02;12;591;Vaufrey;157;0;157;25591
27;25;03;11;592;Vaux-et-Chantegrue;624;14;638;25592
27;25;01;17;594;Velesmes-Essarts;352;4;356;25594
27;25;02;03;595;Vellerot-lès-Belvoir;93;0;93;25595
27;25;03;18;596;Vellerot-lès-Vercel;71;1;72;25596
27;25;02;03;597;Vellevans;236;3;239;25597
27;25;01;02;598;Venise;522;7;529;25598
27;25;01;02;599;Vennans;256;8;264;25599
27;25;03;18;600;Vennes;205;4;209;25600
27;25;03;18;601;Vercel-Villedieu-le-Camp;1664;83;1747;25601
27;25;01;02;602;Vergranne;115;5;120;25602
27;25;01;02;604;Verne;126;4;130;25604
27;25;03;18;605;Vernierfontaine;471;11;482;25605
27;25;02;03;607;Vernois-lès-Belvoir;60;1;61;25607
27;25;02;03;608;Le Vernoy;175;2;177;25608
27;25;03;16;609;Verrières-de-Joux;476;11;487;25609
27;25;01;08;611;La Vèze;478;7;485;25611
27;25;01;02;612;Vieilley;692;20;712;25612
27;25;01;02;613;Viéthorey;94;2;96;25613
27;25;02;10;614;Vieux-Charmont;2793;54;2847;25614
27;25;02;12;615;Villars-lès-Blamont;441;6;447;25615
27;25;01;17;616;Villars-Saint-Georges;280;3;283;25616
27;25;02;19;617;Villars-sous-Dampjoux;353;6;359;25617
27;25;02;03;618;Villars-sous-Ecot;347;8;355;25618
27;25;03;11;619;Les Villedieu;202;3;205;25619
27;25;03;15;620;Ville-du-Pont;336;7;343;25620
27;25;03;11;621;Villeneuve-d'Amont;227;36;263;25621
27;25;01;17;622;Villers-Buzon;259;1;260;25622
27;25;03;18;623;Villers-Chief;126;1;127;25623
27;25;01;02;624;Villers-Grélot;148;3;151;25624
27;25;03;18;625;Villers-la-Combe;52;1;53;25625
27;25;01;02;626;Villers-Saint-Martin;221;8;229;25626
27;25;03;11;627;Villers-sous-Chalamont;304;5;309;25627
27;25;01;15;628;Villers-sous-Montrond;210;3;213;25628
27;25;01;02;629;Voillans;204;6;210;25629
27;25;01;18;630;Voires;80;0;80;25630
27;25;01;09;631;Vorges-les-Pins;601;11;612;25631
27;25;02;19;632;Voujeaucourt;3148;85;3233;25632
27;25;01;15;633;Vuillafans;735;13;748;25633
27;25;03;16;634;Vuillecin;637;23;660;25634
27;25;02;03;635;Vyt-lès-Belvoir;188;3;191;25635
84;26;01;04;001;Solaure en Diois;428;8;436;26001
84;26;03;12;002;Albon;1985;37;2022;26002
84;26;02;03;003;Aleyrac;50;0;50;26003
84;26;03;01;004;Alixan;2546;77;2623;26004
84;26;02;09;005;Allan;1791;50;1841;26005
84;26;01;07;006;Allex;2495;77;2572;26006
84;26;01;07;007;Ambonil;104;7;111;26007
84;26;02;08;008;Ancône;1370;28;1398;26008
84;26;03;12;009;Andancette;1337;35;1372;26009
84;26;03;12;010;Anneyron;4063;97;4160;26010
84;26;01;02;011;Aouste-sur-Sye;2580;42;2622;26011
84;26;01;04;012;Arnayon;21;3;24;26012
84;26;02;10;013;Arpavon;77;3;80;26013
84;26;03;05;014;Arthémonay;594;8;602;26014
84;26;01;04;015;Aubenasson;77;4;81;26015
84;26;02;10;016;Aubres;418;16;434;26016
84;26;01;04;017;Aucelon;16;0;16;26017
84;26;02;10;018;Aulan;12;1;13;26018
84;26;01;04;019;Aurel;244;3;247;26019
84;26;01;02;020;La Répara-Auriples;242;6;248;26020
84;26;01;02;021;Autichamp;124;4;128;26021
84;26;02;10;022;Ballons;88;3;91;26022
84;26;03;19;023;Barbières;1105;19;1124;26023
84;26;03;02;024;Barcelonne;354;10;364;26024
84;26;01;04;025;Barnave;201;10;211;26025
84;26;02;10;026;Barret-de-Lioure;66;0;66;26026
84;26;01;04;027;Barsac;139;2;141;26027
84;26;03;05;028;Bathernay;235;13;248;26028
84;26;01;04;030;La Bâtie-des-Fonds;2;0;2;26030
84;26;02;03;031;La Bâtie-Rolland;1029;27;1056;26031
84;26;03;02;032;La Baume-Cornillane;452;9;461;26032
84;26;02;06;033;La Baume-de-Transit;926;17;943;26033
84;26;03;19;034;La Baume-d'Hostun;576;9;585;26034
84;26;01;02;035;Beaufort-sur-Gervanne;477;8;485;26035
84;26;01;04;036;Beaumont-en-Diois;105;4;109;26036
84;26;03;17;037;Beaumont-lès-Valence;3984;85;4069;26037
84;26;03;13;038;Beaumont-Monteux;1324;33;1357;26038
84;26;03;19;039;Beauregard-Baret;874;13;887;26039
84;26;01;04;040;Beaurières;69;2;71;26040
84;26;03;12;041;Beausemblant;1427;26;1453;26041
84;26;03;17;042;Beauvallon;1599;26;1625;26042
84;26;02;10;043;Beauvoisin;144;5;149;26043
84;26;02;03;045;La Bégude-de-Mazenc;1654;47;1701;26045
84;26;02;10;046;Bellecombe-Tarendol;68;3;71;26046
84;26;01;04;047;Bellegarde-en-Diois;92;0;92;26047
84;26;02;10;048;Bénivay-Ollon;72;1;73;26048
84;26;03;19;049;Bésayes;1250;37;1287;26049
84;26;02;10;050;Bésignan;86;2;88;26050
84;26;02;03;051;Bézaudun-sur-Bîne;67;2;69;26051
84;26;02;03;052;Bonlieu-sur-Roubion;481;12;493;26052
84;26;02;06;054;Bouchet;1544;22;1566;26054
84;26;01;04;055;Boulc;153;2;155;26055
84;26;02;03;056;Bourdeaux;679;15;694;26056
84;26;03;01;057;Bourg-de-Péage;9957;145;10102;26057
84;26;03;15;058;Bourg-lès-Valence;19792;566;20358;26058
84;26;01;19;059;Bouvante;212;3;215;26059
84;26;02;03;060;Bouvières;147;6;153;26060
84;26;03;05;061;Bren;595;10;605;26061
84;26;01;04;062;Brette;36;3;39;26062
84;26;02;10;063;Buis-les-Baronnies;2325;95;2420;26063
84;26;03;16;064;Chabeuil;6814;179;6993;26064
84;26;01;02;065;Chabrillan;751;8;759;26065
84;26;01;19;066;Le Chaffal;41;0;41;26066
84;26;01;04;067;Chalancon;58;1;59;26067
84;26;03;05;068;Le Chalon;211;6;217;26068
84;26;01;04;069;Chamaloc;129;3;132;26069
84;26;02;06;070;Chamaret;527;11;538;26070
84;26;03;13;071;Chanos-Curson;1084;33;1117;26071
84;26;03;13;072;Chantemerle-les-Blés;1292;20;1312;26072
84;26;02;06;073;Chantemerle-lès-Grignan;242;3;245;26073
84;26;01;19;074;La Chapelle-en-Vercors;720;132;852;26074
84;26;02;10;075;La Charce;28;1;29;26075
84;26;01;04;076;Charens;27;0;27;26076
84;26;03;05;077;Charmes-sur-l'Herbasse;887;22;909;26077
84;26;02;03;078;Charols;935;14;949;26078
84;26;03;19;079;Charpey;1500;38;1538;26079
84;26;01;04;080;Chastel-Arnaud;43;0;43;26080
84;26;03;02;081;Châteaudouble;576;24;600;26081
84;26;02;10;082;Châteauneuf-de-Bordette;102;1;103;26082
84;26;03;05;083;Châteauneuf-de-Galaure;1831;580;2411;26083
84;26;03;13;084;Châteauneuf-sur-Isère;3945;147;4092;26084
84;26;02;09;085;Châteauneuf-du-Rhône;2724;52;2776;26085
84;26;01;04;086;Châtillon-en-Diois;666;12;678;26086
84;26;03;11;087;Châtillon-Saint-Jean;1316;45;1361;26087
84;26;03;19;088;Chatuzange-le-Goubet;5934;136;6070;26088
84;26;02;10;089;Chaudebonne;61;1;62;26089
84;26;01;04;090;La Chaudière;33;0;33;26090
84;26;02;10;091;Chauvac-Laux-Montaux;42;0;42;26091
84;26;03;05;092;Chavannes;735;11;746;26092
84;26;02;14;093;Clansayes;531;13;544;26093
84;26;03;12;094;Claveyson;862;24;886;26094
84;26;02;03;095;Cléon-d'Andran;922;32;954;26095
84;26;03;11;096;Clérieux;2061;37;2098;26096
84;26;01;07;097;Cliousclat;616;16;632;26097
84;26;01;02;098;Cobonne;167;5;172;26098
84;26;02;06;099;Colonzelle;556;12;568;26099
84;26;03;02;100;Combovin;449;15;464;26100
84;26;02;03;101;Comps;143;10;153;26101
84;26;02;03;102;Condillac;136;7;143;26102
84;26;02;10;103;Condorcet;499;4;503;26103
84;26;02;10;104;Cornillac;89;0;89;26104
84;26;02;10;105;Cornillon-sur-l'Oule;72;1;73;26105
84;26;02;08;106;La Coucourde;1157;22;1179;26106
84;26;03;05;107;Crépol;542;15;557;26107
84;26;01;02;108;Crest;8680;274;8954;26108
84;26;03;13;110;Crozes-Hermitage;659;10;669;26110
84;26;02;03;111;Crupies;100;1;101;26111
84;26;02;10;112;Curnier;197;8;205;26112
84;26;01;04;113;Die;4718;240;4958;26113
84;26;02;03;114;Dieulefit;3239;136;3375;26114
84;26;01;02;115;Divajeu;663;70;733;26115
84;26;02;06;116;Donzère;5921;102;6023;26116
84;26;01;19;117;Echevis;56;4;60;26117
84;26;03;05;118;Epinouze;1510;22;1532;26118
84;26;03;13;119;Erôme;806;7;813;26119
84;26;02;09;121;Espeluche;1103;41;1144;26121
84;26;01;04;122;Espenel;179;2;181;26122
84;26;01;04;123;Establet;25;0;25;26123
84;26;03;07;124;Etoile-sur-Rhône;5520;127;5647;26124
84;26;01;02;125;Eurre;1387;33;1420;26125
84;26;02;10;126;Eygalayes;91;0;91;26126
84;26;02;10;127;Eygaliers;115;2;117;26127
84;26;01;04;128;Eygluy-Escoulin;74;0;74;26128
84;26;03;19;129;Eymeux;1026;22;1048;26129
84;26;02;10;130;Eyroles;24;0;24;26130
84;26;02;03;131;Eyzahut;150;1;151;26131
84;26;03;12;133;Fay-le-Clos;163;4;167;26133
84;26;01;03;134;Félines-sur-Rimandoule;83;1;84;26134
84;26;02;10;135;Ferrassières;124;2;126;26135
84;26;01;04;136;Val-Maravel;51;0;51;26136
84;26;01;03;137;Francillon-sur-Roubion;191;2;193;26137
84;26;02;14;138;La Garde-Adhémar;1115;34;1149;26138
84;26;03;11;139;Génissieux;2392;57;2449;26139
84;26;03;05;140;Geyssans;717;28;745;26140
84;26;01;02;141;Gigors-et-Lozeron;210;5;215;26141
84;26;01;04;142;Glandage;118;1;119;26142
84;26;03;05;143;Le Grand-Serre;906;51;957;26143
84;26;01;02;144;Grane;1961;51;2012;26144
84;26;02;06;145;Les Granges-Gontardes;664;20;684;26145
84;26;02;06;146;Grignan;1577;44;1621;26146
84;26;01;04;147;Gumiane;19;1;20;26147
84;26;03;05;148;Hauterives;1894;57;1951;26148
84;26;03;19;149;Hostun;991;8;999;26149
84;26;02;10;150;Izon-la-Bruisse;11;0;11;26150
84;26;01;04;152;Jonchères;27;0;27;26152
84;26;02;10;153;Laborel;98;1;99;26153
84;26;02;10;154;Lachau;240;4;244;26154
84;26;03;05;155;Lapeyrouse-Mornay;1221;18;1239;26155
84;26;03;13;156;Larnage;1057;43;1100;26156
84;26;02;03;157;La Laupie;748;17;765;26157
84;26;01;04;159;Laval-d'Aix;116;2;118;26159
84;26;03;12;160;Laveyron;1232;17;1249;26160
84;26;02;10;161;Lemps;49;0;49;26161
84;26;03;05;162;Lens-Lestang;891;29;920;26162
84;26;01;19;163;Léoncel;51;0;51;26163
84;26;01;04;164;Lesches-en-Diois;56;1;57;26164
84;26;01;07;165;Livron-sur-Drôme;9202;152;9354;26165
84;26;01;07;166;Loriol-sur-Drôme;6616;94;6710;26166
84;26;01;04;167;Luc-en-Diois;538;1;539;26167
84;26;01;04;168;Lus-la-Croix-Haute;535;14;549;26168
84;26;02;06;169;Malataverne;2182;42;2224;26169
84;26;03;16;170;Malissard;3207;97;3304;26170
84;26;02;03;171;Manas;191;9;200;26171
84;26;03;05;172;Manthes;664;10;674;26172
84;26;03;19;173;Marches;876;20;896;26173
84;26;03;05;174;Margès;1116;32;1148;26174
84;26;01;04;175;Marignac-en-Diois;224;9;233;26175
84;26;02;03;176;Marsanne;1301;42;1343;26176
84;26;03;05;177;Marsaz;700;22;722;26177
84;26;01;04;178;Menglon;534;7;541;26178
84;26;03;13;179;Mercurol-Veaunes;2732;56;2788;26179
84;26;02;10;180;Mérindol-les-Oliviers;220;6;226;26180
84;26;02;10;181;Mévouillon;235;7;242;26181
84;26;02;10;182;Mirabel-aux-Baronnies;1550;35;1585;26182
84;26;01;02;183;Mirabel-et-Blacons;1170;30;1200;26183
84;26;01;07;185;Mirmande;587;14;601;26185
84;26;01;04;186;Miscon;53;1;54;26186
84;26;02;10;188;Mollans-sur-Ouvèze;1064;24;1088;26188
84;26;02;10;189;Montauban-sur-l'Ouvèze;119;2;121;26189
84;26;02;10;190;Montaulieu;85;2;87;26190
84;26;02;09;191;Montboucher-sur-Jabron;2400;60;2460;26191
84;26;02;06;192;Montbrison-sur-Lez;275;11;286;26192
84;26;02;10;193;Montbrun-les-Bains;442;9;451;26193
84;26;03;05;194;Montchenu;581;16;597;26194
84;26;01;02;195;Montclar-sur-Gervanne;191;3;194;26195
84;26;03;17;196;Montéléger;1796;140;1936;26196
84;26;03;16;197;Montélier;4271;118;4389;26197
84;26;02;97;198;Montélimar;39818;1234;41052;26198
84;26;02;10;199;Montferrand-la-Fare;28;0;28;26199
84;26;02;10;200;Montfroc;75;1;76;26200
84;26;02;10;201;Montguers;48;6;54;26201
84;26;02;03;202;Montjoux;332;11;343;26202
84;26;02;06;203;Montjoyer;281;6;287;26203
84;26;01;04;204;Montlaur-en-Diois;143;5;148;26204
84;26;01;04;205;Montmaur-en-Diois;85;0;85;26205
84;26;03;02;206;Montmeyran;2942;101;3043;26206
84;26;03;05;207;Montmiral;696;18;714;26207
84;26;01;07;208;Montoison;1937;36;1973;26208
84;26;02;10;209;Montréal-les-Sources;24;0;24;26209
84;26;03;05;210;Valherbasse;1025;24;1049;26210
84;26;02;06;211;Montségur-sur-Lauzon;1348;27;1375;26211
84;26;03;02;212;Montvendre;1200;30;1230;26212
84;26;03;05;213;Moras-en-Valloire;681;15;696;26213
84;26;01;03;214;Mornans;75;0;75;26214
84;26;01;04;215;La Motte-Chalancon;416;22;438;26215
84;26;03;12;216;La Motte-de-Galaure;795;15;810;26216
84;26;01;19;217;La Motte-Fanjas;193;3;196;26217
84;26;03;11;218;Mours-Saint-Eusèbe;3229;56;3285;26218
84;26;03;12;219;Mureils;473;8;481;26219
84;26;02;10;220;Nyons;6772;186;6958;26220
84;26;01;02;221;Omblèze;71;2;73;26221
84;26;02;03;222;Orcinas;39;0;39;26222
84;26;01;19;223;Oriol-en-Royans;523;6;529;26223
84;26;03;02;224;Ourches;267;8;275;26224
84;26;03;05;225;Parnans;699;21;720;26225
84;26;02;06;226;Le Pègue;368;6;374;26226
84;26;02;10;227;Pelonne;27;0;27;26227
84;26;01;04;228;Pennes-le-Sec;40;0;40;26228
84;26;02;10;229;La Penne-sur-l'Ouvèze;95;1;96;26229
84;26;03;11;231;Peyrins;2629;69;2698;26231
84;26;03;02;232;Peyrus;592;8;600;26232
84;26;02;10;233;Piégon;242;9;251;26233
84;26;01;02;234;Piégros-la-Clastre;873;17;890;26234
84;26;02;14;235;Pierrelatte;13510;259;13769;26235
84;26;02;10;236;Pierrelongue;214;4;218;26236
84;26;02;10;238;Les Pilles;240;2;242;26238
84;26;02;10;239;Plaisians;206;4;210;26239
84;26;01;02;240;Plan-de-Baix;147;3;150;26240
84;26;01;03;241;Le PoÃ«t-Célard;132;2;134;26241
84;26;02;10;242;Le PoÃ«t-en-Percip;17;0;17;26242
84;26;02;03;243;Le PoÃ«t-Laval;968;39;1007;26243
84;26;02;10;244;Le PoÃ«t-Sigillat;134;1;135;26244
84;26;02;10;245;Pommerol;6;0;6;26245
84;26;01;04;246;Ponet-et-Saint-Auban;126;4;130;26246
84;26;03;12;247;Ponsas;531;8;539;26247
84;26;01;04;248;Pontaix;175;5;180;26248
84;26;02;03;249;Pont-de-Barret;672;17;689;26249
84;26;03;13;250;Pont-de-l'Isère;3573;49;3622;26250
84;26;02;03;251;Portes-en-Valdaine;412;12;424;26251
84;26;03;17;252;Portes-lès-Valence;10680;151;10831;26252
84;26;01;04;253;Poyols;72;1;73;26253
84;26;01;04;254;Pradelle;18;0;18;26254
84;26;01;04;255;Les Prés;23;0;23;26255
84;26;02;10;256;Propiac;141;2;143;26256
84;26;02;03;257;Puygiron;453;21;474;26257
84;26;01;03;258;Puy-Saint-Martin;887;29;916;26258
84;26;03;05;259;Ratières;266;12;278;26259
84;26;02;06;261;Réauville;396;11;407;26261
84;26;01;04;262;Recoubeau-Jansac;260;7;267;26262
84;26;02;10;263;Reilhanette;146;2;148;26263
84;26;02;10;264;Rémuzat;329;7;336;26264
84;26;01;04;266;Rimon-et-Savel;24;0;24;26266
84;26;02;10;267;Rioms;25;1;26;26267
84;26;02;03;268;Rochebaudin;122;0;122;26268
84;26;02;10;269;Rochebrune;56;0;56;26269
84;26;01;19;270;Rochechinard;125;2;127;26270
84;26;03;13;271;La Roche-de-Glun;3395;64;3459;26271
84;26;02;03;272;Rochefort-en-Valdaine;361;9;370;26272
84;26;03;19;273;Rochefort-Samson;1023;20;1043;26273
84;26;01;04;274;Rochefourchat;1;0;1;26274
84;26;02;14;275;Rochegude;1640;46;1686;26275
84;26;02;03;276;Roche-Saint-Secret-Béconne;464;14;478;26276
84;26;01;02;277;La Roche-sur-Grane;164;4;168;26277
84;26;02;10;278;La Roche-sur-le-Buis;283;10;293;26278
84;26;02;10;279;La Rochette-du-Buis;60;2;62;26279
84;26;03;98;281;Romans-sur-Isère;33098;680;33778;26281
84;26;01;04;282;Romeyer;187;8;195;26282
84;26;01;04;283;Rottier;23;0;23;26283
84;26;02;06;284;Roussas;382;8;390;26284
84;26;02;06;285;Rousset-les-Vignes;280;9;289;26285
84;26;02;10;286;Roussieux;24;1;25;26286
84;26;02;03;287;Roynac;485;15;500;26287
84;26;02;10;288;Sahune;308;6;314;26288
84;26;01;04;289;Saillans;1364;21;1385;26289
84;26;01;19;290;Saint-Agnan-en-Vercors;362;10;372;26290
84;26;01;04;291;Saint-Andéol;84;2;86;26291
84;26;02;10;292;Saint-Auban-sur-l'Ouvèze;212;4;216;26292
84;26;03;05;293;Saint-Avit;324;8;332;26293
84;26;03;11;294;Saint-Bardoux;603;18;621;26294
84;26;03;12;295;Saint-Barthélemy-de-Vals;1858;30;1888;26295
84;26;01;04;296;Saint-Benoit-en-Diois;31;1;32;26296
84;26;03;05;298;Saint-Christophe-et-le-Laris;419;5;424;26298
84;26;01;04;299;Sainte-Croix;105;4;109;26299
84;26;01;04;300;Saint-Dizier-en-Diois;48;1;49;26300
84;26;03;05;301;Saint-Donat-sur-l'Herbasse;4248;90;4338;26301
84;26;01;19;302;Sainte-Eulalie-en-Royans;547;11;558;26302
84;26;02;10;303;Sainte-Euphémie-sur-Ouvèze;73;4;77;26303
84;26;02;10;304;Saint-Ferréol-Trente-Pas;275;3;278;26304
84;26;02;03;305;Saint-Gervais-sur-Roubion;1083;22;1105;26305
84;26;02;10;306;Sainte-Jalle;316;5;321;26306
84;26;01;19;307;Saint-Jean-en-Royans;2809;66;2875;26307
84;26;01;04;308;Saint-Julien-en-Quint;150;0;150;26308
84;26;01;19;309;Saint-Julien-en-Vercors;231;5;236;26309
84;26;03;05;310;Saint-Laurent-d'Onay;157;4;161;26310
84;26;01;19;311;Saint-Laurent-en-Royans;1419;50;1469;26311
84;26;02;03;312;Saint-Marcel-lès-Sauzet;1289;46;1335;26312
84;26;03;15;313;Saint-Marcel-lès-Valence;6289;128;6417;26313
84;26;03;05;314;Saint-Martin-d'Août;382;16;398;26314
84;26;01;19;315;Saint-Martin-en-Vercors;352;13;365;26315
84;26;01;19;316;Saint-Martin-le-Colonel;204;7;211;26316
84;26;02;10;317;Saint-Maurice-sur-Eygues;792;13;805;26317
84;26;02;10;318;Saint-May;35;1;36;26318
84;26;03;05;319;Saint-Michel-sur-Savasse;566;11;577;26319
84;26;01;19;320;Saint-Nazaire-en-Royans;814;10;824;26320
84;26;01;04;321;Saint-Nazaire-le-Désert;209;9;218;26321
84;26;02;06;322;Saint-Pantaléon-les-Vignes;420;22;442;26322
84;26;03;11;323;Saint-Paul-lès-Romans;1829;48;1877;26323
84;26;02;14;324;Saint-Paul-Trois-Châteaux;8736;436;9172;26324
84;26;03;12;325;Saint-Rambert-d'Albon;6758;66;6824;26325
84;26;02;14;326;Saint-Restitut;1443;47;1490;26326
84;26;01;04;327;Saint-Roman;215;3;218;26327
84;26;01;04;328;Saint-Sauveur-en-Diois;54;1;55;26328
84;26;02;10;329;Saint-Sauveur-Gouvernet;180;6;186;26329
84;26;03;05;330;Saint-Sorlin-en-Valloire;2254;44;2298;26330
84;26;01;19;331;Saint-Thomas-en-Royans;608;14;622;26331
84;26;03;12;332;Saint-Uze;2062;20;2082;26332
84;26;03;12;333;Saint-Vallier;3960;152;4112;26333
84;26;02;03;334;Salettes;139;2;141;26334
84;26;02;06;335;Salles-sous-Bois;195;3;198;26335
84;26;01;03;336;Saou;567;23;590;26336
84;26;02;08;337;Saulce-sur-Rhône;1844;30;1874;26337
84;26;02;03;338;Sauzet;1823;58;1881;26338
84;26;02;08;339;Savasse;1487;42;1529;26339
84;26;02;10;340;Séderon;258;4;262;26340
84;26;03;13;341;Serves-sur-Rhône;726;12;738;26341
84;26;02;14;342;Solérieux;318;7;325;26342
84;26;02;03;343;Souspierre;103;2;105;26343
84;26;01;03;344;Soyans;392;7;399;26344
84;26;02;14;345;Suze-la-Rousse;2155;55;2210;26345
84;26;01;02;346;Suze;231;5;236;26346
84;26;03;13;347;Tain-l'Hermitage;6106;206;6312;26347
84;26;02;06;348;Taulignan;1650;28;1678;26348
84;26;03;05;349;Tersanne;368;5;373;26349
84;26;02;03;350;Teyssières;75;1;76;26350
84;26;02;03;351;Les Tonils;30;0;30;26351
84;26;02;03;352;La Touche;258;7;265;26352
84;26;02;08;353;Les Tourrettes;1032;18;1050;26353
84;26;03;11;355;Triors;602;8;610;26355
84;26;02;03;356;Truinas;119;4;123;26356
84;26;02;06;357;Tulette;2012;40;2052;26357
84;26;03;02;358;Upie;1519;43;1562;26358
84;26;01;04;359;Vachères-en-Quint;36;0;36;26359
84;26;02;06;360;Valaurie;660;26;686;26360
84;26;01;04;361;Valdrôme;140;3;143;26361
84;26;03;99;362;Valence;64749;1400;66149;26362
84;26;02;10;363;Valouse;38;0;38;26363
84;26;01;19;364;Vassieux-en-Vercors;326;8;334;26364
84;26;01;02;365;Vaunaveys-la-Rochette;585;11;596;26365
84;26;02;10;367;Venterol;692;20;712;26367
84;26;01;04;368;Vercheny;464;6;470;26368
84;26;02;10;369;Verclause;58;1;59;26369
84;26;02;10;370;Vercoiran;138;5;143;26370
84;26;01;04;371;Véronne;47;2;49;26371
84;26;02;10;372;Vers-sur-Méouge;39;1;40;26372
84;26;02;03;373;Vesc;245;8;253;26373
84;26;02;10;374;Villebois-les-Pins;15;0;15;26374
84;26;02;10;375;Villefranche-le-Château;17;1;18;26375
84;26;02;10;376;Villeperdrix;107;1;108;26376
84;26;02;10;377;Vinsobres;1031;24;1055;26377
84;26;01;04;378;Volvent;33;0;33;26378
84;26;03;13;379;Granges-les-Beaumont;908;10;918;26379
84;26;03;13;380;Gervans;550;10;560;26380
84;26;03;19;381;Jaillans;904;12;916;26381
84;26;03;19;382;Saint-Vincent-la-Commanderie;568;7;575;26382
28;27;02;07;001;Aclou;327;9;336;27001
28;27;03;22;002;Acon;464;8;472;27002
28;27;01;18;003;Acquigny;1619;33;1652;27003
28;27;01;16;004;Aigleville;425;8;433;27004
28;27;01;12;005;Ailly;1171;18;1189;27005
28;27;02;04;006;Aizier;148;3;151;27006
28;27;01;18;008;Alizay;1592;16;1608;27008
28;27;02;06;009;Ambenay;566;11;577;27009
28;27;01;13;010;Amécourt;170;7;177;27010
28;27;02;05;011;Amfreville-Saint-Amand;1196;14;1210;27011
28;27;01;19;012;Amfreville-les-Champs;447;16;463;27012
28;27;01;21;013;Amfreville-sous-les-Monts;486;11;497;27013
28;27;01;18;014;Amfreville-sur-Iton;848;23;871;27014
28;27;01;14;015;Andé;1303;31;1334;27015
28;27;01;01;016;Les Andelys;8070;140;8210;27016
28;27;03;11;017;Angerville-la-Campagne;1363;37;1400;27017
28;27;02;17;018;Appeville-Annebault;992;11;1003;27018
28;27;02;22;019;Armentières-sur-Avre;163;7;170;27019
28;27;03;09;020;Arnières-sur-Iton;1676;43;1719;27020
28;27;02;03;021;Asnières;340;9;349;27021
28;27;01;12;022;Le Val d'Hazey;5350;109;5459;27022
28;27;03;08;023;Aulnay-sur-Iton;708;20;728;27023
28;27;01;12;025;Autheuil-Authouillet;956;19;975;27025
28;27;01;13;026;Authevernes;432;9;441;27026
28;27;03;20;027;Les Authieux;286;7;293;27027
28;27;02;17;028;Authou;336;4;340;27028
28;27;03;10;031;Aviron;1101;39;1140;27031
28;27;02;22;032;Chambois;1390;31;1421;27032
28;27;02;15;033;Bacquepuis;306;7;313;27033
28;27;01;19;034;Bacqueville;632;9;641;27034
28;27;02;03;035;Bailleul-la-Vallée;102;1;103;27035
28;27;02;22;036;Bâlines;550;21;571;27036
28;27;02;07;037;Barc;1178;22;1200;27037
28;27;02;22;038;Les Barils;279;6;285;27038
28;27;02;04;039;Barneville-sur-Seine;517;36;553;27039
28;27;02;07;040;Barquet;448;5;453;27040
28;27;02;03;042;Barville;78;0;78;27042
28;27;02;06;043;Les Baux-de-Breteuil;676;21;697;27043
28;27;03;11;044;Les Baux-Sainte-Croix;820;37;857;27044
28;27;01;13;045;Bazincourt-sur-Epte;772;12;784;27045
28;27;02;03;046;Bazoques;149;1;150;27046
28;27;03;08;047;Beaubray;330;8;338;27047
28;27;01;19;048;Beauficel-en-Lyons;187;3;190;27048
28;27;02;02;049;Mesnil-en-Ouche;4554;118;4672;27049
28;27;02;07;050;Beaumontel;641;15;656;27050
28;27;02;07;051;Beaumont-le-Roger;2794;38;2832;27051
28;27;02;07;052;Le Bec-Hellouin;396;3;399;27052
28;27;02;05;053;Le Bec-Thomas;219;5;224;27053
28;27;02;06;054;Bémécourt;582;8;590;27054
28;27;02;15;055;Bérengeville-la-Campagne;331;6;337;27055
28;27;02;02;056;Bernay;9848;311;10159;27056
28;27;02;15;057;Bernienville;285;6;291;27057
28;27;01;12;058;Les Trois Lacs;1769;43;1812;27058
28;27;01;13;059;Bernouville;306;3;309;27059
28;27;02;07;061;Berthouville;327;5;332;27061
28;27;02;05;062;Les Monts du Roumois;1567;47;1614;27062
28;27;02;07;063;Berville-la-Campagne;255;1;256;27063
28;27;02;03;064;Berville-sur-Mer;676;9;685;27064
28;27;02;03;065;Beuzeville;4666;58;4724;27065
28;27;01;19;066;Bézu-la-Forêt;328;6;334;27066
28;27;01;13;067;Bézu-Saint-Eloi;1549;28;1577;27067
28;27;02;06;068;Bois-Anzeray;174;2;176;27068
28;27;02;06;069;Bois-Arnault;695;16;711;27069
28;27;01;01;070;Frenelles-en-Vexin;1726;35;1761;27070
28;27;02;03;071;Le Bois-Hellain;215;2;217;27071
28;27;01;01;072;Bois-Jérôme-Saint-Ouen;748;22;770;27072
28;27;03;20;073;Bois-le-Roi;1214;18;1232;27073
28;27;02;07;074;Boisney;277;8;285;27074
28;27;02;06;075;Bois-Normand-près-Lyre;340;4;344;27075
28;27;01;16;076;Boisset-les-Prévanches;493;9;502;27076
28;27;02;05;077;Boissey-le-Châtel;856;10;866;27077
28;27;01;16;078;La Boissière;266;11;277;27078
28;27;02;03;079;Boissy-Lamberville;362;5;367;27079
28;27;03;11;081;Boncourt;183;7;190;27081
28;27;03;08;082;La Bonneville-sur-Iton;2075;49;2124;27082
28;27;02;17;083;Bonneville-Aptot;261;4;265;27083
28;27;02;05;085;Flancourt-Crescy-en-Roumois;1517;22;1539;27085
28;27;02;05;089;Thénouville;1009;17;1026;27089
28;27;02;05;090;Bosroumois;3649;65;3714;27090
28;27;02;04;091;Bosgouet;737;5;742;27091
28;27;01;19;094;Bosquentin;126;1;127;27094
28;27;02;07;095;Bosrobert;665;11;676;27095
28;27;02;06;096;Les Bottereaux;346;11;357;27096
28;27;01;01;097;Bouafles;661;12;673;27097
28;27;01;19;098;Bouchevilliers;83;3;86;27098
28;27;03;10;099;Le Boulay-Morin;798;10;808;27099
28;27;02;03;100;Boulleville;1185;24;1209;27100
28;27;02;04;101;Bouquelon;523;10;533;27101
28;27;02;04;102;Bouquetot;1033;22;1055;27102
28;27;02;04;103;Bourg-Achard;3942;73;4015;27103
28;27;01;19;104;Bourg-Beaudouin;702;10;712;27104
28;27;02;05;105;Grand Bourgtheroulde;3957;79;4036;27105
28;27;02;03;106;Bournainville-Faverolles;478;5;483;27106
28;27;02;04;107;Bourneville-Sainte-Croix;1324;25;1349;27107
28;27;02;22;108;Bourth;1204;33;1237;27108
28;27;02;07;109;Bray;398;7;405;27109
28;27;02;17;110;Brestot;627;8;635;27110
28;27;03;20;111;Bretagnolles;202;5;207;27111
28;27;02;06;112;Breteuil;4331;125;4456;27112
28;27;02;07;113;Brétigny;139;2;141;27113
28;27;01;16;114;Breuilpont;1216;23;1239;27114
28;27;02;22;115;Breux-sur-Avre;338;7;345;27115
28;27;02;07;116;Brionne;4199;152;4351;27116
28;27;02;06;117;Broglie;1024;20;1044;27117
28;27;02;15;118;Brosville;646;10;656;27118
28;27;01;16;119;Bueil;1615;29;1644;27119
28;27;03;08;120;Burey;404;5;409;27120
28;27;01;16;123;Caillouet-Orgeville;491;12;503;27123
28;27;01;12;124;Cailly-sur-Eure;214;1;215;27124
28;27;02;07;125;Calleville;660;10;670;27125
28;27;02;17;126;Campigny;1134;22;1156;27126
28;27;02;15;127;Canappeville;699;22;721;27127
28;27;02;02;129;Caorches-Saint-Nicolas;594;15;609;27129
28;27;02;06;130;Capelle-les-Grands;419;11;430;27130
28;27;03;08;132;Caugé;860;24;884;27132
28;27;02;04;133;Caumont;1062;10;1072;27133
28;27;02;04;134;Cauverville-en-Roumois;215;0;215;27134
28;27;02;15;135;Cesseville;459;11;470;27135
28;27;01;16;136;Chaignes;276;4;280;27136
28;27;02;06;137;Chaise-Dieu-du-Theil;201;5;206;27137
28;27;02;06;138;Chamblac;396;10;406;27138
28;27;02;06;139;Chambord;172;6;178;27139
28;27;01;16;140;Chambray;412;11;423;27140
28;27;03;08;141;Champ-Dolent;63;0;63;27141
28;27;01;12;142;Champenard;281;7;288;27142
28;27;03;20;144;Champigny-la-Futelaye;278;5;283;27144
28;27;02;03;146;La Chapelle-Bayvel;375;5;380;27146
28;27;03;10;147;La Chapelle-du-Bois-des-Faulx;688;11;699;27147
28;27;02;06;148;La Chapelle-Gauthier;408;10;418;27148
28;27;02;03;149;La Chapelle-Hareng;113;3;116;27149
28;27;01;19;151;Charleval;1734;22;1756;27151
28;27;01;01;152;Château-sur-Epte;556;9;565;27152
28;27;01;13;153;Chauvincourt-Provemont;367;6;373;27153
28;27;03;20;154;Chavigny-Bailleul;598;16;614;27154
28;27;02;22;155;Chennebrun;107;2;109;27155
28;27;02;06;156;Chéronvilliers;472;17;489;27156
28;27;02;06;157;Marbois;1326;20;1346;27157
28;27;03;11;158;Cierrey;768;28;796;27158
28;27;03;08;161;Claville;1083;21;1104;27161
28;27;03;08;162;Collandres-Quincarnon;243;5;248;27162
28;27;02;17;163;Colletot;207;1;208;27163
28;27;02;07;164;Combon;819;8;827;27164
28;27;03;08;165;Conches-en-Ouche;4995;65;5060;27165
28;27;02;17;167;Condé-sur-Risle;657;6;663;27167
28;27;01;21;168;Connelles;180;7;187;27168
28;27;02;03;169;Conteville;1010;12;1022;27169
28;27;02;03;170;Cormeilles;1193;21;1214;27170
28;27;01;16;171;Le Cormier;385;10;395;27171
28;27;02;02;173;Corneville-la-Fouquetière;122;3;125;27173
28;27;02;17;174;Corneville-sur-Risle;1370;26;1396;27174
28;27;01;13;176;Coudray;218;5;223;27176
28;27;03;20;177;Coudres;549;13;562;27177
28;27;02;02;179;Courbépine;716;16;732;27179
28;27;01;12;180;Courcelles-sur-Seine;2098;38;2136;27180
28;27;03;22;181;Courdemanche;603;12;615;27181
28;27;02;22;182;Courteilles;157;3;160;27182
28;27;03;20;183;La Couture-Boussey;2308;43;2351;27183
28;27;01;18;184;Crasville;124;3;127;27184
28;27;02;15;185;Crestot;594;6;600;27185
28;27;02;15;187;Criquebeuf-la-Campagne;330;6;336;27187
28;27;01;18;188;Criquebeuf-sur-Seine;1489;14;1503;27188
28;27;03;08;189;La Croisille;432;7;439;27189
28;27;01;16;190;Croisy-sur-Eure;207;4;211;27190
28;27;01;12;191;Clef Vallée d'Eure;2500;64;2564;27191
28;27;02;15;192;Crosville-la-Vieille;608;11;619;27192
28;27;03;20;193;Croth;1377;16;1393;27193
28;27;01;01;194;Cuverville;250;2;252;27194
28;27;01;18;196;Les Damps;1371;8;1379;27196
28;27;02;88;198;Mesnils-sur-Iton;6126;254;6380;27198
28;27;01;13;199;Dangu;571;12;583;27199
28;27;03;10;200;Dardez;149;7;156;27200
28;27;02;15;201;Daubeuf-la-Campagne;235;6;241;27201
28;27;01;01;202;Daubeuf-près-Vatteville;464;8;472;27202
28;27;01;16;203;Douains;478;17;495;27203
28;27;01;13;204;Doudeauville-en-Vexin;284;7;291;27204
28;27;01;19;205;Douville-sur-Andelle;452;4;456;27205
28;27;03;22;206;Droisy;451;3;454;27206
28;27;02;03;207;Drucourt;591;7;598;27207
28;27;02;03;208;Duranville;151;2;153;27208
28;27;02;17;209;Ecaquelon;601;11;612;27209
28;27;02;07;210;Ecardenville-la-Campagne;474;12;486;27210
28;27;02;15;212;Ecauville;109;2;111;27212
28;27;01;01;213;Vexin-sur-Epte;5952;136;6088;27213
28;27;01;01;214;Ecouis;816;14;830;27214
28;27;02;15;215;Ecquetot;391;10;401;27215
28;27;03;10;216;Emalleville;493;25;518;27216
28;27;02;15;217;Emanville;556;9;565;27217
28;27;02;03;218;Epaignes;1580;23;1603;27218
28;27;02;15;219;Epégard;549;7;556;27219
28;27;03;20;220;Epieds;349;8;357;27220
28;27;02;03;222;Epreville-en-Lieuvin;198;4;202;27222
28;27;02;15;224;Epreville-près-le-Neubourg;460;10;470;27224
28;27;01;13;226;Etrépagny;3730;82;3812;27226
28;27;02;04;227;Etréville;665;11;676;27227
28;27;02;04;228;Eturqueraye;300;3;303;27228
28;27;03;99;229;Evreux;46349;1225;47574;27229
28;27;03;20;230;Ezy-sur-Eure;3702;55;3757;27230
28;27;01;16;231;Fains;447;7;454;27231
28;27;01;13;232;Farceaux;344;7;351;27232
28;27;02;03;233;Fatouville-Grestain;727;11;738;27233
28;27;03;11;234;Fauville;348;6;354;27234
28;27;03;08;235;Faverolles-la-Campagne;171;3;174;27235
28;27;02;03;237;Le Favril;166;2;168;27237
28;27;03;08;238;Ferrières-Haut-Clocher;1162;29;1191;27238
28;27;02;06;239;Ferrières-Saint-Hilaire;419;7;426;27239
28;27;03;08;240;La Ferrière-sur-Risle;221;4;225;27240
28;27;02;15;241;Feuguerolles;175;5;180;27241
28;27;03;08;242;Le Fidelaire;1017;14;1031;27242
28;27;02;03;243;Fiquefleur-Equainville;739;10;749;27243
28;27;01;19;245;Fleury-la-Forêt;259;8;267;27245
28;27;01;19;246;Fleury-sur-Andelle;1834;19;1853;27246
28;27;01;19;247;Flipou;324;3;327;27247
28;27;02;03;248;Folleville;197;3;200;27248
28;27;01;12;249;Fontaine-Bellenger;1155;21;1176;27249
28;27;02;02;251;Fontaine-l'Abbé;549;8;557;27251
28;27;02;03;252;Fontaine-la-Louvet;328;7;335;27252
28;27;01;16;254;Fontaine-sous-Jouy;846;23;869;27254
28;27;03;20;256;La Forêt-du-Parc;624;9;633;27256
28;27;02;03;258;Fort-Moville;522;7;529;27258
28;27;03;20;259;Foucrainville;90;4;94;27259
28;27;02;03;260;Foulbec;663;8;671;27260
28;27;02;05;261;Fouqueville;448;12;460;27261
28;27;02;17;263;Le Perrey;1244;13;1257;27263
28;27;02;07;266;Franqueville;317;2;319;27266
28;27;02;17;267;Freneuse-sur-Risle;350;4;354;27267
28;27;02;03;269;Fresne-Cauverville;194;3;197;27269
28;27;03;20;271;Fresney;329;13;342;27271
28;27;01;16;273;Gadencourt;381;7;388;27273
28;27;01;12;275;Gaillon;6860;98;6958;27275
28;27;01;13;276;Gamaches-en-Vexin;285;8;293;27276
28;27;03;20;277;La Baronnie;737;15;752;27277
28;27;03;20;278;Garennes-sur-Eure;1945;38;1983;27278
28;27;01;23;279;Gasny;3058;52;3110;27279
28;27;03;11;280;Gauciel;837;7;844;27280
28;27;03;08;281;Gaudreville-la-Rivière;226;8;234;27281
28;27;03;08;282;Gauville-la-Campagne;606;13;619;27282
28;27;01;13;284;Gisors;11696;166;11862;27284
28;27;01;23;285;Giverny;494;13;507;27285
28;27;02;03;286;Giverville;409;5;414;27286
28;27;03;08;287;Glisolles;865;17;882;27287
28;27;02;17;288;Glos-sur-Risle;599;14;613;27288
28;27;02;06;289;La Goulafrière;168;3;171;27289
28;27;02;07;290;Goupil-Othon;1256;16;1272;27290
28;27;02;22;291;Gournay-le-Guérin;126;11;137;27291
28;27;01;19;294;Val d'Orger;991;16;1007;27294
28;27;02;06;295;Grand-Camp;478;15;493;27295
28;27;02;15;298;Graveron-Sémerville;315;6;321;27298
28;27;03;10;299;Gravigny;3994;81;4075;27299
28;27;02;07;300;Grosley-sur-Risle;527;4;531;27300
28;27;03;20;301;GrossÅ“uvre;1334;28;1362;27301
28;27;02;15;302;Le Bosc du Theil;1305;13;1318;27302
28;27;01;13;304;Guerny;166;4;170;27304
28;27;03;11;306;Guichainville;2954;60;3014;27306
28;27;01;01;307;Guiseniers;466;7;473;27307
28;27;03;20;309;L'Habit;504;7;511;27309
28;27;01;13;310;Hacqueville;426;8;434;27310
28;27;02;07;311;Harcourt;1086;5;1091;27311
28;27;01;16;312;Hardencourt-Cocherel;273;13;286;27312
28;27;02;05;313;La Harengère;609;5;614;27313
28;27;01;01;315;Harquency;269;8;277;27315
28;27;02;04;316;Hauville;1278;27;1305;27316
28;27;02;04;317;La Haye-Aubrée;458;10;468;27317
28;27;02;07;318;La Haye-de-Calleville;259;3;262;27318
28;27;02;04;319;La Haye-de-Routot;307;5;312;27319
28;27;02;05;320;La Haye-du-Theil;304;0;304;27320
28;27;01;18;321;La Haye-le-Comte;134;5;139;27321
28;27;01;18;322;La Haye-Malherbe;1392;19;1411;27322
28;27;02;06;323;La Haye-Saint-Sylvestre;281;3;284;27323
28;27;01;13;324;Hébécourt;617;14;631;27324
28;27;02;07;325;Hecmanville;187;3;190;27325
28;27;01;16;326;Hécourt;318;13;331;27326
28;27;02;15;327;Hectomare;212;8;220;27327
28;27;01;01;329;Hennezis;771;22;793;27329
28;27;01;21;330;Herqueville;133;4;137;27330
28;27;01;01;331;Heubécourt-Haricourt;456;10;466;27331
28;27;01;14;332;Heudebouville;782;12;794;27332
28;27;01;13;333;Heudicourt;718;7;725;27333
28;27;02;03;334;Heudreville-en-Lieuvin;109;1;110;27334
28;27;01;12;335;Heudreville-sur-Eure;1077;32;1109;27335
28;27;01;16;336;La Heunière;431;4;435;27336
28;27;01;01;337;Heuqueville;356;6;362;27337
28;27;01;19;338;Les Hogues;674;8;682;27338
28;27;02;15;339;Hondouville;790;15;805;27339
28;27;02;04;340;Honguemare-Guenouville;710;8;718;27340
28;27;02;22;341;L'Hosmes;67;3;70;27341
28;27;02;15;342;Houetteville;202;6;208;27342
28;27;01;16;343;Houlbec-Cocherel;1280;55;1335;27343
28;27;02;07;345;La Houssaye;209;2;211;27345
28;27;01;19;346;Houville-en-Vexin;234;4;238;27346
28;27;03;11;347;Huest;785;26;811;27347
28;27;01;18;348;Igoville;1756;20;1776;27348
28;27;02;17;349;Illeville-sur-Montfort;867;13;880;27349
28;27;03;22;350;Illiers-l'Evêque;999;17;1016;27350
28;27;01;14;351;Incarville;1423;24;1447;27351
28;27;03;10;353;Irreville;470;8;478;27353
28;27;02;15;354;Iville;426;4;430;27354
28;27;03;20;355;Ivry-la-Bataille;2665;30;2695;27355
28;27;01;16;358;Jouy-sur-Eure;591;13;604;27358
28;27;02;06;359;Juignettes;226;1;227;27359
28;27;03;20;360;Jumelles;329;7;336;27360
28;27;02;03;361;La Lande-Saint-Léger;386;5;391;27361
28;27;02;04;363;Le Landin;221;7;228;27363
28;27;02;07;364;Launay;195;3;198;27364
28;27;01;21;365;Léry;2028;38;2066;27365
28;27;01;19;366;Letteguives;207;3;210;27366
28;27;02;03;367;Lieurey;1487;15;1502;27367
28;27;03;20;368;Lignerolles;335;9;344;27368
28;27;01;19;369;Lilly;79;2;81;27369
28;27;01;19;370;Lisors;329;9;338;27370
28;27;02;07;371;Livet-sur-Authou;159;1;160;27371
28;27;01;13;372;Longchamps;682;5;687;27372
28;27;01;19;373;Lorleau;118;2;120;27373
28;27;03;08;374;Louversey;530;14;544;27374
28;27;01;14;375;Louviers;18518;403;18921;27375
28;27;03;20;376;Louye;223;5;228;27376
28;27;01;19;377;Lyons-la-Forêt;712;6;718;27377
28;27;03;22;378;La Madeleine-de-Nonancourt;1143;24;1167;27378
28;27;01;19;379;Mainneville;444;8;452;27379
28;27;02;07;380;Malleville-sur-le-Bec;265;4;269;27380
28;27;02;02;381;Malouy;162;0;162;27381
28;27;02;15;382;Mandeville;319;9;328;27382
28;27;02;22;383;Mandres;376;11;387;27383
28;27;02;03;384;Manneville-la-Raoult;498;11;509;27384
28;27;02;17;385;Manneville-sur-Risle;1497;41;1538;27385
28;27;01;18;386;Le Manoir;1329;7;1336;27386
28;27;02;04;388;Marais-Vernier;487;9;496;27388
28;27;02;15;389;Marbeuf;462;17;479;27389
28;27;03;22;390;Marcilly-la-Campagne;1121;16;1137;27390
28;27;03;20;391;Marcilly-sur-Eure;1599;21;1620;27391
28;27;01;19;392;Martagny;150;4;154;27392
28;27;02;03;393;Martainville;503;2;505;27393
28;27;01;18;394;Martot;492;11;503;27394
28;27;02;06;395;Mélicourt;88;1;89;27395
28;27;01;19;396;Ménesqueville;467;9;476;27396
28;27;01;16;397;Ménilles;1737;42;1779;27397
28;27;02;02;398;Menneval;1476;105;1581;27398
28;27;01;16;399;Mercey;52;1;53;27399
28;27;01;16;400;Merey;342;4;346;27400
28;27;03;15;401;Le Mesnil-Fuguet;177;3;180;27401
28;27;01;18;403;Le Mesnil-Jourdain;236;12;248;27403
28;27;02;06;404;Mesnil-Rousset;91;1;92;27404
28;27;01;19;405;Mesnil-sous-Vienne;102;5;107;27405
28;27;03;20;406;Mesnil-sur-l'Estrée;889;24;913;27406
28;27;01;01;407;Mesnil-Verclives;325;9;334;27407
28;27;01;01;408;Mézières-en-Vexin;603;19;622;27408
28;27;03;11;410;Miserey;643;7;650;27410
28;27;03;22;411;Moisville;232;2;234;27411
28;27;01;18;412;Terres de Bord;1491;35;1526;27412
28;27;02;17;413;Montfort-sur-Risle;777;12;789;27413
28;27;02;06;414;Montreuil-l'Argillé;843;10;853;27414
28;27;02;03;415;Morainville-Jouveaux;369;7;376;27415
28;27;01;13;417;Morgny;669;12;681;27417
28;27;02;07;418;Morsan;105;0;105;27418
28;27;03;20;419;Mouettes;760;17;777;27419
28;27;01;13;420;Mouflaines;164;7;171;27420
28;27;03;20;421;Mousseaux-Neuville;640;13;653;27421
28;27;01;01;422;Muids;876;22;898;27422
28;27;03;20;423;Muzy;772;18;790;27423
28;27;03;08;424;Nagel-Séez-Mesnil;326;8;334;27424
28;27;02;07;425;Nassandres sur Risle;2406;46;2452;27425
28;27;01;13;426;Neaufles-Saint-Martin;1318;7;1325;27426
28;27;02;06;427;Neaufles-Auvergny;420;8;428;27427
28;27;02;15;428;Le Neubourg;4241;221;4462;27428
28;27;01;16;429;Neuilly;183;0;183;27429
28;27;01;13;430;La Neuve-Grange;343;3;346;27430
28;27;02;06;431;La Neuve-Lyre;578;6;584;27431
28;27;02;07;432;La Neuville-du-Bosc;697;7;704;27432
28;27;02;07;433;Neuville-sur-Authou;191;2;193;27433
28;27;02;03;434;Noards;55;0;55;27434
28;27;02;03;435;La NoÃ«-Poulain;285;3;288;27435
28;27;03;08;436;Nogent-le-Sec;440;6;446;27436
28;27;01;13;437;Nojeon-en-Vexin;340;6;346;27437
28;27;03;22;438;Nonancourt;2275;40;2315;27438
28;27;03;10;439;Normanville;1133;37;1170;27439
28;27;01;01;440;Notre-Dame-de-l'Isle;659;22;681;27440
28;27;02;07;441;Notre-Dame-d'Epine;74;1;75;27441
28;27;02;06;442;Notre-Dame-du-Hamel;198;7;205;27442
28;27;02;02;444;Le Noyer-en-Ouche;230;2;232;27444
28;27;01;13;445;Noyers;253;4;257;27445
28;27;03;08;446;Ormes;479;3;482;27446
28;27;03;08;447;Le Val-Doré;898;56;954;27447
28;27;01;16;448;Pacy-sur-Eure;5056;127;5183;27448
28;27;03;08;451;Parville;292;6;298;27451
28;27;01;19;453;Perriers-sur-Andelle;1802;20;1822;27453
28;27;01;19;454;Perruel;465;7;472;27454
28;27;02;03;455;Piencourt;165;3;168;27455
28;27;01;18;456;Pinterville;760;18;778;27456
28;27;02;22;457;Piseux;696;12;708;27457
28;27;01;18;458;Pîtres;2648;27;2675;27458
28;27;02;03;459;Les Places;73;2;75;27459
28;27;02;02;460;Plainville;205;5;210;27460
28;27;02;03;462;Le Planquay;161;1;162;27462
28;27;02;02;463;Plasnes;721;8;729;27463
28;27;03;11;464;Le Plessis-Grohan;911;19;930;27464
28;27;01;16;465;Le Plessis-Hébert;402;13;415;27465
28;27;02;07;466;Le Plessis-Sainte-Opportune;336;5;341;27466
28;27;02;17;467;Pont-Audemer;9982;272;10254;27467
28;27;02;17;468;Pont-Authou;602;8;610;27468
28;27;01;18;469;Pont-de-l'Arche;4146;58;4204;27469
28;27;01;19;470;Pont-Saint-Pierre;1134;22;1156;27470
28;27;01;21;471;Porte-de-Seine;205;7;212;27471
28;27;03;08;472;Portes;276;3;279;27472
28;27;01;01;473;Port-Mort;909;26;935;27473
28;27;01;21;474;Poses;1158;22;1180;27474
28;27;02;03;475;La Poterie-Mathieu;164;1;165;27475
28;27;02;17;476;Les Préaux;388;8;396;27476
28;27;01;01;477;Pressagny-l'Orgueilleux;697;26;723;27477
28;27;03;20;478;Prey;949;25;974;27478
28;27;01;13;480;Puchay;652;7;659;27480
28;27;02;22;481;Pullay;403;54;457;27481
28;27;02;15;482;La Pyle;169;4;173;27482
28;27;01;18;483;Quatremare;435;6;441;27483
28;27;02;04;485;Quillebeuf-sur-Seine;833;8;841;27485
28;27;02;15;486;Quittebeuf;654;18;672;27486
28;27;01;19;487;Radepont;662;2;664;27487
28;27;01;19;488;Renneville;194;4;198;27488
28;27;03;10;489;Reuilly;521;13;534;27489
28;27;01;13;490;Richeville;267;4;271;27490
28;27;02;07;492;Romilly-la-Puthenaye;317;10;327;27492
28;27;01;19;493;Romilly-sur-Andelle;3288;52;3340;27493
28;27;01;01;495;La Roquette;237;2;239;27495
28;27;01;19;496;Rosay-sur-Lieure;516;6;522;27496
28;27;02;04;497;Rougemontiers;1045;17;1062;27497
28;27;02;07;498;Rouge-Perriers;367;4;371;27498
28;27;02;04;500;Routot;1679;56;1735;27500
28;27;01;16;501;Rouvray;259;6;265;27501
28;27;02;06;502;Rugles;2214;28;2242;27502
28;27;03;15;504;Sacquenville;1288;38;1326;27504
28;27;02;06;505;Saint-Agnan-de-Cernières;165;1;166;27505
28;27;03;20;507;Saint-André-de-l'Eure;4031;66;4097;27507
28;27;02;06;508;Saint-Antonin-de-Sommaire;198;2;200;27508
28;27;02;15;511;Saint-Aubin-d'Ecrosville;721;11;732;27511
28;27;02;03;512;Saint-Aubin-de-Scellon;336;7;343;27512
28;27;02;06;514;Saint-Aubin-du-Thenney;380;2;382;27514
28;27;02;02;516;Treis-Sants-en-Ouche;1412;34;1446;27516
28;27;01;12;517;Saint-Aubin-sur-Gaillon;2093;47;2140;27517
28;27;02;04;518;Saint-Aubin-sur-Quillebeuf;749;13;762;27518
28;27;02;03;520;Saint-Benoît-des-Ombres;142;1;143;27520
28;27;02;22;521;Saint-Christophe-sur-Avre;138;6;144;27521
28;27;02;03;522;Saint-Christophe-sur-Condé;436;4;440;27522
28;27;02;15;524;Sainte-Colombe-la-Commanderie;868;6;874;27524
28;27;01;16;525;Sainte-Colombe-près-Vernon;298;18;316;27525
28;27;02;07;527;Saint-Cyr-de-Salerne;205;7;212;27527
28;27;01;21;528;Le Vaudreuil;3681;82;3763;27528
28;27;02;05;529;Saint-Cyr-la-Campagne;435;9;444;27529
28;27;02;06;530;Saint-Denis-d'Augerons;82;3;85;27530
28;27;02;05;531;Saint-Denis-des-Monts;206;4;210;27531
28;27;01;13;533;Saint-Denis-le-Ferment;494;20;514;27533
28;27;02;05;534;Saint-Didier-des-Bois;886;10;896;27534
28;27;03;08;535;Saint-Elier;438;9;447;27535
28;27;02;07;536;Saint-Eloi-de-Fourques;538;15;553;27536
28;27;01;14;537;Saint-Etienne-du-Vauvray;876;14;890;27537
28;27;02;03;538;Saint-Etienne-l'Allier;547;9;556;27538
28;27;01;12;539;Saint-Etienne-sous-Bailleul;385;13;398;27539
28;27;01;23;540;Sainte-Geneviève-lès-Gasny;670;15;685;27540
28;27;02;03;541;Le Mesnil-Saint-Jean;220;6;226;27541
28;27;02;03;542;Saint-Georges-du-Vièvre;887;15;902;27542
28;27;03;20;543;Saint-Georges-Motel;887;11;898;27543
28;27;03;20;544;Saint-Germain-de-Fresney;204;5;209;27544
28;27;02;05;545;Saint-Germain-de-Pasquier;123;5;128;27545
28;27;03;10;546;Saint-Germain-des-Angles;168;2;170;27546
28;27;02;03;547;Saint-Germain-la-Campagne;871;21;892;27547
28;27;03;22;548;Saint-Germain-sur-Avre;1174;25;1199;27548
28;27;02;03;550;Saint-Grégoire-du-Vièvre;307;7;314;27550
28;27;02;06;552;Saint-Jean-du-Thenney;249;5;254;27552
28;27;01;12;553;Saint-Julien-de-la-Liègue;422;2;424;27553
28;27;01;16;554;La Chapelle-Longueville;3338;105;3443;27554
28;27;03;20;555;Saint-Laurent-des-Bois;246;5;251;27555
28;27;02;06;556;Saint-Laurent-du-Tencement;65;0;65;27556
28;27;02;02;557;Saint-Léger-de-Rôtes;464;6;470;27557
28;27;02;05;558;Saint-Léger-du-Gennetey;179;6;185;27558
28;27;03;11;560;Saint-Luc;251;12;263;27560
28;27;02;03;561;Saint-Maclou;652;11;663;27561
28;27;01;16;562;Saint-Marcel;4425;136;4561;27562
28;27;02;17;563;Saint-Mards-de-Blacarville;825;23;848;27563
28;27;02;03;564;Saint-Mards-de-Fresne;333;6;339;27564
28;27;02;06;565;Le Lesme;681;9;690;27565
28;27;01;13;567;Sainte-Marie-de-Vatimesnil;280;6;286;27567
28;27;03;08;568;Sainte-Marthe;495;8;503;27568
28;27;02;02;569;Saint-Martin-du-Tilleul;245;10;255;27569
28;27;03;15;570;Saint-Martin-la-Campagne;100;2;102;27570
28;27;02;03;571;Saint-Martin-Saint-Firmin;336;10;346;27571
28;27;02;15;572;Saint-Meslin-du-Bosc;289;4;293;27572
28;27;02;07;576;Sainte-Opportune-du-Bosc;650;15;665;27576
28;27;02;04;577;Sainte-Opportune-la-Mare;435;11;446;27577
28;27;02;06;578;Sainte-Marie-d'Attez;596;16;612;27578
28;27;02;05;579;Saint-Ouen-de-Pontcheuil;99;2;101;27579
28;27;02;04;580;Saint-Ouen-de-Thouberville;2426;31;2457;27580
28;27;02;05;582;Saint-Ouen-du-Tilleul;1696;16;1712;27582
28;27;02;07;584;Saint-Paul-de-Fourques;282;9;291;27584
28;27;02;05;586;Saint-Philbert-sur-Boissey;173;1;174;27586
28;27;02;17;587;Saint-Philbert-sur-Risle;789;6;795;27587
28;27;01;12;589;Saint-Pierre-de-Bailleul;968;32;1000;27589
28;27;02;06;590;Saint-Pierre-de-Cernières;236;3;239;27590
28;27;02;03;591;Saint-Pierre-de-Cormeilles;595;12;607;27591
28;27;02;07;592;Saint-Pierre-de-Salerne;246;3;249;27592
28;27;02;05;593;Saint-Pierre-des-Fleurs;1614;22;1636;27593
28;27;02;03;594;Saint-Pierre-des-Ifs;276;1;277;27594
28;27;02;05;595;Saint-Pierre-du-Bosguérard;1012;13;1025;27595
28;27;02;03;597;Saint-Pierre-du-Val;585;1;586;27597
28;27;01;14;598;Saint-Pierre-du-Vauvray;1249;26;1275;27598
28;27;01;12;599;Saint-Pierre-la-Garenne;911;10;921;27599
28;27;02;04;601;Saint-Samson-de-la-Roque;433;10;443;27601
28;27;03;09;602;Saint-Sébastien-de-Morsent;5594;169;5763;27602
28;27;02;03;603;Saint-Siméon;313;6;319;27603
28;27;02;03;604;Saint-Sulpice-de-Grimbouville;157;2;159;27604
28;27;02;03;605;Saint-Sylvestre-de-Cormeilles;237;5;242;27605
28;27;02;17;606;Saint-Symphorien;488;1;489;27606
28;27;02;02;608;Saint-Victor-de-Chrétienville;446;9;455;27608
28;27;02;07;609;Saint-Victor-d'Epine;333;6;339;27609
28;27;02;22;610;Saint-Victor-sur-Avre;56;1;57;27610
28;27;03;10;611;Saint-Vigor;321;10;331;27611
28;27;01;16;612;Saint-Vincent-des-Bois;333;6;339;27612
28;27;02;03;613;Saint-Vincent-du-Boulay;379;4;383;27613
28;27;01;13;614;Sancourt;167;2;169;27614
28;27;03;11;615;Sassey;192;3;195;27615
28;27;02;05;616;La Saussaye;1890;52;1942;27616
28;27;01;13;617;Saussay-la-Campagne;530;9;539;27617
28;27;03;08;618;Sébécourt;470;11;481;27618
28;27;02;17;620;Selles;465;2;467;27620
28;27;03;20;621;Serez;170;5;175;27621
28;27;02;02;622;Serquigny;1852;55;1907;27622
28;27;01;18;623;Surtauville;492;9;501;27623
28;27;01;18;624;Surville;883;24;907;27624
28;27;01;01;625;Suzay;359;2;361;27625
28;27;02;03;627;Le Theil-Nolent;245;12;257;27627
28;27;02;03;629;Thiberville;1789;16;1805;27629
28;27;02;07;630;Thibouville;318;40;358;27630
28;27;02;17;631;Thierville;372;4;376;27631
28;27;01;13;632;Le Thil;579;8;587;27632
28;27;01;13;633;Les Thilliers-en-Vexin;495;4;499;27633
28;27;01;01;635;Le Thuit;141;1;142;27635
28;27;02;05;638;Le Thuit de l'Oison;3700;52;3752;27638
28;27;03;08;640;Tilleul-Dame-Agnès;192;4;196;27640
28;27;02;15;641;Le Tilleul-Lambert;260;5;265;27641
28;27;02;22;643;Tillières-sur-Avre;1069;23;1092;27643
28;27;01;01;644;Tilly;558;41;599;27644
28;27;02;04;645;Tocqueville;155;4;159;27645
28;27;02;03;646;Le Torpt;446;5;451;27646
28;27;01;19;649;Touffreville;353;7;360;27649
28;27;02;15;650;Tournedos-Bois-Hubert;468;8;476;27650
28;27;03;15;652;Tourneville;310;8;318;27652
28;27;02;05;654;Tourville-la-Campagne;1121;12;1133;27654
28;27;02;17;655;Tourville-sur-Pont-Audemer;730;160;890;27655
28;27;02;17;656;Toutainville;1311;31;1342;27656
28;27;02;15;658;Le Tremblay-Omonville;362;6;368;27658
28;27;03;11;659;La Trinité;123;6;129;27659
28;27;02;06;660;La Trinité-de-Réville;237;2;239;27660
28;27;02;04;661;La Trinité-de-Thouberville;425;9;434;27661
28;27;02;17;662;Triqueville;330;11;341;27662
28;27;02;15;663;Le Troncq;167;4;171;27663
28;27;01;19;664;Le Tronquay;513;7;520;27664
28;27;02;04;665;Trouville-la-Haule;762;13;775;27665
28;27;01;18;666;La Vacherie;565;19;584;27666
28;27;02;02;667;Valailles;384;9;393;27667
28;27;03;11;668;Le Val-David;701;11;712;27668
28;27;02;04;669;Valletot;441;6;447;27669
28;27;01;19;670;Vandrimare;961;18;979;27670
28;27;02;03;671;Vannecrocq;164;7;171;27671
28;27;01;19;672;VascÅ“uil;357;1;358;27672
28;27;01;01;673;Vatteville;178;4;182;27673
28;27;01;16;674;Vaux-sur-Eure;267;7;274;27674
28;27;02;15;677;Venon;413;8;421;27677
28;27;03;08;678;Les Ventes;1040;24;1064;27678
28;27;02;86;679;Verneuil d'Avre et d'Iton;7614;364;7978;27679
28;27;02;06;680;Verneusses;193;6;199;27680
28;27;01;23;681;Vernon;23727;677;24404;27681
28;27;01;13;682;Vesly;657;16;673;27682
28;27;01;01;683;Vézillon;232;3;235;27683
28;27;03;11;684;Le Vieil-Evreux;831;14;845;27684
28;27;02;06;685;La Vieille-Lyre;659;18;677;27685
28;27;02;04;686;Vieux-Port;48;0;48;27686
28;27;01;16;689;Villegats;348;16;364;27689
28;27;01;13;690;Villers-en-Vexin;311;1;312;27690
28;27;01;12;691;Villers-sur-le-Roule;863;19;882;27691
28;27;02;15;692;Villettes;161;6;167;27692
28;27;02;22;693;Sylvains-Lès-Moulins;1296;32;1328;27693
28;27;01;16;694;Villez-sous-Bailleul;314;15;329;27694
28;27;02;15;695;Villez-sur-le-Neubourg;281;6;287;27695
28;27;01;16;696;Villiers-en-DésÅ“uvre;932;17;949;27696
28;27;01;14;697;Vironvay;330;17;347;27697
28;27;02;15;698;Vitot;559;13;572;27698
28;27;02;05;699;Voiscreville;119;3;122;27699
28;27;02;15;700;Vraiville;728;5;733;27700
28;27;01;21;701;Val-de-Reuil;12910;287;13197;27701
24;28;03;01;001;Abondant;2390;56;2446;28001
24;28;03;08;003;Allainville;139;4;143;28003
24;28;01;15;004;Allonnes;316;3;319;28004
24;28;02;07;005;Alluyes;747;90;837;28005
24;28;01;12;006;Amilly;1825;47;1872;28006
24;28;03;01;007;Anet;2697;103;2800;28007
24;28;03;14;008;Ardelles;206;2;208;28008
24;28;01;02;009;Ardelu;72;1;73;28009
24;28;04;13;010;Argenvilliers;325;8;333;28010
24;28;02;03;012;Commune nouvelle d'Arrou;3653;63;3716;28012
24;28;01;02;013;Aunay-sous-Auneau;1549;25;1574;28013
24;28;03;08;014;Aunay-sous-Crécy;668;7;675;28014
24;28;01;02;015;Auneau-Bleury-Saint-Symphorien;6090;87;6177;28015
24;28;04;03;016;Les Autels-Villevillon;131;6;137;28016
24;28;04;03;018;Authon-du-Perche;1501;16;1517;28018
24;28;02;15;019;Baigneaux;208;4;212;28019
24;28;01;11;021;Bailleau-le-Pin;1581;30;1611;28021
24;28;01;06;022;Bailleau-l'Evêque;1139;31;1170;28022
24;28;01;02;023;Bailleau-Armenonville;1376;26;1402;28023
24;28;01;12;024;Barjouville;1722;60;1782;28024
24;28;01;15;025;Barmainville;107;2;109;28025
24;28;01;15;026;Baudreville;246;0;246;28026
24;28;04;03;027;La Bazoche-Gouet;1224;20;1244;28027
24;28;02;15;028;Bazoches-en-Dunois;260;5;265;28028
24;28;02;15;029;Bazoches-les-Hautes;318;7;325;28029
24;28;03;14;030;Beauche;275;8;283;28030
24;28;04;03;031;Beaumont-les-Autels;390;111;501;28031
24;28;01;15;032;Beauvilliers;339;4;343;28032
24;28;04;13;033;Belhomert-Guéhouville;799;32;831;28033
24;28;01;04;034;Berchères-Saint-Germain;888;12;900;28034
24;28;01;05;035;Berchères-les-Pierres;979;23;1002;28035
24;28;03;01;036;Berchères-sur-Vesgre;847;20;867;28036
24;28;03;14;037;Bérou-la-Mulotière;334;5;339;28037
24;28;04;03;038;Béthonvilliers;112;5;117;28038
24;28;01;02;039;Béville-le-Comte;1671;31;1702;28039
24;28;01;11;040;Billancelles;324;9;333;28040
24;28;01;11;041;Blandainville;276;2;278;28041
24;28;03;08;045;Boissy-en-Drouais;224;6;230;28045
24;28;03;14;046;Boissy-lès-Perche;485;9;494;28046
24;28;01;15;047;Boisville-la-Saint-Père;724;15;739;28047
24;28;01;05;048;La Bourdinière-Saint-Loup;742;14;756;28048
24;28;01;15;049;Boncé;244;5;249;28049
24;28;03;01;050;Boncourt;267;6;273;28050
24;28;02;07;051;Bonneval;4846;100;4946;28051
24;28;01;10;052;Bouglainval;752;15;767;28052
24;28;03;14;053;Le Boullay-les-Deux-Eglises;250;3;253;28053
24;28;03;09;054;Le Boullay-Mivoye;504;11;515;28054
24;28;03;09;055;Le Boullay-Thierry;560;9;569;28055
24;28;03;01;056;Boutigny-Prouais;1699;46;1745;28056
24;28;02;15;057;Bouville;592;9;601;28057
24;28;03;09;058;Bréchamps;358;4;362;28058
24;28;03;14;059;Brezolles;1823;28;1851;28059
24;28;01;04;060;Briconville;263;5;268;28060
24;28;02;03;061;Brou;3311;36;3347;28061
24;28;03;01;062;Broué;899;15;914;28062
24;28;03;01;064;Bû;2007;51;2058;28064
24;28;02;15;065;Bullainville;108;5;113;28065
24;28;01;11;067;Cernay;90;2;92;28067
24;28;01;04;068;Challet;433;10;443;28068
24;28;01;04;070;Champhol;3715;109;3824;28070
24;28;04;13;071;Champrond-en-Gâtine;688;3;691;28071
24;28;04;13;072;Champrond-en-Perchet;413;0;413;28072
24;28;01;02;073;Champseru;343;1;344;28073
24;28;01;02;074;La Chapelle-d'Aunainville;256;4;260;28074
24;28;02;07;075;La Chapelle-du-Noyer;1016;181;1197;28075
24;28;03;01;076;La Chapelle-Forainvilliers;194;3;197;28076
24;28;03;14;077;La Chapelle-Fortin;176;3;179;28077
24;28;04;03;078;Chapelle-Guillaume;184;4;188;28078
24;28;04;03;079;Chapelle-Royale;300;4;304;28079
24;28;04;03;080;Charbonnières;254;3;257;28080
24;28;01;11;081;Charonville;306;5;311;28081
24;28;03;09;082;Charpont;634;14;648;28082
24;28;01;10;084;Chartainvilliers;711;9;720;28084
24;28;01;98;085;Chartres;38534;1164;39698;28085
24;28;04;13;086;Chassant;327;8;335;28086
24;28;03;14;087;Châtaincourt;239;4;243;28087
24;28;02;07;088;Châteaudun;13096;336;13432;28088
24;28;03;14;089;Châteauneuf-en-Thymerais;2596;32;2628;28089
24;28;03;14;090;Les Châtelets;104;3;107;28090
24;28;01;11;091;Les Châtelliers-Notre-Dame;145;3;148;28091
24;28;01;02;092;Châtenay;232;6;238;28092
24;28;03;09;094;Chaudon;1670;27;1697;28094
24;28;01;11;095;Chauffours;275;6;281;28095
24;28;03;01;096;La Chaussée-d'Ivry;1226;18;1244;28096
24;28;03;01;098;Cherisy;1841;49;1890;28098
24;28;01;11;099;Chuisnes;1106;22;1128;28099
24;28;01;12;100;Cintray;447;6;453;28100
24;28;01;04;102;Clévilliers;722;9;731;28102
24;28;02;03;103;Cloyes-les-Trois-Rivières;5618;124;5742;28103
24;28;01;04;104;Coltainville;898;28;926;28104
24;28;04;13;105;Combres;555;6;561;28105
24;28;02;07;106;Conie-Molitard;406;11;417;28106
24;28;01;05;107;Corancez;363;9;372;28107
24;28;02;15;108;Cormainville;232;8;240;28108
24;28;04;13;109;Les Corvées-les-Yys;318;5;323;28109
24;28;01;05;110;Le Coudray;4078;118;4196;28110
24;28;04;03;111;Coudray-au-Perche;358;13;371;28111
24;28;03;10;113;Coulombs;1343;32;1375;28113
24;28;02;15;114;Courbehaye;136;0;136;28114
24;28;01;11;116;Courville-sur-Eure;2831;61;2892;28116
24;28;03;08;117;Crécy-Couvé;267;9;276;28117
24;28;03;09;118;Croisilles;427;15;442;28118
24;28;04;13;119;La Croix-du-Perche;153;2;155;28119
24;28;03;14;120;Crucey-Villages;455;2;457;28120
24;28;02;15;121;Dambron;108;0;108;28121
24;28;01;05;122;Dammarie;1504;23;1527;28122
24;28;02;03;123;Dampierre-sous-Brou;451;8;459;28123
24;28;03;14;124;Dampierre-sur-Avre;738;20;758;28124
24;28;02;07;126;Dancy;200;4;204;28126
24;28;02;07;127;Dangeau;1259;27;1286;28127
24;28;01;11;128;Dangers;432;5;437;28128
24;28;01;02;129;Denonville;758;19;777;28129
24;28;03;14;130;Digny;996;13;1009;28130
24;28;02;07;132;Donnemain-Saint-Mamès;659;16;675;28132
24;28;03;99;134;Dreux;30646;519;31165;28134
24;28;01;10;135;Droue-sur-Drouette;1222;57;1279;28135
24;28;03;09;136;Ecluzelles;166;5;171;28136
24;28;01;02;137;Ecrosnes;838;17;855;28137
24;28;01;11;139;Epeautrolles;191;2;193;28139
24;28;01;10;140;Epernon;5634;67;5701;28140
24;28;01;11;141;Ermenonville-la-Grande;317;11;328;28141
24;28;01;11;142;Ermenonville-la-Petite;184;2;186;28142
24;28;03;14;143;Escorpain;245;3;248;28143
24;28;04;03;144;Les Etilleux;212;7;219;28144
24;28;03;10;146;Faverolles;855;12;867;28146
24;28;03;14;147;Favières;600;10;610;28147
24;28;01;11;148;Le Favril;368;11;379;28148
24;28;03;14;149;La Ferté-Vidame;621;18;639;28149
24;28;03;14;151;Fessanvilliers-Mattanvilliers;176;5;181;28151
24;28;02;07;153;Flacey;208;7;215;28153
24;28;01;11;154;Fontaine-la-Guyon;1696;33;1729;28154
24;28;03;14;155;Fontaine-les-Ribouts;205;2;207;28155
24;28;04;13;156;Fontaine-Simon;900;16;916;28156
24;28;02;15;157;Fontenay-sur-Conie;121;4;125;28157
24;28;01;12;158;Fontenay-sur-Eure;1070;27;1097;28158
24;28;03;14;159;La Framboisière;341;4;345;28159
24;28;01;02;160;Francourville;834;8;842;28160
24;28;04;03;161;Frazé;502;7;509;28161
24;28;01;05;162;Fresnay-le-Comte;305;5;310;28162
24;28;01;04;163;Fresnay-le-Gilmert;213;3;216;28163
24;28;01;15;164;Fresnay-l'Evêque;735;10;745;28164
24;28;04;11;166;Friaize;253;2;255;28166
24;28;01;11;167;Fruncé;386;6;392;28167
24;28;01;02;168;Gallardon;3693;57;3750;28168
24;28;01;02;169;Garancières-en-Beauce;223;7;230;28169
24;28;03;08;170;Garancières-en-Drouais;281;6;287;28170
24;28;03;08;171;Garnay;921;22;943;28171
24;28;01;10;172;Gas;797;15;812;28172
24;28;01;04;173;Gasville-Oisème;1494;34;1528;28173
24;28;04;13;175;La Gaudaine;169;4;173;28175
24;28;02;15;176;Le Gault-Saint-Denis;679;13;692;28176
24;28;01;05;177;Gellainville;666;12;678;28177
24;28;03;01;178;Germainville;313;6;319;28178
24;28;03;01;180;Gilles;501;13;514;28180
24;28;02;03;182;Gohory;315;2;317;28182
24;28;01;15;183;Gommerville;690;3;693;28183
24;28;01;15;184;Gouillons;342;4;346;28184
24;28;03;01;185;Goussainville;1302;22;1324;28185
24;28;03;01;187;Guainville;656;13;669;28187
24;28;01;02;188;Le Gué-de-Longroi;947;16;963;28188
24;28;01;15;189;Guilleville;178;4;182;28189
24;28;02;15;190;Guillonville;458;12;470;28190
24;28;01;10;191;Hanches;2682;57;2739;28191
24;28;04;13;192;Happonvilliers;316;3;319;28192
24;28;03;01;193;Havelu;135;3;138;28193
24;28;01;02;194;Houville-la-Branche;411;16;427;28194
24;28;01;10;195;Houx;748;22;770;28195
24;28;01;11;196;Illiers-Combray;3266;50;3316;28196
24;28;01;15;197;Intréville;148;3;151;28197
24;28;02;07;198;Jallans;801;31;832;28198
24;28;01;15;199;Janville-en-Beauce;2571;50;2621;28199
24;28;03;14;200;Jaudrais;422;5;427;28200
24;28;01;04;201;Jouy;1961;41;2002;28201
24;28;03;14;202;Lamblore;325;6;331;28202
24;28;01;11;203;Landelles;638;7;645;28203
24;28;03;14;206;Laons;679;12;691;28206
24;28;01;02;207;Léthuin;230;4;234;28207
24;28;01;02;208;Levainville;382;14;396;28208
24;28;01;06;209;Lèves;5686;160;5846;28209
24;28;01;15;210;Levesville-la-Chenard;220;2;222;28210
24;28;02;07;211;Logron;578;7;585;28211
24;28;02;15;212;Loigny-la-Bataille;196;8;204;28212
24;28;03;10;213;Lormaye;665;10;675;28213
24;28;04;13;214;La Loupe;3329;81;3410;28214
24;28;01;15;215;Louville-la-Chenard;253;6;259;28215
24;28;03;08;216;Louvilliers-en-Drouais;203;1;204;28216
24;28;03;14;217;Louvilliers-lès-Perche;180;2;182;28217
24;28;01;12;218;Lucé;15403;215;15618;28218
24;28;04;03;219;Luigny;389;10;399;28219
24;28;01;12;220;Luisant;6689;320;7009;28220
24;28;02;15;221;Lumeau;140;8;148;28221
24;28;01;11;222;Luplanté;385;6;391;28222
24;28;03;09;223;Luray;1542;22;1564;28223
24;28;01;11;225;Magny;649;11;660;28225
24;28;03;14;226;Maillebois;906;16;922;28226
24;28;01;10;227;Maintenon;4457;82;4539;28227
24;28;01;06;229;Mainvilliers;11127;258;11385;28229
24;28;01;02;230;Maisons;383;7;390;28230
24;28;03;14;231;La Mancelière;178;3;181;28231
24;28;04;13;232;Manou;592;30;622;28232
24;28;02;07;233;Marboué;1152;26;1178;28233
24;28;01;11;234;Marchéville;461;11;472;28234
24;28;03;01;235;Marchezais;369;3;372;28235
24;28;04;13;236;Arcisses;2181;60;2241;28236
24;28;04;13;237;Marolles-les-Buis;207;4;211;28237
24;28;03;08;239;Marville-Moutiers-Brûlé;983;25;1008;28239
24;28;04;13;240;Meaucé;513;8;521;28240
24;28;01;11;242;Méréglise;98;3;101;28242
24;28;01;15;243;Mérouville;214;6;220;28243
24;28;01;11;245;Meslay-le-Grenet;360;9;369;28245
24;28;02;15;246;Meslay-le-Vidame;530;9;539;28246
24;28;03;01;247;Le Mesnil-Simon;568;15;583;28247
24;28;03;14;248;Le Mesnil-Thomas;329;6;335;28248
24;28;01;10;249;Mévoisins;614;18;632;28249
24;28;03;09;251;Mézières-en-Drouais;1061;27;1088;28251
24;28;04;03;252;Miermaigne;189;3;192;28252
24;28;01;05;253;Mignières;1067;84;1151;28253
24;28;01;11;254;Mittainvilliers-Vérigny;795;13;808;28254
24;28;01;02;255;Moinville-la-Jeulin;170;0;170;28255
24;28;02;07;256;Moléans;449;14;463;28256
24;28;01;02;257;Mondonville-Saint-Jean;87;2;89;28257
24;28;02;07;259;Montboissier;330;5;335;28259
24;28;02;07;260;Montharville;99;5;104;28260
24;28;04;03;261;Montigny-le-Chartif;599;12;611;28261
24;28;03;14;263;Montigny-sur-Avre;252;7;259;28263
24;28;04;13;264;Montireau;139;5;144;28264
24;28;04;13;265;Montlandon;252;2;254;28265
24;28;03;01;267;Montreuil;508;5;513;28267
24;28;01;02;268;Morainville;17;2;19;28268
24;28;01;05;269;Morancez;1899;41;1940;28269
24;28;02;07;270;Moriers;223;4;227;28270
24;28;03;14;271;Morvilliers;140;4;144;28271
24;28;02;03;272;Mottereau;159;3;162;28272
24;28;04;03;273;Moulhard;139;2;141;28273
24;28;01;15;274;Moutiers;242;6;248;28274
24;28;03;10;275;Néron;659;15;674;28275
24;28;01;15;276;Neuvy-en-Beauce;208;8;216;28276
24;28;02;15;277;Neuvy-en-Dunois;306;13;319;28277
24;28;01;05;278;Nogent-le-Phaye;1480;34;1514;28278
24;28;03;10;279;Nogent-le-Roi;3981;65;4046;28279
24;28;04;13;280;Nogent-le-Rotrou;9491;450;9941;28280
24;28;01;11;281;Nogent-sur-Eure;518;9;527;28281
24;28;04;13;282;Nonvilliers-Grandhoux;431;11;442;28282
24;28;02;15;283;Nottonville;289;5;294;28283
24;28;01;15;284;Oinville-Saint-Liphard;277;9;286;28284
24;28;01;02;285;Oinville-sous-Auneau;349;9;358;28285
24;28;01;11;286;Ollé;622;15;637;28286
24;28;02;15;287;Orgères-en-Beauce;1012;15;1027;28287
24;28;03;09;289;Ormoy;220;6;226;28289
24;28;01;11;290;Orrouer;287;9;296;28290
24;28;01;15;291;Ouarville;526;16;542;28291
24;28;03;09;292;Ouerre;734;16;750;28292
24;28;03;01;293;Oulins;1197;28;1225;28293
24;28;01;02;294;Oysonville;524;13;537;28294
24;28;02;15;296;Péronville;269;4;273;28296
24;28;01;10;298;Pierres;2756;57;2813;28298
24;28;03;10;299;Les Pinthières;171;6;177;28299
24;28;01;15;300;Poinville;154;6;160;28300
24;28;01;04;301;Poisvilliers;444;6;450;28301
24;28;01;11;302;Pontgouin;1099;319;1418;28302
24;28;02;15;303;Poupry;101;3;104;28303
24;28;01;15;304;Prasville;433;6;439;28304
24;28;02;15;305;Pré-Saint-Evroult;299;5;304;28305
24;28;02;15;306;Pré-Saint-Martin;204;6;210;28306
24;28;03;14;308;Prudemanche;259;11;270;28308
24;28;01;05;309;Prunay-le-Gillon;1071;16;1087;28309
24;28;03;14;310;La Puisaye;264;6;270;28310
24;28;03;14;312;Puiseux;130;2;132;28312
24;28;01;15;313;Réclainville;194;1;195;28313
24;28;03;14;314;Les Ressuintes;116;8;124;28314
24;28;03;14;315;Revercourt;22;1;23;28315
24;28;03;14;316;Rohaire;126;3;129;28316
24;28;01;02;317;Roinville;564;5;569;28317
24;28;01;15;319;Rouvray-Saint-Denis;373;13;386;28319
24;28;03;01;321;Rouvres;838;14;852;28321
24;28;03;14;322;Rueil-la-Gadelière;498;9;507;28322
24;28;03;14;323;Saint-Ange-et-Torçay;285;1;286;28323
24;28;01;11;324;Saint-Arnoult-des-Bois;886;23;909;28324
24;28;01;06;325;Saint-Aubin-des-Bois;1055;27;1082;28325
24;28;02;11;326;Saint-Avit-les-Guespières;360;2;362;28326
24;28;04;03;327;Saint-Bomer;189;2;191;28327
24;28;02;07;329;Saint-Christophe;159;2;161;28329
24;28;02;07;330;Villemaury;1375;32;1407;28330
24;28;04;13;331;Saintigny;973;19;992;28331
24;28;03;09;332;Sainte-Gemme-Moronval;1090;21;1111;28332
24;28;01;11;333;Saint-Denis-des-Puits;140;3;143;28333
24;28;02;07;334;Saint-Denis-Lanneray;2195;54;2249;28334
24;28;04;13;335;Saint-Eliph;853;24;877;28335
24;28;01;11;336;Saint-Eman;107;1;108;28336
24;28;01;11;337;Saint-Georges-sur-Eure;2817;67;2884;28337
24;28;01;11;339;Saint-Germain-le-Gaillard;355;11;366;28339
24;28;03;14;341;Saint-Jean-de-Rebervilliers;249;5;254;28341
24;28;04;13;342;Saint-Jean-Pierre-Fixte;263;5;268;28342
24;28;03;10;343;Saint-Laurent-la-Gâtine;444;11;455;28343
24;28;01;02;344;Saint-Léger-des-Aubées;264;10;274;28344
24;28;03;14;346;Saint-Lubin-de-Cravant;57;3;60;28346
24;28;03;01;347;Saint-Lubin-de-la-Haye;933;29;962;28347
24;28;03;14;348;Saint-Lubin-des-Joncherets;4019;71;4090;28348
24;28;03;10;349;Saint-Lucien;257;8;265;28349
24;28;01;11;350;Saint-Luperce;934;21;955;28350
24;28;03;14;351;Saint-Maixme-Hauterive;408;8;416;28351
24;28;01;10;352;Saint-Martin-de-Nigelles;1569;41;1610;28352
24;28;02;07;353;Saint-Maur-sur-le-Loir;403;5;408;28353
24;28;04;13;354;Saint-Maurice-Saint-Germain;419;69;488;28354
24;28;03;01;355;Saint-Ouen-Marchefroy;296;9;305;28355
24;28;01;10;357;Saint-Piat;1059;30;1089;28357
24;28;01;04;358;Saint-Prest;2072;67;2139;28358
24;28;03;14;359;Saint-Rémy-sur-Avre;4041;46;4087;28359
24;28;03;14;360;Saint-Sauveur-Marville;920;17;937;28360
24;28;04;13;362;Saint-Victor-de-Buthon;503;12;515;28362
24;28;01;02;363;Sainville;1024;13;1037;28363
24;28;02;15;364;Sancheville;766;13;779;28364
24;28;01;11;365;Sandarville;409;9;418;28365
24;28;01;02;366;Santeuil;320;3;323;28366
24;28;01;15;367;Santilly;330;6;336;28367
24;28;03;14;368;La Saucelle;197;3;200;28368
24;28;03;08;369;Saulnières;758;10;768;28369
24;28;02;07;370;Saumeray;505;11;516;28370
24;28;03;01;371;Saussay;1101;20;1121;28371
24;28;03;10;372;Senantes;568;12;580;28372
24;28;03;14;373;Senonches;3032;47;3079;28373
24;28;03;14;374;Serazereux;538;3;541;28374
24;28;03;01;375;Serville;369;6;375;28375
24;28;03;01;377;Sorel-Moussel;1761;44;1805;28377
24;28;04;13;378;Souancé-au-Perche;524;11;535;28378
24;28;01;10;379;Soulaires;467;10;477;28379
24;28;01;05;380;Sours;1998;171;2169;28380
24;28;02;15;382;Terminiers;889;15;904;28382
24;28;01;15;383;Theuville;706;6;712;28383
24;28;04;11;385;Le Thieulin;452;34;486;28385
24;28;03;14;386;Thimert-Gâtelles;1245;21;1266;28386
24;28;04;13;387;Thiron-Gardais;982;11;993;28387
24;28;01;05;388;Thivars;1044;32;1076;28388
24;28;02;07;389;Thiville;341;8;349;28389
24;28;02;15;390;Tillay-le-Péneux;312;6;318;28390
24;28;01;15;391;Toury;2595;32;2627;28391
24;28;01;15;392;Trancrainville;164;2;166;28392
24;28;03;14;393;Tremblay-les-Villages;2243;66;2309;28393
24;28;03;08;394;Tréon;1422;28;1450;28394
24;28;04;13;395;Trizay-Coutretot-Saint-Serge;433;14;447;28395
24;28;02;07;396;Trizay-lès-Bonneval;310;4;314;28396
24;28;01;02;397;Umpeau;407;13;420;28397
24;28;02;03;398;Unverre;1167;22;1189;28398
24;28;02;15;400;Varize;194;8;202;28400
24;28;04;13;401;Vaupillon;454;8;462;28401
24;28;01;05;403;Ver-lès-Chartres;770;21;791;28403
24;28;03;08;404;Vernouillet;12472;150;12622;28404
24;28;03;08;405;Vert-en-Drouais;1070;21;1091;28405
24;28;01;15;406;Eole-en-Beauce;1247;19;1266;28406
24;28;04;13;407;Vichères;295;8;303;28407
24;28;01;02;408;Vierville;121;3;124;28408
24;28;02;11;409;Vieuvicq;455;15;470;28409
24;28;02;07;410;Villampuy;303;4;307;28410
24;28;01;15;411;Villars;172;2;174;28411
24;28;01;11;414;Villebon;65;5;70;28414
24;28;03;09;415;Villemeux-sur-Eure;1688;31;1719;28415
24;28;03;10;417;Villiers-le-Morhier;1335;28;1363;28417
24;28;02;07;418;Villiers-Saint-Orien;163;5;168;28418
24;28;02;15;419;Vitray-en-Beauce;344;8;352;28419
24;28;01;02;421;Voise;275;5;280;28421
24;28;01;15;422;Les Villages Vovéens;3914;61;3975;28422
24;28;01;02;423;Yermenonville;598;14;612;28423
24;28;02;03;424;Yèvres;1616;39;1655;28424
24;28;01;02;425;Ymeray;575;11;586;28425
24;28;01;15;426;Ymonville;498;9;507;28426
53;29;02;09;001;Argol;998;19;1017;29001
53;29;04;25;002;Arzano;1376;33;1409;29002
53;29;04;10;003;Audierne;3692;66;3758;29003
53;29;04;16;004;Bannalec;5668;157;5825;29004
53;29;04;25;005;Baye;1239;31;1270;29005
53;29;04;11;006;Bénodet;3616;63;3679;29006
53;29;02;07;007;Berrien;892;31;923;29007
53;29;04;10;008;Beuzec-Cap-Sizun;1000;21;1021;29008
53;29;03;14;010;Bodilis;1645;34;1679;29010
53;29;01;04;011;Bohars;3530;86;3616;29011
53;29;02;07;012;Bolazec;188;2;190;29012
53;29;02;07;013;Botmeur;218;6;224;29013
53;29;03;20;014;Botsorhel;430;9;439;29014
53;29;01;18;015;Bourg-Blanc;3553;63;3616;29015
53;29;02;07;016;Brasparts;1028;11;1039;29016
53;29;01;27;017;Brélès;861;27;888;29017
53;29;02;07;018;Brennilis;438;5;443;29018
53;29;01;98;019;Brest;139926;2629;142555;29019
53;29;04;06;020;Briec;5675;114;5789;29020
53;29;01;15;021;Plounéour-Brignogan-plages;1912;49;1961;29021
53;29;02;09;022;Camaret-sur-Mer;2466;55;2521;29022
53;29;03;17;023;Carantec;3189;103;3292;29023
53;29;02;07;024;Carhaix-Plouguer;7155;613;7768;29024
53;29;02;09;025;Cast;1538;45;1583;29025
53;29;02;09;026;Châteaulin;5164;422;5586;29026
53;29;02;06;027;Châteauneuf-du-Faou;3650;100;3750;29027
53;29;04;10;028;Cléden-Cap-Sizun;921;20;941;29028
53;29;02;07;029;Cléden-Poher;1145;18;1163;29029
53;29;03;26;030;Cléder;3683;115;3798;29030
53;29;04;25;031;Clohars-CarnoÃ«t;4528;114;4642;29031
53;29;04;11;032;Clohars-Fouesnant;2080;50;2130;29032
53;29;02;06;033;Le Cloître-Pleyben;524;10;534;29033
53;29;03;20;034;Le Cloître-Saint-Thégonnec;658;6;664;29034
53;29;01;18;035;Coat-Méal;1114;19;1133;29035
53;29;02;07;036;Collorec;608;7;615;29036
53;29;04;19;037;Combrit;4187;125;4312;29037
53;29;03;14;038;Commana;998;26;1024;29038
53;29;04;08;039;Concarneau;19816;856;20672;29039
53;29;01;27;040;Le Conquet;2750;76;2826;29040
53;29;02;06;041;Coray;1890;31;1921;29041
53;29;02;09;042;Crozon;7386;219;7605;29042
53;29;01;21;043;Daoulas;1817;46;1863;29043
53;29;02;09;044;Dinéault;1967;39;2006;29044
53;29;01;21;045;Dirinon;2215;66;2281;29045
53;29;04;10;046;Douarnenez;14000;365;14365;29046
53;29;01;15;047;Le Drennec;1877;35;1912;29047
53;29;04;06;048;Edern;2251;43;2294;29048
53;29;04;08;049;Elliant;3320;141;3461;29049
53;29;04;11;051;Ergué-Gabéric;8434;203;8637;29051
53;29;02;21;053;Le Faou;1744;41;1785;29053
53;29;02;07;054;La Feuillée;642;15;657;29054
53;29;01;15;055;Le FolgoÃ«t;3215;78;3293;29055
53;29;01;13;056;La Forest-Landerneau;1947;31;1978;29056
53;29;04;11;057;La Forêt-Fouesnant;3438;122;3560;29057
53;29;04;11;058;Fouesnant;9864;484;10348;29058
53;29;03;20;059;Garlan;1050;32;1082;29059
53;29;04;11;060;Gouesnach;2786;79;2865;29060
53;29;01;04;061;Gouesnou;6215;135;6350;29061
53;29;02;06;062;Gouézec;1098;35;1133;29062
53;29;04;10;063;Goulien;433;7;440;29063
53;29;01;15;064;Goulven;447;4;451;29064
53;29;04;19;065;Gourlizon;908;15;923;29065
53;29;04;23;066;Guengat;1828;30;1858;29066
53;29;03;20;067;Guerlesquin;1298;41;1339;29067
53;29;03;14;068;Guiclan;2502;52;2554;29068
53;29;01;04;069;Guilers;8061;160;8221;29069
53;29;04;19;070;Guiler-sur-Goyen;526;10;536;29070
53;29;04;25;071;Guilligomarc'h;783;3;786;29071
53;29;04;22;072;Guilvinec;2681;48;2729;29072
53;29;03;20;073;GuimaÃ«c;939;34;973;29073
53;29;03;14;074;Guimiliau;1008;17;1025;29074
53;29;01;12;075;Guipavas;15050;357;15407;29075
53;29;01;27;076;Milizac-Guipronvel;4550;65;4615;29076
53;29;01;15;077;Guissény;1991;47;2038;29077
53;29;01;21;078;Hanvec;2036;47;2083;29078
53;29;03;17;079;Henvic;1267;43;1310;29079
53;29;01;21;080;Hôpital-Camfrout;2232;69;2301;29080
53;29;02;07;081;Huelgoat;1406;27;1433;29081
53;29;03;26;082;ÃŽle-de-Batz;452;13;465;29082
53;29;04;10;083;ÃŽle-de-Sein;260;2;262;29083
53;29;01;27;084;ÃŽle-Molène;160;6;166;29084
53;29;04;19;085;ÃŽle-Tudy;733;18;751;29085
53;29;01;21;086;Irvillac;1453;22;1475;29086
53;29;04;10;087;Le Juch;725;16;741;29087
53;29;02;07;089;Kergloff;857;23;880;29089
53;29;04;10;090;Kerlaz;782;25;807;29090
53;29;01;15;091;Kerlouan;2097;39;2136;29091
53;29;01;15;093;Kernilis;1422;31;1453;29093
53;29;01;15;094;KernouÃ«s;665;14;679;29094
53;29;01;18;095;Kersaint-Plabennec;1495;26;1521;29095
53;29;03;14;097;Lampaul-Guimiliau;2028;52;2080;29097
53;29;01;27;098;Lampaul-Plouarzel;2145;53;2198;29098
53;29;01;18;099;Lampaul-Ploudalmézeau;821;22;843;29099
53;29;01;15;100;Lanarvily;414;12;426;29100
53;29;01;18;101;Landéda;3576;112;3688;29101
53;29;02;07;102;Landeleau;959;12;971;29102
53;29;01;13;103;Landerneau;15918;614;16532;29103
53;29;02;09;104;Landévennec;345;6;351;29104
53;29;03;14;105;Landivisiau;9151;320;9471;29105
53;29;04;06;106;Landrévarzec;1850;41;1891;29106
53;29;04;06;107;Landudal;884;13;897;29107
53;29;04;19;108;Landudec;1479;40;1519;29108
53;29;01;18;109;Landunvez;1486;36;1522;29109
53;29;04;06;110;Langolen;861;14;875;29110
53;29;03;26;111;Lanhouarneau;1314;25;1339;29111
53;29;01;27;112;Lanildut;957;18;975;29112
53;29;03;20;113;Lanmeur;2362;39;2401;29113
53;29;03;20;114;Lannéanou;351;7;358;29114
53;29;02;06;115;Lannédern;290;4;294;29115
53;29;01;13;116;Lanneuffret;154;2;156;29116
53;29;01;18;117;Lannilis;5672;118;5790;29117
53;29;01;27;119;Lanrivoaré;1460;37;1497;29119
53;29;02;09;120;Lanvéoc;1970;65;2035;29120
53;29;02;06;122;Laz;676;16;692;29122
53;29;02;06;123;Lennon;784;20;804;29123
53;29;01;15;124;Lesneven;7322;229;7551;29124
53;29;02;06;125;Leuhan;826;17;843;29125
53;29;01;15;126;Loc-Brévalaire;207;6;213;29126
53;29;03;14;128;Loc-Eguiner;406;6;412;29128
53;29;01;27;130;Locmaria-Plouzané;5092;131;5223;29130
53;29;03;14;131;Locmélar;474;14;488;29131
53;29;03;17;132;Locquénolé;795;31;826;29132
53;29;03;20;133;Locquirec;1513;43;1556;29133
53;29;04;23;134;Locronan;795;26;821;29134
53;29;04;22;135;Loctudy;4013;107;4120;29135
53;29;04;25;136;Locunolé;1158;23;1181;29136
53;29;01;21;137;Logonna-Daoulas;2133;53;2186;29137
53;29;02;07;139;Lopérec;874;141;1015;29139
53;29;01;21;140;Loperhet;3910;86;3996;29140
53;29;02;07;141;Loqueffret;348;4;352;29141
53;29;02;06;142;Lothey;460;4;464;29142
53;29;04;10;143;Mahalon;968;21;989;29143
53;29;01;21;144;La Martyre;759;9;768;29144
53;29;04;10;145;Confort-Meilars;873;28;901;29145
53;29;04;08;146;Melgven;3408;50;3458;29146
53;29;04;25;147;Mellac;3242;79;3321;29147
53;29;03;26;148;Mespaul;943;30;973;29148
53;29;04;16;150;MoÃ«lan-sur-Mer;6742;133;6875;29150
53;29;03;17;151;Morlaix;14845;457;15302;29151
53;29;02;07;152;Motreff;701;15;716;29152
53;29;04;16;153;Névez;2686;52;2738;29153
53;29;01;27;155;Ouessant;833;19;852;29155
53;29;01;13;156;Pencran;2049;43;2092;29156
53;29;04;22;158;Penmarch;5149;100;5249;29158
53;29;04;19;159;Peumerit;844;17;861;29159
53;29;01;18;160;Plabennec;8515;164;8679;29160
53;29;04;11;161;Pleuven;3188;82;3270;29161
53;29;02;06;162;Pleyben;3640;265;3905;29162
53;29;03;17;163;Pleyber-Christ;3184;77;3261;29163
53;29;04;22;165;Plobannalec-Lesconil;3568;84;3652;29165
53;29;02;09;166;Ploéven;507;19;526;29166
53;29;04;19;167;Plogastel-Saint-Germain;1985;44;2029;29167
53;29;04;10;168;Plogoff;1230;20;1250;29168
53;29;04;23;169;Plogonnec;3178;76;3254;29169
53;29;04;23;170;Plomelin;4191;163;4354;29170
53;29;04;19;171;Plomeur;3828;75;3903;29171
53;29;02;09;172;Plomodiern;2245;68;2313;29172
53;29;04;23;173;Plonéis;2471;55;2526;29173
53;29;04;19;174;Plonéour-Lanvern;6223;187;6410;29174
53;29;02;07;175;Plonévez-du-Faou;2108;51;2159;29175
53;29;02;09;176;Plonévez-Porzay;1784;44;1828;29176
53;29;01;27;177;Plouarzel;3854;91;3945;29177
53;29;01;18;178;Ploudalmézeau;6312;128;6440;29178
53;29;01;15;179;Ploudaniel;3737;117;3854;29179
53;29;01;21;180;Ploudiry;913;22;935;29180
53;29;01;13;181;Plouédern;2944;71;3015;29181
53;29;03;20;182;Plouégat-Guérand;1063;22;1085;29182
53;29;03;20;183;Plouégat-Moysan;714;9;723;29183
53;29;03;26;184;Plouénan;2535;57;2592;29184
53;29;03;26;185;Plouescat;3497;93;3590;29185
53;29;03;20;186;Plouezoc'h;1610;61;1671;29186
53;29;03;14;187;Plougar;791;28;819;29187
53;29;03;20;188;Plougasnou;2737;124;2861;29188
53;29;01;12;189;Plougastel-Daoulas;13161;365;13526;29189
53;29;01;27;190;Plougonvelin;4183;105;4288;29190
53;29;03;20;191;Plougonven;3454;94;3548;29191
53;29;03;26;192;Plougoulm;1761;45;1806;29192
53;29;03;14;193;Plougourvest;1430;29;1459;29193
53;29;01;15;195;Plouguerneau;6640;130;6770;29195
53;29;01;18;196;Plouguin;2166;42;2208;29196
53;29;04;10;197;Plouhinec;3951;109;4060;29197
53;29;01;15;198;Plouider;1838;46;1884;29198
53;29;03;20;199;Plouigneau;5086;171;5257;29199
53;29;01;27;201;Ploumoguer;2119;38;2157;29201
53;29;03;17;202;Plounéour-Ménez;1279;36;1315;29202
53;29;03;14;204;Plounéventer;2084;35;2119;29204
53;29;02;07;205;Plounévézel;1174;26;1200;29205
53;29;03;26;206;Plounévez-Lochrist;2294;96;2390;29206
53;29;03;20;207;Plourin-lès-Morlaix;4517;291;4808;29207
53;29;01;27;208;Plourin;1245;29;1274;29208
53;29;01;18;209;Plouvien;3832;104;3936;29209
53;29;03;14;210;Plouvorn;2862;72;2934;29210
53;29;02;07;211;Plouyé;659;18;677;29211
53;29;01;03;212;Plouzané;13496;245;13741;29212
53;29;03;14;213;Plouzévédé;1760;40;1800;29213
53;29;04;19;214;Plovan;681;26;707;29214
53;29;04;19;215;Plozévet;2948;74;3022;29215
53;29;04;23;216;Pluguffan;4179;103;4282;29216
53;29;04;16;217;Pont-Aven;2821;58;2879;29217
53;29;04;10;218;Pont-Croix;1567;31;1598;29218
53;29;04;22;220;Pont-l'Abbé;8369;395;8764;29220
53;29;01;27;221;Porspoder;1779;53;1832;29221
53;29;02;09;222;Port-Launay;398;7;405;29222
53;29;04;10;224;Pouldergat;1213;26;1239;29224
53;29;04;19;225;Pouldreuzic;2165;45;2210;29225
53;29;04;10;226;Poullan-sur-Mer;1507;96;1603;29226
53;29;02;07;227;Poullaouen;1480;32;1512;29227
53;29;04;10;228;Primelin;657;16;673;29228
53;29;04;09;229;Quéménéven;1114;34;1148;29229
53;29;04;25;230;Querrien;1689;33;1722;29230
53;29;04;99;232;Quimper;63283;2478;65761;29232
53;29;04;25;233;Quimperlé;12220;458;12678;29233
53;29;04;25;234;Rédené;2917;62;2979;29234
53;29;01;12;235;Le Relecq-Kerhuon;11717;234;11951;29235
53;29;04;16;236;Riec-sur-Bélon;4180;118;4298;29236
53;29;01;13;237;La Roche-Maurice;1814;44;1858;29237
53;29;02;09;238;Roscanvel;836;29;865;29238
53;29;03;26;239;Roscoff;3489;85;3574;29239
53;29;02;21;240;RosnoÃ«n;959;26;985;29240
53;29;04;08;241;Rosporden;7614;162;7776;29241
53;29;02;09;243;Saint-Coulitz;456;10;466;29243
53;29;03;14;244;Saint-Derrien;821;13;834;29244
53;29;01;13;245;Saint-Divy;1557;21;1578;29245
53;29;01;21;246;Saint-Eloy;212;5;217;29246
53;29;04;11;247;Saint-Evarzec;3503;113;3616;29247
53;29;01;15;248;Saint-Frégant;846;8;854;29248
53;29;02;06;249;Saint-Goazec;712;10;722;29249
53;29;02;07;250;Saint-Hernin;755;17;772;29250
53;29;03;20;251;Saint-Jean-du-Doigt;655;12;667;29251
53;29;04;19;252;Saint-Jean-Trolimon;933;25;958;29252
53;29;03;17;254;Saint-Martin-des-Champs;4621;146;4767;29254
53;29;01;15;255;Saint-Méen;926;20;946;29255
53;29;02;09;256;Saint-Nic;760;20;780;29256
53;29;01;18;257;Saint-Pabu;2069;62;2131;29257
53;29;03;26;259;Saint-Pol-de-Léon;6709;244;6953;29259
53;29;01;27;260;Saint-Renan;8163;195;8358;29260
53;29;02;07;261;Saint-Rivoal;211;3;214;29261
53;29;03;14;262;Saint-Sauveur;786;10;796;29262
53;29;02;21;263;Saint-Ségal;1117;17;1134;29263
53;29;03;14;264;Saint-Servais;777;11;788;29264
53;29;03;17;265;Sainte-Sève;1044;31;1075;29265
53;29;03;17;266;Saint-Thégonnec Loc-Eguiner;3044;78;3122;29266
53;29;02;06;267;Saint-Thois;720;18;738;29267
53;29;01;13;268;Saint-Thonan;1899;36;1935;29268
53;29;04;25;269;Saint-Thurien;1038;15;1053;29269
53;29;01;21;270;Saint-Urbain;1646;35;1681;29270
53;29;03;14;271;Saint-Vougay;893;32;925;29271
53;29;04;08;272;Saint-Yvi;3249;68;3317;29272
53;29;03;26;273;Santec;2393;77;2470;29273
53;29;04;16;274;ScaÃ«r;5295;111;5406;29274
53;29;02;07;275;Scrignac;736;20;756;29275
53;29;03;26;276;Sibiril;1196;29;1225;29276
53;29;03;14;277;Sizun;2289;78;2367;29277
53;29;02;07;278;Spézet;1758;43;1801;29278
53;29;03;17;279;Taulé;2898;77;2975;29279
53;29;02;09;280;Telgruc-sur-Mer;2098;60;2158;29280
53;29;04;08;281;Tourch;997;27;1024;29281
53;29;01;27;282;Trébabu;360;10;370;29282
53;29;04;22;284;Treffiagat;2406;99;2505;29284
53;29;03;26;285;Tréflaouénan;521;7;528;29285
53;29;01;21;286;Tréflévénez;242;9;251;29286
53;29;03;26;287;Tréflez;973;21;994;29287
53;29;01;15;288;Trégarantec;611;7;618;29288
53;29;02;09;289;Trégarvan;114;6;120;29289
53;29;01;18;290;Tréglonou;684;15;699;29290
53;29;02;06;291;Trégourez;957;18;975;29291
53;29;04;19;292;Tréguennec;316;6;322;29292
53;29;04;16;293;Trégunc;7064;224;7288;29293
53;29;01;21;294;Le Tréhou;648;14;662;29294
53;29;01;13;295;Trémaouézan;532;22;554;29295
53;29;04;19;296;Tréméoc;1347;40;1387;29296
53;29;04;25;297;Tréméven;2321;44;2365;29297
53;29;04;19;298;Tréogat;575;11;586;29298
53;29;01;27;299;Tréouergat;333;3;336;29299
53;29;04;16;300;Le Trévoux;1597;51;1648;29300
53;29;03;14;301;Trézilidé;392;2;394;29301
53;29;02;21;302;Pont-de-Buis-lès-Quimerch;3639;136;3775;29302
94;2A;01;08;001;Afa;3229;57;3286;2A001
94;2A;01;98;004;Ajaccio;71361;867;72228;2A004
94;2A;01;05;006;Alata;3456;69;3525;2A006
94;2A;01;11;008;Albitreccia;1771;26;1797;2A008
94;2A;04;09;011;Altagène;53;2;55;2A011
94;2A;01;10;014;Ambiegna;72;1;73;2A014
94;2A;01;08;017;Appietto;1813;37;1850;2A017
94;2A;04;09;018;Arbellara;160;2;162;2A018
94;2A;01;10;019;Arbori;55;0;55;2A019
94;2A;04;11;021;Argiusta-Moriccio;77;1;78;2A021
94;2A;01;10;022;Arro;80;0;80;2A022
94;2A;04;09;024;Aullène;187;1;188;2A024
94;2A;01;11;026;Azilone-Ampaza;187;3;190;2A026
94;2A;01;10;027;Azzana;54;0;54;2A027
94;2A;01;10;028;Balogna;145;6;151;2A028
94;2A;01;08;031;Bastelica;520;6;526;2A031
94;2A;01;05;032;Bastelicaccia;4124;109;4233;2A032
94;2A;04;09;035;Belvédère-Campomoro;161;2;163;2A035
94;2A;04;09;038;Bilia;50;1;51;2A038
94;2A;01;08;040;Bocognano;374;7;381;2A040
94;2A;04;07;041;Bonifacio;3192;55;3247;2A041
94;2A;01;10;048;Calcatoggio;499;5;504;2A048
94;2A;01;11;056;Campo;105;5;110;2A056
94;2A;01;10;060;Cannelle;71;1;72;2A060
94;2A;04;07;061;Carbini;112;1;113;2A061
94;2A;01;08;062;Carbuccia;381;9;390;2A062
94;2A;01;11;064;Cardo-Torgia;32;2;34;2A064
94;2A;01;10;065;Cargèse;1297;22;1319;2A065
94;2A;04;09;066;Cargiaca;58;0;58;2A066
94;2A;01;10;070;Casaglione;389;6;395;2A070
94;2A;04;11;071;Casalabriva;214;5;219;2A071
94;2A;01;11;085;Cauro;1493;37;1530;2A085
94;2A;01;11;089;Ciamannacce;133;0;133;2A089
94;2A;01;10;090;Coggia;679;18;697;2A090
94;2A;01;11;091;Cognocoli-Monticchi;171;1;172;2A091
94;2A;04;06;092;Conca;1145;20;1165;2A092
94;2A;01;11;094;Corrano;71;2;73;2A094
94;2A;01;11;098;Coti-Chiavari;713;9;722;2A098
94;2A;01;11;099;Cozzano;276;0;276;2A099
94;2A;01;10;100;Cristinacce;68;0;68;2A100
94;2A;01;08;103;Cuttoli-Corticchiato;2017;33;2050;2A103
94;2A;01;11;104;Eccica-Suarella;1295;36;1331;2A104
94;2A;01;10;108;Evisa;214;5;219;2A108
94;2A;04;07;114;Figari;1466;29;1495;2A114
94;2A;04;09;115;Foce;150;7;157;2A115
94;2A;01;11;117;Forciolo;81;0;81;2A117
94;2A;04;09;118;Fozzano;205;5;210;2A118
94;2A;01;11;119;Frasseto;137;3;140;2A119
94;2A;04;09;127;Giuncheto;89;2;91;2A127
94;2A;04;09;128;Granace;94;0;94;2A128
94;2A;04;09;129;Grossa;43;1;44;2A129
94;2A;01;11;130;Grosseto-Prugna;3402;55;3457;2A130
94;2A;01;10;131;Guagno;160;2;162;2A131
94;2A;01;11;132;Guargualé;148;1;149;2A132
94;2A;01;11;133;Guitera-les-Bains;151;3;154;2A133
94;2A;04;06;139;Lecci;1838;31;1869;2A139
94;2A;01;10;141;Letia;127;1;128;2A141
94;2A;04;07;142;Levie;669;13;682;2A142
94;2A;01;10;144;Lopigna;103;3;106;2A144
94;2A;04;09;146;Loreto-di-Tallano;52;1;53;2A146
94;2A;01;10;154;Marignana;107;6;113;2A154
94;2A;04;09;158;Mela;29;1;30;2A158
94;2A;04;11;160;Moca-Croce;257;2;259;2A160
94;2A;04;07;163;Monacia-d'Aullène;549;15;564;2A163
94;2A;01;10;174;Murzo;100;3;103;2A174
94;2A;01;08;181;Ocana;629;17;646;2A181
94;2A;01;11;186;Olivese;221;1;222;2A186
94;2A;04;09;189;Olmeto;1218;30;1248;2A189
94;2A;04;09;191;Olmiccia;121;3;124;2A191
94;2A;01;10;196;Orto;51;1;52;2A196
94;2A;01;10;197;Osani;99;0;99;2A197
94;2A;01;10;198;Ota;539;11;550;2A198
94;2A;01;11;200;Palneca;143;3;146;2A200
94;2A;01;10;203;Partinello;97;0;97;2A203
94;2A;01;10;204;Pastricciola;96;1;97;2A204
94;2A;01;08;209;Peri;2015;33;2048;2A209
94;2A;04;11;211;Petreto-Bicchisano;563;17;580;2A211
94;2A;01;10;212;Piana;468;9;477;2A212
94;2A;04;07;215;Pianottoli-Caldarello;910;7;917;2A215
94;2A;01;11;228;Pietrosella;1859;19;1878;2A228
94;2A;01;11;232;Pila-Canale;280;3;283;2A232
94;2A;01;10;240;Poggiolo;113;0;113;2A240
94;2A;04;99;247;Porto-Vecchio;11132;180;11312;2A247
94;2A;04;09;249;Propriano;3699;40;3739;2A249
94;2A;01;11;253;Quasquara;51;0;51;2A253
94;2A;04;09;254;Quenza;200;4;204;2A254
94;2A;01;10;258;Renno;60;4;64;2A258
94;2A;01;10;259;Rezza;62;1;63;2A259
94;2A;01;10;262;Rosazia;49;3;52;2A262
94;2A;01;10;266;Salice;89;4;93;2A266
94;2A;01;11;268;Sampolo;80;0;80;2A268
94;2A;04;06;269;Sari-Solenzara;1392;32;1424;2A269
94;2A;01;10;270;Sari-d'Orcino;344;3;347;2A270
94;2A;01;08;271;Sarrola-Carcopino;3289;52;3341;2A271
94;2A;04;09;272;Sartène;3248;124;3372;2A272
94;2A;01;11;276;Serra-di-Ferro;489;12;501;2A276
94;2A;04;09;278;Serra-di-Scopamène;83;3;86;2A278
94;2A;01;10;279;Serriera;122;0;122;2A279
94;2A;01;10;282;Soccia;148;4;152;2A282
94;2A;04;11;284;Sollacaro;374;5;379;2A284
94;2A;04;09;285;Sorbollano;76;0;76;2A285
94;2A;04;07;288;Sotta;1401;24;1425;2A288
94;2A;01;10;295;Sant'Andréa-d'Orcino;116;0;116;2A295
94;2A;04;06;300;San-Gavino-di-Carbini;1088;21;1109;2A300
94;2A;04;09;308;Sainte-Lucie-de-Tallano;383;7;390;2A308
94;2A;04;09;310;Santa-Maria-Figaniella;102;0;102;2A310
94;2A;01;11;312;Santa-Maria-Siché;404;9;413;2A312
94;2A;01;11;322;Tasso;95;0;95;2A322
94;2A;01;08;323;Tavaco;402;7;409;2A323
94;2A;01;08;324;Tavera;399;4;403;2A324
94;2A;01;08;326;Tolla;122;0;122;2A326
94;2A;01;08;330;Ucciani;501;2;503;2A330
94;2A;01;11;331;Urbalacone;61;0;61;2A331
94;2A;01;08;336;Valle-di-Mezzana;512;11;523;2A336
94;2A;01;08;345;Vero;598;4;602;2A345
94;2A;01;10;348;Vico;889;14;903;2A348
94;2A;04;09;349;Viggianello;846;18;864;2A349
94;2A;01;05;351;Villanova;389;5;394;2A351
94;2A;04;09;357;Zérubia;50;3;53;2A357
94;2A;01;11;358;Zévaco;54;1;55;2A358
94;2A;01;11;359;Zicavo;225;2;227;2A359
94;2A;01;11;360;Zigliara;129;5;134;2A360
94;2A;04;06;362;Zonza;2759;35;2794;2A362
94;2A;04;09;363;Zoza;62;0;62;2A363
94;2B;03;13;002;Aghione;240;4;244;2B002
94;2B;03;14;003;Aiti;25;0;25;2B003
94;2B;03;14;005;Alando;29;2;31;2B005
94;2B;03;14;007;Albertacce;206;3;209;2B007
94;2B;03;13;009;Aléria;2185;26;2211;2B009
94;2B;05;07;010;Algajola;354;6;360;2B010
94;2B;03;13;012;Altiani;50;0;50;2B012
94;2B;03;14;013;Alzi;25;0;25;2B013
94;2B;03;13;015;Ampriani;25;0;25;2B015
94;2B;03;13;016;Antisanti;551;0;551;2B016
94;2B;05;07;020;Aregno;598;15;613;2B020
94;2B;03;14;023;Asco;115;2;117;2B023
94;2B;05;07;025;Avapessa;84;2;86;2B025
94;2B;05;05;029;Barbaggio;294;3;297;2B029
94;2B;02;08;030;Barrettali;132;4;136;2B030
94;2B;02;99;033;Bastia;48503;695;49198;2B033
94;2B;05;15;034;Belgodère;671;9;680;2B034
94;2B;03;14;036;Bigorno;88;0;88;2B036
94;2B;02;05;037;Biguglia;7810;126;7936;2B037
94;2B;03;14;039;Bisinchi;225;2;227;2B039
94;2B;02;06;042;Borgo;8832;141;8973;2B042
94;2B;02;08;043;Brando;1624;40;1664;2B043
94;2B;03;14;045;Bustanico;66;0;66;2B045
94;2B;02;08;046;Cagnano;155;3;158;2B046
94;2B;03;14;047;Calacuccia;272;3;275;2B047
94;2B;05;07;049;Calenzana;2461;29;2490;2B049
94;2B;05;07;050;Calvi;5774;82;5856;2B050
94;2B;03;14;051;Cambia;73;0;73;2B051
94;2B;03;10;052;Campana;20;0;20;2B052
94;2B;03;13;053;Campi;19;2;21;2B053
94;2B;03;14;054;Campile;188;4;192;2B054
94;2B;03;14;055;Campitello;121;1;122;2B055
94;2B;03;10;057;Canale-di-Verde;317;10;327;2B057
94;2B;02;08;058;Canari;318;1;319;2B058
94;2B;03;14;059;Canavaggia;108;1;109;2B059
94;2B;03;10;063;Carcheto-Brustico;30;1;31;2B063
94;2B;03;10;067;Carpineto;34;0;34;2B067
94;2B;03;14;068;Carticasi;26;0;26;2B068
94;2B;03;09;069;Casabianca;105;1;106;2B069
94;2B;03;09;072;Casalta;54;1;55;2B072
94;2B;03;14;073;Casamaccioli;107;0;107;2B073
94;2B;03;11;074;Casanova;404;6;410;2B074
94;2B;03;13;075;Casevecchie;70;2;72;2B075
94;2B;03;09;077;Castellare-di-Casinca;696;5;701;2B077
94;2B;03;14;078;Castellare-di-Mercurio;28;1;29;2B078
94;2B;03;14;079;Castello-di-Rostino;490;1;491;2B079
94;2B;03;14;080;Castifao;142;1;143;2B080
94;2B;03;14;081;Castiglione;42;0;42;2B081
94;2B;03;14;082;Castineta;40;1;41;2B082
94;2B;03;14;083;Castirla;159;2;161;2B083
94;2B;05;07;084;Cateri;234;1;235;2B084
94;2B;02;08;086;Centuri;189;1;190;2B086
94;2B;03;10;087;Cervione;2199;26;2225;2B087
94;2B;03;10;088;Chiatra;209;5;214;2B088
94;2B;05;15;093;Corbara;895;32;927;2B093
94;2B;03;14;095;Corscia;128;3;131;2B095
94;2B;03;11;096;Corte;7485;117;7602;2B096
94;2B;05;15;097;Costa;55;1;56;2B097
94;2B;03;09;101;Croce;80;3;83;2B101
94;2B;03;14;102;Crocicchia;77;0;77;2B102
94;2B;03;14;105;Erbajolo;116;0;116;2B105
94;2B;03;14;106;Erone;12;0;12;2B106
94;2B;02;08;107;Ersa;155;1;156;2B107
94;2B;05;08;109;Farinole;235;2;237;2B109
94;2B;03;14;110;Favalello;70;1;71;2B110
94;2B;03;10;111;Felce;51;0;51;2B111
94;2B;05;15;112;Feliceto;232;4;236;2B112
94;2B;03;09;113;Ficaja;56;1;57;2B113
94;2B;03;14;116;Focicchia;28;1;29;2B116
94;2B;02;04;120;Furiani;5608;127;5735;2B120
94;2B;05;07;121;Galéria;361;5;366;2B121
94;2B;03;14;122;Gavignano;57;0;57;2B122
94;2B;03;13;123;Ghisonaccia;4219;55;4274;2B123
94;2B;03;12;124;Ghisoni;210;6;216;2B124
94;2B;03;09;125;Giocatojo;54;0;54;2B125
94;2B;03;13;126;Giuncaggio;69;0;69;2B126
94;2B;05;15;134;L'ÃŽle-Rousse;3163;72;3235;2B134
94;2B;03;12;135;Isolaccio-di-Fiumorbo;307;2;309;2B135
94;2B;05;15;136;Lama;146;2;148;2B136
94;2B;03;14;137;Lano;23;0;23;2B137
94;2B;05;07;138;Lavatoggio;149;2;151;2B138
94;2B;03;14;140;Lento;102;0;102;2B140
94;2B;03;13;143;Linguizzetta;1104;8;1112;2B143
94;2B;03;09;145;Loreto-di-Casinca;209;6;215;2B145
94;2B;03;14;147;Lozzi;113;2;115;2B147
94;2B;02;06;148;Lucciana;6007;51;6058;2B148
94;2B;03;12;149;Lugo-di-Nazza;82;1;83;2B149
94;2B;05;07;150;Lumio;1260;38;1298;2B150
94;2B;02;08;152;Luri;848;9;857;2B152
94;2B;05;07;153;Manso;117;2;119;2B153
94;2B;03;13;155;Matra;47;0;47;2B155
94;2B;05;15;156;Mausoléo;23;0;23;2B156
94;2B;03;14;157;Mazzola;29;0;29;2B157
94;2B;02;08;159;Meria;81;1;82;2B159
94;2B;03;13;161;MoÃ¯ta;65;0;65;2B161
94;2B;03;14;162;Moltifao;703;11;714;2B162
94;2B;03;10;164;Monacia-d'Orezza;23;0;23;2B164
94;2B;05;07;165;Moncale;332;6;338;2B165
94;2B;03;14;166;Monte;632;5;637;2B166
94;2B;05;07;167;Montegrosso;425;14;439;2B167
94;2B;05;15;168;Monticello;1972;42;2014;2B168
94;2B;03;14;169;Morosaglia;981;10;991;2B169
94;2B;02;08;170;Morsiglia;109;2;111;2B170
94;2B;03;11;171;Muracciole;34;1;35;2B171
94;2B;05;05;172;Murato;577;7;584;2B172
94;2B;05;15;173;Muro;253;3;256;2B173
94;2B;05;15;175;Nessa;108;2;110;2B175
94;2B;03;10;176;Nocario;73;2;75;2B176
94;2B;03;12;177;Noceta;59;2;61;2B177
94;2B;02;08;178;Nonza;75;2;77;2B178
94;2B;03;10;179;Novale;64;0;64;2B179
94;2B;05;15;180;Novella;78;1;79;2B180
94;2B;05;15;182;Occhiatana;256;2;258;2B182
94;2B;02;08;183;Ogliastro;94;2;96;2B183
94;2B;02;08;184;Olcani;89;1;90;2B184
94;2B;05;05;185;Oletta;1781;14;1795;2B185
94;2B;02;08;187;Olmeta-di-Capocorso;133;1;134;2B187
94;2B;05;05;188;Olmeta-di-Tuda;533;9;542;2B188
94;2B;05;15;190;Olmi-Cappella;183;5;188;2B190
94;2B;03;14;192;Olmo;151;1;152;2B192
94;2B;03;14;193;Omessa;601;3;604;2B193
94;2B;03;10;194;Ortale;26;0;26;2B194
94;2B;03;14;195;Ortiporio;124;1;125;2B195
94;2B;05;15;199;Palasca;184;5;189;2B199
94;2B;03;13;201;Pancheraccia;197;1;198;2B201
94;2B;03;10;202;Parata;23;0;23;2B202
94;2B;05;08;205;Patrimonio;876;12;888;2B205
94;2B;03;14;206;Penta-Acquatella;37;0;37;2B206
94;2B;03;09;207;Penta-di-Casinca;3370;40;3410;2B207
94;2B;03;10;208;Perelli;108;0;108;2B208
94;2B;03;09;210;Pero-Casevecchie;117;0;117;2B210
94;2B;03;13;213;Pianello;63;0;63;2B213
94;2B;03;09;214;Piano;22;0;22;2B214
94;2B;03;10;216;Piazzali;19;0;19;2B216
94;2B;03;10;217;Piazzole;41;3;44;2B217
94;2B;03;13;218;Piedicorte-di-Gaggio;98;3;101;2B218
94;2B;03;10;219;Piedicroce;82;1;83;2B219
94;2B;03;14;220;Piedigriggio;133;3;136;2B220
94;2B;03;10;221;Piedipartino;16;0;16;2B221
94;2B;03;10;222;Pie-d'Orezza;38;0;38;2B222
94;2B;05;14;223;Pietralba;502;3;505;2B223
94;2B;02;08;224;Pietracorbara;654;11;665;2B224
94;2B;03;10;225;Pietra-di-Verde;100;2;102;2B225
94;2B;03;13;226;Pietraserena;59;1;60;2B226
94;2B;03;10;227;Pietricaggio;34;1;35;2B227
94;2B;03;12;229;Pietroso;350;0;350;2B229
94;2B;05;05;230;Piève;109;5;114;2B230
94;2B;05;15;231;Pigna;105;6;111;2B231
94;2B;02;08;233;Pino;167;2;169;2B233
94;2B;03;10;234;Piobetta;18;0;18;2B234
94;2B;05;15;235;Pioggiola;84;0;84;2B235
94;2B;03;12;236;Poggio-di-Nazza;181;3;184;2B236
94;2B;03;11;238;Poggio-di-Venaco;210;8;218;2B238
94;2B;05;05;239;Poggio-d'Oletta;214;11;225;2B239
94;2B;03;09;241;Poggio-Marinaccio;31;1;32;2B241
94;2B;03;10;242;Poggio-Mezzana;697;13;710;2B242
94;2B;03;09;243;Polveroso;42;0;42;2B243
94;2B;03;14;244;Popolasca;42;0;42;2B244
94;2B;03;09;245;Porri;42;1;43;2B245
94;2B;03;09;246;La Porta;191;1;192;2B246
94;2B;03;14;248;Prato-di-Giovellina;42;1;43;2B248
94;2B;03;14;250;Prunelli-di-Casacconi;150;0;150;2B250
94;2B;03;12;251;Prunelli-di-Fiumorbo;3667;40;3707;2B251
94;2B;03;09;252;Pruno;183;2;185;2B252
94;2B;03;09;255;Quercitello;42;0;42;2B255
94;2B;03;10;256;Rapaggio;26;0;26;2B256
94;2B;05;05;257;Rapale;158;0;158;2B257
94;2B;03;11;260;Riventosa;156;3;159;2B260
94;2B;02;08;261;Rogliano;538;11;549;2B261
94;2B;03;12;263;Rospigliani;69;5;74;2B263
94;2B;03;14;264;Rusio;62;1;63;2B264
94;2B;05;05;265;Rutali;360;6;366;2B265
94;2B;03;14;267;Saliceto;45;3;48;2B267
94;2B;03;09;273;Scata;44;5;49;2B273
94;2B;03;14;274;Scolca;93;1;94;2B274
94;2B;03;14;275;Sermano;71;2;73;2B275
94;2B;03;12;277;Serra-di-Fiumorbo;337;3;340;2B277
94;2B;03;09;280;Silvareccio;114;0;114;2B280
94;2B;02;08;281;Sisco;1157;9;1166;2B281
94;2B;03;12;283;Solaro;722;13;735;2B283
94;2B;03;09;286;Sorbo-Ocagnano;873;8;881;2B286
94;2B;05;05;287;Sorio;142;0;142;2B287
94;2B;03;14;289;Soveria;117;0;117;2B289
94;2B;05;15;290;Speloncato;285;4;289;2B290
94;2B;03;10;291;Stazzona;34;1;35;2B291
94;2B;03;14;292;Sant'Andréa-di-Bozio;71;2;73;2B292
94;2B;03;10;293;Sant'Andréa-di-Cotone;210;2;212;2B293
94;2B;05;07;296;Sant'Antonino;134;5;139;2B296
94;2B;03;09;297;San-Damiano;57;0;57;2B297
94;2B;05;05;298;Saint-Florent;1681;19;1700;2B298
94;2B;03;09;299;San-Gavino-d'Ampugnani;105;1;106;2B299
94;2B;05;05;301;San-Gavino-di-Tenda;57;1;58;2B301
94;2B;03;10;302;San-Giovanni-di-Moriani;91;2;93;2B302
94;2B;03;10;303;San-Giuliano;755;6;761;2B303
94;2B;03;14;304;San-Lorenzo;143;0;143;2B304
94;2B;02;08;305;San-Martino-di-Lota;2913;42;2955;2B305
94;2B;03;14;306;Santa-Lucia-di-Mercurio;119;0;119;2B306
94;2B;03;10;307;Santa-Lucia-di-Moriani;1490;29;1519;2B307
94;2B;02;08;309;Santa-Maria-di-Lota;1888;86;1974;2B309
94;2B;03;10;311;Santa-Maria-Poggio;781;11;792;2B311
94;2B;03;10;313;San-Nicolao;2027;22;2049;2B313
94;2B;05;05;314;Santo-Pietro-di-Tenda;346;1;347;2B314
94;2B;03;11;315;Santo-Pietro-di-Venaco;281;5;286;2B315
94;2B;05;15;316;Santa-Reparata-di-Balagna;990;15;1005;2B316
94;2B;03;10;317;Santa-Reparata-di-Moriani;60;0;60;2B317
94;2B;03;09;318;Taglio-Isolaccio;583;12;595;2B318
94;2B;03;09;319;Talasani;796;7;803;2B319
94;2B;03;13;320;Tallone;282;2;284;2B320
94;2B;03;10;321;Tarrano;16;0;16;2B321
94;2B;02;08;327;Tomino;188;3;191;2B327
94;2B;03;13;328;Tox;96;0;96;2B328
94;2B;03;14;329;Tralonca;110;1;111;2B329
94;2B;05;15;332;Urtaca;231;3;234;2B332
94;2B;05;05;333;Vallecalle;138;3;141;2B333
94;2B;03;10;334;Valle-d'Alesani;107;1;108;2B334
94;2B;03;10;335;Valle-di-Campoloro;353;7;360;2B335
94;2B;03;14;337;Valle-di-Rostino;128;0;128;2B337
94;2B;03;10;338;Valle-d'Orezza;29;0;29;2B338
94;2B;05;15;339;Vallica;28;0;28;2B339
94;2B;03;10;340;Velone-Orneto;123;0;123;2B340
94;2B;03;11;341;Venaco;713;17;730;2B341
94;2B;03;12;342;Ventiseri;2512;46;2558;2B342
94;2B;03;09;343;Venzolasca;1795;14;1809;2B343
94;2B;03;10;344;Verdèse;42;2;44;2B344
94;2B;03;09;346;Vescovato;2851;32;2883;2B346
94;2B;03;12;347;Vezzani;266;0;266;2B347
94;2B;02;06;350;Vignale;195;4;199;2B350
94;2B;05;15;352;Ville-di-Paraso;209;5;214;2B352
94;2B;02;01;353;Ville-di-Pietrabugno;3328;87;3415;2B353
94;2B;03;11;354;Vivario;428;5;433;2B354
94;2B;03;14;355;Volpajola;358;7;365;2B355
94;2B;03;13;356;Zalana;144;1;145;2B356
94;2B;05;07;361;Zilia;289;5;294;2B361
94;2B;03;13;364;Zuani;34;0;34;2B364
94;2B;03;12;365;San-Gavino-di-Fiumorbo;104;2;106;2B365
94;2B;03;12;366;Chisa;102;2;104;2B366
76;30;02;20;001;Aigaliers;518;13;531;30001
76;30;03;15;002;Aigremont;777;15;792;30002
76;30;02;01;003;Aigues-Mortes;8560;80;8640;30003
76;30;02;21;004;Aigues-Vives;3338;62;3400;30004
76;30;02;14;005;Aiguèze;215;3;218;30005
76;30;02;01;006;Aimargues;5717;53;5770;30006
76;30;01;98;007;Alès;41837;615;42452;30007
76;30;01;18;008;Allègre-les-Fumades;953;17;970;30008
76;30;03;22;009;Alzon;172;3;175;30009
76;30;01;02;010;Anduze;3327;41;3368;30010
76;30;02;23;011;Les Angles;8476;205;8681;30011
76;30;02;06;012;Aramon;4219;76;4295;30012
76;30;02;16;013;Argilliers;456;21;477;30013
76;30;02;20;014;Arpaillargues-et-Aureillac;1022;27;1049;30014
76;30;03;22;015;Arphy;152;5;157;30015
76;30;03;22;016;Arre;288;10;298;30016
76;30;03;22;017;Arrigas;210;2;212;30017
76;30;02;07;018;Aspères;514;13;527;30018
76;30;02;01;019;Aubais;2895;60;2955;30019
76;30;02;21;020;Aubord;2363;43;2406;30020
76;30;02;20;021;Aubussargues;321;4;325;30021
76;30;01;08;022;Aujac;179;7;186;30022
76;30;02;07;023;Aujargues;787;16;803;30023
76;30;03;22;024;Aulas;456;7;463;30024
76;30;03;22;025;Aumessas;230;3;233;30025
76;30;03;22;026;Avèze;1075;33;1108;30026
76;30;01;02;027;Bagard;2556;59;2615;30027
76;30;02;05;028;Bagnols-sur-Cèze;18091;358;18449;30028
76;30;01;18;029;Barjac;1620;26;1646;30029
76;30;02;20;030;Baron;368;4;372;30030
76;30;02;20;031;La Bastide-d'Engras;200;2;202;30031
76;30;02;06;032;Beaucaire;15906;139;16045;30032
76;30;02;21;033;Beauvoisin;5104;55;5159;30033
76;30;02;06;034;Bellegarde;7353;85;7438;30034
76;30;02;03;035;Belvézet;239;1;240;30035
76;30;02;21;036;Bernis;3421;27;3448;30036
76;30;01;18;037;Bessèges;2835;34;2869;30037
76;30;03;22;038;Bez-et-Esparon;328;11;339;30038
76;30;02;16;039;Bezouce;2304;31;2335;30039
76;30;03;22;040;Blandas;129;2;131;30040
76;30;02;20;041;Blauzac;1237;21;1258;30041
76;30;01;02;042;Boisset-et-Gaujac;2552;44;2596;30042
76;30;02;07;043;Boissières;581;11;592;30043
76;30;01;08;044;Bonnevaux;90;0;90;30044
76;30;01;18;045;Bordezac;390;4;394;30045
76;30;01;15;046;Boucoiran-et-Nozières;981;14;995;30046
76;30;02;09;047;Bouillargues;6272;135;6407;30047
76;30;02;03;048;Bouquet;175;3;178;30048
76;30;02;20;049;Bourdic;374;17;391;30049
76;30;03;15;050;Bragassargues;170;1;171;30050
76;30;01;08;051;Branoux-les-Taillades;1338;30;1368;30051
76;30;03;22;052;Bréau-Mars;643;18;661;30052
76;30;01;15;053;Brignon;787;12;799;30053
76;30;03;15;054;Brouzet-lès-Quissac;301;4;305;30054
76;30;01;03;055;Brouzet-lès-Alès;671;12;683;30055
76;30;02;20;056;La Bruguière;331;7;338;30056
76;30;02;16;057;Cabrières;1698;29;1727;30057
76;30;03;22;058;La Cadière-et-Cambo;212;10;222;30058
76;30;02;01;059;Le Cailar;2418;28;2446;30059
76;30;02;09;060;Caissargues;4150;81;4231;30060
76;30;02;20;061;La Calmette;2363;27;2390;30061
76;30;02;07;062;Calvisson;5898;99;5997;30062
76;30;03;22;064;Campestre-et-Luc;122;2;124;30064
76;30;03;15;065;Canaules-et-Argentières;466;4;470;30065
76;30;02;07;066;Cannes-et-Clairan;533;12;545;30066
76;30;02;20;067;La Capelle-et-Masmolène;412;6;418;30067
76;30;03;15;068;Cardet;900;22;922;30068
76;30;03;15;069;Carnas;504;12;516;30069
76;30;02;14;070;Carsan;750;24;774;30070
76;30;03;15;071;Cassagnoles;395;2;397;30071
76;30;01;04;072;Castelnau-Valence;465;10;475;30072
76;30;02;16;073;Castillon-du-Gard;1672;87;1759;30073
76;30;03;22;074;Causse-Bégon;24;0;24;30074
76;30;02;19;075;Caveirac;4308;112;4420;30075
76;30;02;05;076;Cavillargues;854;29;883;30076
76;30;01;08;077;Cendras;1715;34;1749;30077
76;30;01;08;079;Chambon;261;6;267;30079
76;30;01;08;080;Chamborigaud;876;5;881;30080
76;30;02;05;081;Chusclan;964;29;993;30081
76;30;02;19;082;Clarensac;4209;96;4305;30082
76;30;02;21;083;Codognan;2418;38;2456;30083
76;30;02;17;084;Codolet;618;11;629;30084
76;30;02;16;085;Collias;1065;15;1080;30085
76;30;02;20;086;Collorgues;634;10;644;30086
76;30;03;15;087;Colognac;228;6;234;30087
76;30;02;07;088;Combas;635;15;650;30088
76;30;02;06;089;Comps;1756;31;1787;30089
76;30;01;08;090;Concoules;262;4;266;30090
76;30;02;07;091;Congénies;1667;34;1701;30091
76;30;02;05;092;Connaux;1692;49;1741;30092
76;30;03;22;093;Conqueyrac;95;2;97;30093
76;30;01;08;094;Corbès;146;1;147;30094
76;30;03;15;095;Corconne;587;12;599;30095
76;30;02;14;096;Cornillon;949;21;970;30096
76;30;01;18;097;Courry;279;5;284;30097
76;30;02;07;098;Crespian;435;4;439;30098
76;30;03;15;099;Cros;241;8;249;30099
76;30;01;15;100;Cruviers-Lascours;700;9;709;30100
76;30;01;04;101;Deaux;651;16;667;30101
76;30;02;20;102;Dions;543;9;552;30102
76;30;02;16;103;Domazan;939;11;950;30103
76;30;02;15;104;Domessargues;743;18;761;30104
76;30;03;22;105;Dourbies;139;5;144;30105
76;30;03;15;106;Durfort-et-Saint-Martin-de-Sossenac;728;17;745;30106
76;30;02;16;107;Estézargues;601;12;613;30107
76;30;03;22;108;L'Estréchure;157;5;162;30108
76;30;01;04;109;Euzet;466;7;473;30109
76;30;02;20;110;Flaux;379;9;388;30110
76;30;02;20;111;Foissac;438;9;447;30111
76;30;02;07;112;Fons;1593;15;1608;30112
76;30;02;03;113;Fons-sur-Lussan;237;3;240;30113
76;30;02;07;114;Fontanès;685;10;695;30114
76;30;02;20;115;Fontarèches;252;8;260;30115
76;30;02;16;116;Fournès;1077;12;1089;30116
76;30;02;06;117;Fourques;2796;56;2852;30117
76;30;03;15;119;Fressac;157;5;162;30119
76;30;01;18;120;Gagnières;1084;15;1099;30120
76;30;03;15;121;Gailhan;250;4;254;30121
76;30;02;07;122;Gajan;705;13;718;30122
76;30;02;01;123;Gallargues-le-Montueux;3632;102;3734;30123
76;30;02;14;124;Le Garn;214;2;216;30124
76;30;02;09;125;Garons;4940;50;4990;30125
76;30;02;20;126;Garrigues-Sainte-Eulalie;731;18;749;30126
76;30;02;05;127;Gaujac;1079;26;1105;30127
76;30;02;19;128;Générac;4071;68;4139;30128
76;30;01;02;129;Générargues;694;20;714;30129
76;30;01;08;130;Génolhac;826;20;846;30130
76;30;02;14;131;Goudargues;1106;33;1139;30131
76;30;01;08;132;La Grand-Combe;4998;96;5094;30132
76;30;02;01;133;Le Grau-du-Roi;8419;73;8492;30133
76;30;02;14;134;Issirac;309;4;313;30134
76;30;02;06;135;Jonquières-Saint-Vincent;3850;39;3889;30135
76;30;02;07;136;Junas;1129;17;1146;30136
76;30;01;08;137;Lamelouze;137;3;140;30137
76;30;02;19;138;Langlade;2222;55;2277;30138
76;30;03;22;139;Lanuéjols;350;23;373;30139
76;30;03;22;140;Lasalle;1106;11;1117;30140
76;30;02;17;141;Laudun-l'Ardoise;6331;118;6449;30141
76;30;01;08;142;Laval-Pradel;1133;22;1155;30142
76;30;02;14;143;Laval-Saint-Roman;213;5;218;30143
76;30;02;07;144;Lecques;462;9;471;30144
76;30;02;16;145;Lédenon;1620;25;1645;30145
76;30;03;15;146;Lédignan;1481;24;1505;30146
76;30;01;15;147;Lézan;1512;27;1539;30147
76;30;03;15;148;Liouc;323;7;330;30148
76;30;02;17;149;Lirac;927;20;947;30149
76;30;03;15;150;Logrian-Florian;264;6;270;30150
76;30;02;03;151;Lussan;503;7;510;30151
76;30;01;18;152;Les Mages;2044;34;2078;30152
76;30;01;08;153;Malons-et-Elze;125;0;125;30153
76;30;03;22;154;Mandagout;399;7;406;30154
76;30;02;09;155;Manduel;6943;97;7040;30155
76;30;02;09;156;Marguerittes;8656;164;8820;30156
76;30;01;04;158;Martignargues;432;9;441;30158
76;30;01;18;159;Le Martinet;741;5;746;30159
76;30;03;15;160;Maruéjols-lès-Gardon;261;4;265;30160
76;30;01;15;161;Massanes;201;6;207;30161
76;30;01;15;162;Massillargues-Attuech;667;15;682;30162
76;30;02;15;163;Mauressargues;170;6;176;30163
76;30;01;18;164;Méjannes-le-Clap;716;14;730;30164
76;30;01;04;165;Méjannes-lès-Alès;1195;35;1230;30165
76;30;02;16;166;Meynes;2503;151;2654;30166
76;30;01;18;167;Meyrannes;794;16;810;30167
76;30;01;08;168;Mialet;619;17;636;30168
76;30;02;19;169;Milhaud;5721;134;5855;30169
76;30;03;22;170;Molières-Cavaillac;924;31;955;30170
76;30;01;18;171;Molières-sur-Cèze;1219;12;1231;30171
76;30;03;15;172;Monoblet;758;8;766;30172
76;30;01;03;173;Mons;1725;32;1757;30173
76;30;02;20;174;Montaren-et-Saint-Médiers;1403;37;1440;30174
76;30;02;14;175;Montclus;194;1;195;30175
76;30;03;22;176;Montdardier;195;3;198;30176
76;30;01;04;177;Monteils;656;10;666;30177
76;30;02;17;178;Montfaucon;1521;38;1559;30178
76;30;02;16;179;Montfrin;3163;52;3215;30179
76;30;02;07;180;Montignargues;578;9;587;30180
76;30;02;07;181;Montmirat;458;5;463;30181
76;30;02;07;182;Montpezat;1367;22;1389;30182
76;30;02;15;183;Moulézan;665;4;669;30183
76;30;02;15;184;Moussac;1523;12;1535;30184
76;30;02;21;185;Mus;1431;19;1450;30185
76;30;02;07;186;Nages-et-Solorgues;1921;51;1972;30186
76;30;01;18;187;Navacelles;305;8;313;30187
76;30;01;15;188;Ners;710;13;723;30188
76;30;02;99;189;Nîmes;148561;2225;150786;30189
76;30;02;05;191;Orsan;1186;28;1214;30191
76;30;03;15;192;Orthoux-Sérignac-Quilhan;429;12;441;30192
76;30;02;07;193;Parignargues;694;6;700;30193
76;30;01;18;194;Peyremale;280;2;282;30194
76;30;03;22;195;Peyrolles;34;3;37;30195
76;30;02;05;196;Le Pin;454;11;465;30196
76;30;01;03;197;Les Plans;273;8;281;30197
76;30;03;22;198;Les Plantiers;259;6;265;30198
76;30;03;22;199;Pommiers;55;1;56;30199
76;30;03;22;200;Pompignan;957;14;971;30200
76;30;01;08;201;Ponteils-et-Brésis;369;6;375;30201
76;30;02;14;202;Pont-Saint-Esprit;10369;192;10561;30202
76;30;01;08;203;Portes;334;8;342;30203
76;30;01;18;204;Potelières;363;5;368;30204
76;30;02;20;205;Pougnadoresse;249;4;253;30205
76;30;02;09;206;Poulx;4131;121;4252;30206
76;30;02;16;207;Pouzilhac;733;6;739;30207
76;30;03;15;208;Puechredon;45;0;45;30208
76;30;02;23;209;Pujaut;3921;131;4052;30209
76;30;03;15;210;Quissac;3299;33;3332;30210
76;30;02;16;211;Redessan;4097;58;4155;30211
76;30;02;16;212;Remoulins;2259;43;2302;30212
76;30;03;22;213;Revens;20;0;20;30213
76;30;01;02;214;Ribaute-les-Tavernes;2113;48;2161;30214
76;30;01;18;215;Rivières;391;3;394;30215
76;30;01;18;216;Robiac-Rochessadoule;823;15;838;30216
76;30;02;23;217;Rochefort-du-Gard;7629;185;7814;30217
76;30;01;18;218;Rochegude;257;3;260;30218
76;30;03;22;219;Rogues;106;2;108;30219
76;30;03;22;220;Roquedur;260;6;266;30220
76;30;02;17;221;Roquemaure;5545;66;5611;30221
76;30;02;14;222;La Roque-sur-Cèze;179;7;186;30222
76;30;01;18;223;Rousson;4251;114;4365;30223
76;30;02;07;224;La Rouvière;607;15;622;30224
76;30;02;05;225;Sabran;1628;53;1681;30225
76;30;02;14;226;Saint-Alexandre;1242;26;1268;30226
76;30;01;18;227;Saint-Ambroix;3351;40;3391;30227
76;30;02;20;228;Sainte-Anastasie;1722;33;1755;30228
76;30;03;22;229;Saint-André-de-Majencoules;599;9;608;30229
76;30;02;14;230;Saint-André-de-Roquepertuis;589;9;598;30230
76;30;03;22;231;Saint-André-de-Valborgne;364;11;375;30231
76;30;02;14;232;Saint-André-d'Olérargues;435;14;449;30232
76;30;02;07;233;Saint-Bauzély;656;10;666;30233
76;30;03;15;234;Saint-Bénézet;284;7;291;30234
76;30;02;16;235;Saint-Bonnet-du-Gard;853;12;865;30235
76;30;01;08;236;Saint-Bonnet-de-Salendrinque;117;3;120;30236
76;30;01;18;237;Saint-Brès;651;12;663;30237
76;30;03;22;238;Saint-Bresson;62;0;62;30238
76;30;01;08;239;Sainte-Cécile-d'Andorge;594;3;597;30239
76;30;01;04;240;Saint-Césaire-de-Gauzignan;386;4;390;30240
76;30;02;20;241;Saint-Chaptes;1915;30;1945;30241
76;30;02;14;242;Saint-Christol-de-Rodières;162;2;164;30242
76;30;01;02;243;Saint-Christol-lez-Alès;7055;182;7237;30243
76;30;02;07;244;Saint-Clément;359;6;365;30244
76;30;02;19;245;Saint-Côme-et-Maruéjols;804;14;818;30245
76;30;01;08;246;Sainte-Croix-de-Caderle;109;7;116;30246
76;30;01;18;247;Saint-Denis;288;9;297;30247
76;30;02;20;248;Saint-Dézéry;462;4;466;30248
76;30;02;19;249;Saint-Dionisy;1070;13;1083;30249
76;30;01;04;250;Saint-Etienne-de-l'Olm;405;12;417;30250
76;30;02;05;251;Saint-Etienne-des-Sorts;548;12;560;30251
76;30;03;15;252;Saint-Félix-de-Pallières;227;7;234;30252
76;30;01;18;253;Saint-Florent-sur-Auzonnet;1169;16;1185;30253
76;30;02;17;254;Saint-Geniès-de-Comolas;1997;39;2036;30254
76;30;02;07;255;Saint-Geniès-de-Malgoirès;3052;32;3084;30255
76;30;02;14;256;Saint-Gervais;761;16;777;30256
76;30;02;16;257;Saint-Gervasy;1999;27;2026;30257
76;30;02;19;258;Saint-Gilles;13931;108;14039;30258
76;30;01;04;259;Saint-Hilaire-de-Brethmas;4503;79;4582;30259
76;30;02;16;260;Saint-Hilaire-d'Ozilhan;1080;22;1102;30260
76;30;01;04;261;Saint-Hippolyte-de-Caton;233;4;237;30261
76;30;02;20;262;Saint-Hippolyte-de-Montaigu;255;12;267;30262
76;30;03;22;263;Saint-Hippolyte-du-Fort;3804;138;3942;30263
76;30;01;04;264;Saint-Jean-de-Ceyrargues;170;1;171;30264
76;30;03;15;265;Saint-Jean-de-Crieulon;241;2;243;30265
76;30;01;18;266;Saint-Jean-de-Maruéjols-et-Avéjan;852;11;863;30266
76;30;01;15;267;Saint-Jean-de-Serres;524;11;535;30267
76;30;01;18;268;Saint-Jean-de-Valériscle;626;15;641;30268
76;30;01;08;269;Saint-Jean-du-Gard;2437;171;2608;30269
76;30;01;02;270;Saint-Jean-du-Pin;1517;39;1556;30270
76;30;01;18;271;Saint-Julien-de-Cassagnas;721;15;736;30271
76;30;03;22;272;Saint-Julien-de-la-Nef;143;6;149;30272
76;30;02;14;273;Saint-Julien-de-Peyrolas;1442;27;1469;30273
76;30;01;18;274;Saint-Julien-les-Rosiers;3401;62;3463;30274
76;30;01;03;275;Saint-Just-et-Vacquières;315;5;320;30275
76;30;02;01;276;Saint-Laurent-d'Aigouze;3536;45;3581;30276
76;30;02;14;277;Saint-Laurent-de-Carnols;500;9;509;30277
76;30;02;17;278;Saint-Laurent-des-Arbres;3000;68;3068;30278
76;30;02;20;279;Saint-Laurent-la-Vernède;658;11;669;30279
76;30;03;22;280;Saint-Laurent-le-Minier;360;11;371;30280
76;30;02;07;281;Saint-Mamert-du-Gard;1652;23;1675;30281
76;30;02;14;282;Saint-Marcel-de-Careiret;861;17;878;30282
76;30;03;22;283;Saint-Martial;183;3;186;30283
76;30;01;03;284;Saint-Martin-de-Valgalgues;4497;62;4559;30284
76;30;01;04;285;Saint-Maurice-de-Cazevieille;754;8;762;30285
76;30;02;20;286;Saint-Maximin;770;18;788;30286
76;30;02;14;287;Saint-Michel-d'Euzet;657;11;668;30287
76;30;02;14;288;Saint-Nazaire;1262;19;1281;30288
76;30;03;15;289;Saint-Nazaire-des-Gardies;86;2;88;30289
76;30;02;14;290;Saint-Paulet-de-Caisson;1830;59;1889;30290
76;30;01;08;291;Saint-Paul-la-Coste;291;5;296;30291
76;30;02;05;292;Saint-Pons-la-Calm;454;10;464;30292
76;30;01;18;293;Saint-Privat-de-Champclos;349;5;354;30293
76;30;01;03;294;Saint-Privat-des-Vieux;5275;128;5403;30294
76;30;02;20;295;Saint-Quentin-la-Poterie;3064;63;3127;30295
76;30;03;22;296;Saint-Roman-de-Codières;151;14;165;30296
76;30;03;22;297;Saint-Sauveur-Camprieu;224;11;235;30297
76;30;01;08;298;Saint-Sébastien-d'Aigrefeuille;503;19;522;30298
76;30;02;20;299;Saint-Siffret;1097;48;1145;30299
76;30;03;15;300;Saint-Théodorit;538;12;550;30300
76;30;02;20;301;Saint-Victor-des-Oules;310;4;314;30301
76;30;02;17;302;Saint-Victor-la-Coste;2135;46;2181;30302
76;30;01;18;303;Saint-Victor-de-Malcap;839;21;860;30303
76;30;02;14;304;Salazac;189;3;192;30304
76;30;01;03;305;Salindres;3571;39;3610;30305
76;30;02;07;306;Salinelles;554;8;562;30306
76;30;01;08;307;Les Salles-du-Gardon;2600;26;2626;30307
76;30;02;20;308;Sanilhac-Sagriès;774;51;825;30308
76;30;03;15;309;Sardan;337;1;338;30309
76;30;03;22;310;Saumane;281;6;287;30310
76;30;03;15;311;Sauve;1903;22;1925;30311
76;30;02;17;312;Sauveterre;2061;47;2108;30312
76;30;02;07;313;Sauzet;758;7;765;30313
76;30;03;15;314;Savignargues;235;4;239;30314
76;30;02;23;315;Saze;2119;39;2158;30315
76;30;01;08;316;Sénéchas;241;7;248;30316
76;30;02;16;317;Sernhac;1765;16;1781;30317
76;30;01;03;318;Servas;208;4;212;30318
76;30;02;20;319;Serviers-et-Labaume;618;23;641;30319
76;30;01;03;320;Seynes;159;2;161;30320
76;30;02;07;321;Sommières;5050;63;5113;30321
76;30;03;22;322;Soudorgues;267;6;273;30322
76;30;01;08;323;Soustelle;122;2;124;30323
76;30;02;07;324;Souvignargues;877;15;892;30324
76;30;03;22;325;Sumène;1388;34;1422;30325
76;30;02;17;326;Tavel;2029;37;2066;30326
76;30;01;18;327;Tharaux;56;2;58;30327
76;30;02;16;328;Théziers;1039;19;1058;30328
76;30;01;08;329;Thoiras;438;16;454;30329
76;30;01;15;330;Tornac;935;25;960;30330
76;30;02;05;331;Tresques;1806;50;1856;30331
76;30;03;22;332;Trèves;113;1;114;30332
76;30;02;21;333;Uchaud;4424;43;4467;30333
76;30;02;20;334;Uzès;8387;329;8716;30334
76;30;01;08;335;Vabres;134;4;138;30335
76;30;02;06;336;Vallabrègues;1388;20;1408;30336
76;30;02;20;337;Vallabrix;422;6;428;30337
76;30;02;03;338;Vallérargues;142;4;146;30338
76;30;03;22;339;Val-d'Aigoual;1415;21;1436;30339
76;30;02;16;340;Valliguières;591;11;602;30340
76;30;02;21;341;Vauvert;11492;118;11610;30341
76;30;02;14;342;Vénéjan;1270;42;1312;30342
76;30;02;14;343;Verfeuil;604;8;612;30343
76;30;02;21;344;Vergèze;5308;76;5384;30344
76;30;01;08;345;La Vernarède;343;1;344;30345
76;30;02;16;346;Vers-Pont-du-Gard;1794;33;1827;30346
76;30;02;21;347;Vestric-et-Candiac;1379;21;1400;30347
76;30;01;04;348;Vézénobres;1816;102;1918;30348
76;30;03;15;349;Vic-le-Fesq;546;3;549;30349
76;30;03;22;350;Le Vigan;3772;118;3890;30350
76;30;02;23;351;Villeneuve-lès-Avignon;12216;401;12617;30351
76;30;02;07;352;Villevieille;1791;35;1826;30352
76;30;03;22;353;Vissec;67;1;68;30353
76;30;02;15;354;Montagnac;200;4;204;30354
76;30;02;17;355;Saint-Paul-les-Fonts;1029;21;1050;30355
76;30;02;09;356;Rodilhan;2851;172;3023;30356
76;31;02;06;001;Agassac;122;3;125;31001
76;31;03;07;002;Aignes;241;6;247;31002
76;31;03;07;003;Aigrefeuille;1272;29;1301;31003
76;31;03;07;004;Ayguesvives;2679;50;2729;31004
76;31;02;06;005;Alan;293;8;301;31005
76;31;03;13;006;Albiac;221;6;227;31006
76;31;02;06;007;Ambax;64;0;64;31007
76;31;02;06;008;Anan;253;4;257;31008
76;31;02;02;009;Antichan-de-Frontignes;186;3;189;31009
76;31;02;02;010;Antignac;99;3;102;31010
76;31;02;02;011;Arbas;268;6;274;31011
76;31;02;02;012;Arbon;99;2;101;31012
76;31;02;02;013;Ardiège;358;11;369;31013
76;31;02;02;014;Arguenos;81;4;85;31014
76;31;02;02;015;Argut-Dessous;22;1;23;31015
76;31;02;02;017;Arlos;101;2;103;31017
76;31;02;02;018;Arnaud-Guilhem;227;4;231;31018
76;31;02;02;019;Artigue;32;1;33;31019
76;31;02;02;020;Aspet;874;72;946;31020
76;31;02;14;021;Aspret-Sarrat;128;5;133;31021
76;31;03;05;022;Aucamville;8968;94;9062;31022
76;31;02;06;023;Aulon;310;5;315;31023
76;31;01;07;024;Auragne;421;5;426;31024
76;31;03;04;025;Aureville;921;15;936;31025
76;31;03;13;026;Auriac-sur-Vendinelle;1055;21;1076;31026
76;31;01;01;027;Auribail;200;5;205;31027
76;31;02;06;028;Aurignac;1243;70;1313;31028
76;31;03;13;029;Aurin;335;6;341;31029
76;31;02;02;030;Ausseing;78;1;79;31030
76;31;02;14;031;Ausson;590;20;610;31031
76;31;03;03;032;Aussonne;7209;80;7289;31032
76;31;01;01;033;Auterive;9923;95;10018;31033
76;31;02;02;034;Auzas;231;9;240;31034
76;31;03;04;035;Auzeville-Tolosane;4088;247;4335;31035
76;31;03;04;036;Auzielle;1578;48;1626;31036
76;31;03;13;037;Avignonet-Lauragais;1602;12;1614;31037
76;31;03;10;038;Azas;664;11;675;31038
76;31;02;06;039;Bachas;81;2;83;31039
76;31;02;02;040;Bachos;35;1;36;31040
76;31;02;02;041;Bagiry;113;2;115;31041
76;31;02;02;042;Bagnères-de-Luchon;2285;143;2428;31042
76;31;02;14;043;Balesta;140;6;146;31043
76;31;03;24;044;Balma;16625;287;16912;31044
76;31;02;02;045;Barbazan;496;10;506;31045
76;31;02;02;046;Baren;12;0;12;31046
76;31;01;01;047;Bax;92;1;93;31047
76;31;03;07;048;Baziège;3395;58;3453;31048
76;31;03;10;049;Bazus;579;14;593;31049
76;31;02;02;050;Beauchalot;643;9;652;31050
76;31;01;06;051;Beaufort;467;5;472;31051
76;31;01;01;052;Beaumont-sur-Lèze;1587;32;1619;31052
76;31;03;24;053;Beaupuy;1340;28;1368;31053
76;31;03;13;054;Beauteville;184;1;185;31054
76;31;03;13;055;Beauville;173;3;176;31055
76;31;03;03;056;Beauzelle;6973;83;7056;31056
76;31;03;07;057;Belberaud;1505;51;1556;31057
76;31;03;07;058;Belbèze-de-Lauragais;128;1;129;31058
76;31;02;02;059;Belbèze-en-Comminges;114;6;120;31059
76;31;03;13;060;Bélesta-en-Lauragais;111;5;116;31060
76;31;03;08;061;Bellegarde-Sainte-Marie;191;12;203;31061
76;31;03;08;062;Bellesserre;107;4;111;31062
76;31;02;06;063;Benque;166;2;168;31063
76;31;02;02;064;Benque-Dessous-et-Dessus;27;0;27;31064
76;31;01;06;065;Bérat;3034;59;3093;31065
76;31;03;27;066;Bessières;4127;62;4189;31066
76;31;02;02;067;Bezins-Garraux;42;0;42;31067
76;31;02;02;068;Billière;27;0;27;31068
76;31;03;03;069;Blagnac;25525;489;26014;31069
76;31;02;14;070;Blajan;451;8;459;31070
76;31;01;01;071;Bois-de-la-Pierre;441;3;444;31071
76;31;02;06;072;Boissède;68;2;70;31072
76;31;03;27;073;Bondigoux;659;21;680;31073
76;31;03;10;074;Bonrepos-Riquet;289;7;296;31074
76;31;01;11;075;Bonrepos-sur-Aussonnelle;1225;22;1247;31075
76;31;02;14;076;Bordes-de-Rivière;471;12;483;31076
76;31;03;27;077;Le Born;593;15;608;31077
76;31;02;14;078;Boudrac;147;2;149;31078
76;31;03;27;079;Bouloc;4723;89;4812;31079
76;31;02;14;080;Boulogne-sur-Gesse;1648;34;1682;31080
76;31;02;02;081;Bourg-d'Oueil;5;0;5;31081
76;31;03;13;082;Bourg-Saint-Bernard;1111;21;1132;31082
76;31;02;06;083;Boussan;233;2;235;31083
76;31;01;06;084;Boussens;1061;24;1085;31084
76;31;02;02;085;Boutx;249;3;252;31085
76;31;02;06;086;Bouzin;88;4;92;31086
76;31;01;11;087;Bragayrac;323;2;325;31087
76;31;03;21;088;Brax;2862;95;2957;31088
76;31;03;08;089;Bretx;679;6;685;31089
76;31;03;08;090;Brignemont;374;5;379;31090
76;31;03;05;091;Bruguières;5947;105;6052;31091
76;31;02;02;092;Burgalays;120;0;120;31092
76;31;03;08;093;Le Burgaud;957;11;968;31093
76;31;03;27;094;Buzet-sur-Tarn;2870;51;2921;31094
76;31;02;02;095;Cabanac-Cazaux;128;1;129;31095
76;31;03;08;096;Cabanac-Séguenville;180;1;181;31096
76;31;03;13;097;Le Cabanial;462;12;474;31097
76;31;03;08;098;Cadours;1089;19;1108;31098
76;31;03;07;099;Caignac;399;4;403;31099
76;31;03;07;100;Calmont;2371;31;2402;31100
76;31;01;06;101;Cambernard;467;4;471;31101
76;31;03;13;102;Cambiac;220;3;223;31102
76;31;01;01;103;Canens;59;0;59;31103
76;31;01;01;104;Capens;677;13;690;31104
76;31;03;13;105;Caragoudes;228;5;233;31105
76;31;03;13;106;Caraman;2544;47;2591;31106
76;31;01;01;107;Carbonne;5791;111;5902;31107
76;31;02;14;108;Cardeilhac;269;2;271;31108
76;31;02;06;109;Cassagnabère-Tournas;467;3;470;31109
76;31;02;02;110;Cassagne;644;13;657;31110
76;31;01;01;111;Castagnac;279;4;283;31111
76;31;02;02;112;Castagnède;190;5;195;31112
76;31;03;04;113;Castanet-Tolosan;14213;249;14462;31113
76;31;02;02;114;Castelbiague;241;3;244;31114
76;31;02;06;115;Castelgaillard;59;1;60;31115
76;31;03;05;116;Castelginest;10682;117;10799;31116
76;31;03;10;117;Castelmaurou;4359;99;4458;31117
76;31;03;27;118;Castelnau-d'Estrétefonds;6579;103;6682;31118
76;31;01;06;119;Castelnau-Picampeau;208;5;213;31119
76;31;03;08;120;Le Castéra;718;18;736;31120
76;31;02;14;121;Castéra-Vignoles;63;1;64;31121
76;31;01;06;122;Casties-Labrande;113;2;115;31122
76;31;02;02;123;Castillon-de-Larboust;74;1;75;31123
76;31;02;02;124;Castillon-de-Saint-Martory;387;9;396;31124
76;31;02;02;125;Cathervielle;36;0;36;31125
76;31;03;08;126;Caubiac;396;10;406;31126
76;31;02;02;127;Caubous;4;1;5;31127
76;31;01;01;128;Caujac;850;22;872;31128
76;31;02;02;129;Cazarilh-Laspènes;17;4;21;31129
76;31;02;14;130;Cazaril-Tambourès;84;3;87;31130
76;31;02;02;131;Cazaunous;70;1;71;31131
76;31;02;02;132;Cazaux-Layrisse;64;1;65;31132
76;31;02;02;133;Cazeaux-de-Larboust;99;4;103;31133
76;31;02;06;134;Cazeneuve-Montaut;83;0;83;31134
76;31;01;06;135;Cazères;4799;72;4871;31135
76;31;03;27;136;Cépet;2171;26;2197;31136
76;31;03;13;137;Cessales;155;0;155;31137
76;31;02;14;138;Charlas;250;6;256;31138
76;31;02;02;139;Chaum;195;4;199;31139
76;31;02;02;140;Chein-Dessus;177;7;184;31140
76;31;02;14;141;Ciadoux;218;2;220;31141
76;31;02;02;142;Cier-de-Luchon;239;7;246;31142
76;31;02;02;143;Cier-de-Rivière;277;8;285;31143
76;31;02;02;144;Cierp-Gaud;730;12;742;31144
76;31;01;01;145;Cintegabelle;2914;65;2979;31145
76;31;02;02;146;Cirès;14;0;14;31146
76;31;02;14;147;Clarac;658;12;670;31147
76;31;03;04;148;Clermont-le-Fort;507;17;524;31148
76;31;03;21;149;Colomiers;39968;561;40529;31149
76;31;03;03;150;Cornebarrieu;7372;106;7478;31150
76;31;03;07;151;Corronsac;859;23;882;31151
76;31;02;06;152;Coueilles;94;5;99;31152
76;31;01;06;153;Couladère;416;12;428;31153
76;31;02;02;155;Couret;231;2;233;31155
76;31;03;08;156;Cox;358;12;370;31156
76;31;03;26;157;Cugnaux;19344;253;19597;31157
76;31;02;14;158;Cuguron;178;7;185;31158
76;31;02;14;159;Le Cuing;472;5;477;31159
76;31;03;08;160;Daux;2432;28;2460;31160
76;31;03;07;161;Deyme;1236;22;1258;31161
76;31;03;07;162;Donneville;1080;86;1166;31162
76;31;03;24;163;Drémil-Lafage;2649;65;2714;31163
76;31;03;08;164;Drudas;202;6;208;31164
76;31;01;12;165;Eaunes;6349;98;6447;31165
76;31;01;11;166;Empeaux;279;4;283;31166
76;31;02;02;167;Encausse-les-Thermes;700;14;714;31167
76;31;02;06;168;Eoux;130;0;130;31168
76;31;03;07;169;Escalquens;6967;162;7129;31169
76;31;02;14;170;Escanecrabe;246;10;256;31170
76;31;03;07;171;Espanès;302;9;311;31171
76;31;02;06;172;Esparron;47;1;48;31172
76;31;01;01;173;Esperce;266;3;269;31173
76;31;02;02;174;Estadens;538;4;542;31174
76;31;02;14;175;Estancarbon;608;10;618;31175
76;31;02;02;176;Esténos;191;5;196;31176
76;31;02;02;177;Eup;136;2;138;31177
76;31;02;06;178;Fabas;200;3;203;31178
76;31;03;13;179;Le Faget;322;20;342;31179
76;31;03;13;180;Falga;139;6;145;31180
76;31;01;09;181;Le Fauga;2089;28;2117;31181
76;31;03;05;182;Fenouillet;5307;59;5366;31182
76;31;02;02;183;Figarol;317;9;326;31183
76;31;03;24;184;Flourens;2056;38;2094;31184
76;31;03;13;185;Folcarde;117;1;118;31185
76;31;03;05;186;Fonbeauzard;3011;30;3041;31186
76;31;01;11;187;Fonsorbes;12170;329;12499;31187
76;31;01;11;188;Fontenilles;5893;161;6054;31188
76;31;01;06;189;Forgues;220;4;224;31189
76;31;02;02;190;Fos;233;0;233;31190
76;31;02;02;191;Fougaron;96;2;98;31191
76;31;03;07;192;Fourquevaux;776;21;797;31192
76;31;01;06;193;Le Fousseret;1904;30;1934;31193
76;31;03;13;194;Francarville;169;2;171;31194
76;31;02;02;195;Francazal;32;0;32;31195
76;31;01;06;196;Francon;244;3;247;31196
76;31;02;14;197;Franquevielle;327;8;335;31197
76;31;02;02;198;Le Fréchet;101;3;104;31198
76;31;02;02;199;Fronsac;200;7;207;31199
76;31;02;02;200;Frontignan-de-Comminges;79;4;83;31200
76;31;02;06;201;Frontignan-Savès;73;0;73;31201
76;31;03;27;202;Fronton;6271;149;6420;31202
76;31;01;09;203;Frouzins;9292;162;9454;31203
76;31;01;06;204;Fustignac;82;3;85;31204
76;31;03;05;205;Gagnac-sur-Garonne;3130;27;3157;31205
76;31;01;01;206;Gaillac-Toulza;1311;15;1326;31206
76;31;02;02;207;Galié;78;6;84;31207
76;31;02;02;208;Ganties;327;5;332;31208
76;31;03;08;209;Garac;147;4;151;31209
76;31;03;13;210;Gardouch;1283;24;1307;31210
76;31;03;27;211;Gargas;702;8;710;31211
76;31;03;10;212;Garidech;1928;14;1942;31212
76;31;02;02;213;Garin;155;3;158;31213
76;31;03;10;215;Gauré;467;15;482;31215
76;31;03;10;216;Gémil;269;10;279;31216
76;31;02;02;217;Génos;68;1;69;31217
76;31;02;14;218;Gensac-de-Boulogne;115;4;119;31218
76;31;01;01;219;Gensac-sur-Garonne;447;2;449;31219
76;31;03;07;220;Gibel;376;5;381;31220
76;31;02;02;221;Gouaux-de-Larboust;69;0;69;31221
76;31;02;02;222;Gouaux-de-Luchon;46;0;46;31222
76;31;02;06;223;Goudex;43;1;44;31223
76;31;02;02;224;Gourdan-Polignan;1203;186;1389;31224
76;31;01;01;225;Goutevernisse;186;3;189;31225
76;31;01;01;226;Gouzens;81;6;87;31226
76;31;03;04;227;Goyrans;843;36;879;31227
76;31;03;10;228;Gragnague;1974;43;2017;31228
76;31;01;06;229;Gratens;696;17;713;31229
76;31;03;05;230;Gratentour;4387;79;4466;31230
76;31;01;01;231;Grazac;691;8;699;31231
76;31;03;08;232;Grenade;8844;166;9010;31232
76;31;01;01;233;Grépiac;997;33;1030;31233
76;31;03;08;234;Le Grès;440;8;448;31234
76;31;02;02;235;Guran;44;1;45;31235
76;31;02;02;236;Herran;73;1;74;31236
76;31;02;02;237;His;232;30;262;31237
76;31;02;02;238;Huos;482;11;493;31238
76;31;02;06;239;L'Isle-en-Dodon;1634;28;1662;31239
76;31;03;07;240;Issus;601;10;611;31240
76;31;02;02;241;Izaut-de-l'Hôtel;295;5;300;31241
76;31;02;02;242;Jurvielle;18;2;20;31242
76;31;03;13;243;Juzes;69;4;73;31243
76;31;02;02;244;Juzet-de-Luchon;381;17;398;31244
76;31;02;02;245;Juzet-d'Izaut;188;5;193;31245
76;31;02;14;246;Labarthe-Inard;866;15;881;31246
76;31;02;14;247;Labarthe-Rivière;1303;28;1331;31247
76;31;01;12;248;Labarthe-sur-Lèze;6271;105;6376;31248
76;31;03;07;249;Labastide-Beauvoir;1259;26;1285;31249
76;31;01;06;250;Labastide-Clermont;675;17;692;31250
76;31;02;06;251;Labastide-Paumès;145;1;146;31251
76;31;03;10;252;Labastide-Saint-Sernin;1955;25;1980;31252
76;31;01;09;253;Labastidette;2938;37;2975;31253
76;31;03;04;254;Labège;4008;142;4150;31254
76;31;02;02;255;Labroquère;319;10;329;31255
76;31;01;01;256;Labruyère-Dorsa;290;6;296;31256
76;31;01;01;258;Lacaugne;241;6;247;31258
76;31;03;04;259;Lacroix-Falgarde;2081;49;2130;31259
76;31;02;02;260;Laffite-Toupière;96;1;97;31260
76;31;01;01;261;Lafitte-Vigordane;1224;19;1243;31261
76;31;03;13;262;Lagarde;421;11;432;31262
76;31;01;12;263;Lagardelle-sur-Lèze;3169;57;3226;31263
76;31;01;01;264;Lagrâce-Dieu;557;7;564;31264
76;31;03;08;265;Lagraulet-Saint-Nicolas;242;4;246;31265
76;31;01;06;266;Lahage;199;1;200;31266
76;31;01;01;267;Lahitère;66;0;66;31267
76;31;02;14;268;Lalouret-Laffiteau;135;3;138;31268
76;31;01;09;269;Lamasquère;1510;15;1525;31269
76;31;02;14;270;Landorthe;1013;35;1048;31270
76;31;03;13;271;Lanta;2155;42;2197;31271
76;31;01;01;272;Lapeyrère;65;3;68;31272
76;31;03;10;273;Lapeyrouse-Fossat;2886;69;2955;31273
76;31;02;14;274;Larcan;182;5;187;31274
76;31;03;08;275;Laréole;160;5;165;31275
76;31;02;14;276;Larroque;287;5;292;31276
76;31;03;08;277;Lasserre-Pradère;1543;42;1585;31277
76;31;02;06;278;Latoue;317;5;322;31278
76;31;01;01;279;Latour;77;1;78;31279
76;31;01;01;280;Latrape;372;13;385;31280
76;31;03;08;281;Launac;1336;32;1368;31281
76;31;03;22;282;Launaguet;9050;112;9162;31282
76;31;01;06;283;Lautignac;267;1;268;31283
76;31;03;07;284;Lauzerville;1654;55;1709;31284
76;31;03;10;285;Lavalette;759;13;772;31285
76;31;01;01;286;Lavelanet-de-Comminges;614;8;622;31286
76;31;01;09;287;Lavernose-Lacasse;3255;83;3338;31287
76;31;03;27;288;Layrac-sur-Tarn;311;9;320;31288
76;31;02;14;289;Lécussan;280;3;283;31289
76;31;02;02;290;Lège;36;1;37;31290
76;31;03;08;291;Léguevin;9359;253;9612;31291
76;31;01;06;292;Lescuns;73;1;74;31292
76;31;03;05;293;Lespinasse;2828;23;2851;31293
76;31;02;14;294;Lespiteau;91;1;92;31294
76;31;02;14;295;Lespugue;83;0;83;31295
76;31;02;02;296;Lestelle-de-Saint-Martory;437;11;448;31296
76;31;03;08;297;Lévignac;2139;42;2181;31297
76;31;01;06;299;Lherm;3777;82;3859;31299
76;31;02;14;300;Lieoux;127;3;130;31300
76;31;02;06;301;Lilhac;131;1;132;31301
76;31;02;14;302;Lodes;291;7;298;31302
76;31;01;01;303;Longages;3160;34;3194;31303
76;31;03;13;304;Loubens-Lauragais;451;10;461;31304
76;31;02;14;305;Loudet;197;6;203;31305
76;31;02;02;306;Lourde;92;0;92;31306
76;31;02;02;308;Luscan;48;0;48;31308
76;31;01;06;309;Lussan-Adeilhac;229;2;231;31309
76;31;03;13;310;Lux;339;5;344;31310
76;31;03;27;311;La Magdelaine-sur-Tarn;1181;21;1202;31311
76;31;01;01;312;Mailholas;35;1;36;31312
76;31;02;02;313;Malvezie;110;2;112;31313
76;31;02;02;314;Mancioux;384;5;389;31314
76;31;02;02;315;Mane;956;46;1002;31315
76;31;02;02;316;Marignac;490;8;498;31316
76;31;01;06;317;Marignac-Lasclares;469;9;478;31317
76;31;01;06;318;Marignac-Laspeyres;206;5;211;31318
76;31;01;01;319;Marliac;138;1;139;31319
76;31;01;01;320;Marquefave;956;41;997;31320
76;31;02;02;321;Marsoulas;125;8;133;31321
76;31;02;06;322;Martisserre;66;2;68;31322
76;31;02;02;323;Martres-de-Rivière;351;13;364;31323
76;31;01;06;324;Martres-Tolosane;2414;44;2458;31324
76;31;03;13;325;Mascarville;187;12;199;31325
76;31;01;01;326;Massabrac;93;0;93;31326
76;31;01;06;327;Mauran;214;1;215;31327
76;31;03;13;328;Mauremont;317;10;327;31328
76;31;03;13;329;Maurens;208;2;210;31329
76;31;01;01;330;Mauressac;506;11;517;31330
76;31;03;13;331;Maureville;307;12;319;31331
76;31;03;07;332;Mauvaisin;217;4;221;31332
76;31;02;06;333;Mauvezin;89;3;92;31333
76;31;01;01;334;Mauzac;1301;23;1324;31334
76;31;02;02;335;Mayrègne;25;2;27;31335
76;31;02;02;336;Mazères-sur-Salat;628;12;640;31336
76;31;02;02;337;Melles;92;1;93;31337
76;31;03;08;338;Menville;781;23;804;31338
76;31;03;08;339;Mérenvielle;490;6;496;31339
76;31;03;04;340;Mervilla;291;9;300;31340
76;31;03;08;341;Merville;6054;103;6157;31341
76;31;02;02;342;Milhas;173;0;173;31342
76;31;02;06;343;Mirambeau;61;0;61;31343
76;31;02;14;344;Miramont-de-Comminges;766;12;778;31344
76;31;01;01;345;Miremont;2623;36;2659;31345
76;31;03;27;346;Mirepoix-sur-Tarn;1104;14;1118;31346
76;31;02;06;347;Molas;167;4;171;31347
76;31;02;02;348;Moncaup;37;0;37;31348
76;31;01;06;349;Mondavezan;905;18;923;31349
76;31;02;14;350;Mondilhan;81;1;82;31350
76;31;03;03;351;Mondonville;5166;93;5259;31351
76;31;03;24;352;Mondouzil;224;11;235;31352
76;31;01;06;353;Monès;88;0;88;31353
76;31;03;07;354;Monestrol;54;0;54;31354
76;31;03;24;355;Mons;1758;53;1811;31355
76;31;03;08;356;Montaigut-sur-Save;1839;46;1885;31356
76;31;02;02;357;Montastruc-de-Salies;305;2;307;31357
76;31;03;10;358;Montastruc-la-Conseillère;3576;101;3677;31358
76;31;01;06;359;Montastruc-Savès;70;2;72;31359
76;31;02;02;360;Montauban-de-Luchon;503;7;510;31360
76;31;01;01;361;Montaut;516;5;521;31361
76;31;01;06;362;Montberaud;203;5;208;31362
76;31;02;06;363;Montbernard;217;5;222;31363
76;31;03;10;364;Montberon;3088;66;3154;31364
76;31;01;01;365;Montbrun-Bocage;470;11;481;31365
76;31;03;07;366;Montbrun-Lauragais;654;21;675;31366
76;31;01;06;367;Montclar-de-Comminges;76;5;81;31367
76;31;03;13;368;Montclar-Lauragais;242;13;255;31368
76;31;02;02;369;Mont-de-Galié;42;2;44;31369
76;31;01;06;370;Montégut-Bourjac;143;1;144;31370
76;31;03;13;371;Montégut-Lauragais;423;15;438;31371
76;31;02;02;372;Montespan;459;7;466;31372
76;31;02;06;373;Montesquieu-Guittaut;179;2;181;31373
76;31;03;13;374;Montesquieu-Lauragais;1009;13;1022;31374
76;31;01;01;375;Montesquieu-Volvestre;3111;68;3179;31375
76;31;02;02;376;Montgaillard-de-Salies;104;3;107;31376
76;31;03;13;377;Montgaillard-Lauragais;711;9;720;31377
76;31;02;14;378;Montgaillard-sur-Save;82;2;84;31378
76;31;01;01;379;Montgazin;178;2;180;31379
76;31;03;07;380;Montgeard;507;8;515;31380
76;31;03;07;381;Montgiscard;2530;59;2589;31381
76;31;01;06;382;Montgras;112;1;113;31382
76;31;03;10;383;Montjoire;1304;26;1330;31383
76;31;03;07;384;Montlaur;1769;36;1805;31384
76;31;02;14;385;Montmaurin;201;4;205;31385
76;31;02;06;386;Montoulieu-Saint-Bernard;214;6;220;31386
76;31;01;06;387;Montoussin;129;0;129;31387
76;31;03;10;388;Montpitol;387;12;399;31388
76;31;03;24;389;Montrabé;4111;78;4189;31389
76;31;02;14;390;Montréjeau;2751;33;2784;31390
76;31;02;02;391;Montsaunès;453;31;484;31391
76;31;03;13;392;Mourvilles-Basses;78;4;82;31392
76;31;03;13;393;Mourvilles-Hautes;167;5;172;31393
76;31;02;02;394;Moustajon;129;3;132;31394
76;31;01;09;395;Muret;24797;564;25361;31395
76;31;03;07;396;Nailloux;3928;64;3992;31396
76;31;02;14;397;Nénigan;56;1;57;31397
76;31;02;14;398;Nizan-Gesse;96;1;97;31398
76;31;01;01;399;Noé;2912;64;2976;31399
76;31;03;13;400;Nogaret;90;0;90;31400
76;31;03;07;401;Noueilles;393;6;399;31401
76;31;03;07;402;Odars;906;32;938;31402
76;31;03;08;403;Ondes;767;133;900;31403
76;31;02;02;404;Oô;101;4;105;31404
76;31;02;02;405;Ore;114;3;117;31405
76;31;01;06;406;Palaminy;814;11;825;31406
76;31;03;10;407;Paulhac;1239;29;1268;31407
76;31;02;02;408;Payssous;88;3;91;31408
76;31;03;04;409;Péchabou;2352;54;2406;31409
76;31;03;10;410;Pechbonnieu;4544;89;4633;31410
76;31;03;04;411;Pechbusque;947;22;969;31411
76;31;02;14;412;Péguilhan;267;8;275;31412
76;31;03;08;413;Pelleport;509;12;521;31413
76;31;02;06;414;Peyrissas;80;2;82;31414
76;31;02;06;415;Peyrouzet;82;2;84;31415
76;31;01;01;416;Peyssies;585;7;592;31416
76;31;03;21;417;Pibrac;8578;255;8833;31417
76;31;03;24;418;Pin-Balma;938;33;971;31418
76;31;01;06;419;Le Pin-Murelet;173;4;177;31419
76;31;01;12;420;Pinsaguel;2840;37;2877;31420
76;31;01;12;421;Pins-Justaret;4318;69;4387;31421
76;31;01;06;422;Plagne;93;0;93;31422
76;31;01;06;423;Plagnole;306;3;309;31423
76;31;03;11;424;Plaisance-du-Touch;19402;411;19813;31424
76;31;01;06;425;Le Plan;442;7;449;31425
76;31;02;02;426;Pointis-de-Rivière;854;11;865;31426
76;31;02;14;427;Pointis-Inard;941;15;956;31427
76;31;01;06;428;Polastron;53;2;55;31428
76;31;03;07;429;Pompertuzat;2307;38;2345;31429
76;31;02;14;430;Ponlat-Taillebourg;596;14;610;31430
76;31;02;02;431;Portet-d'Aspet;61;1;62;31431
76;31;02;02;432;Portet-de-Luchon;38;4;42;31432
76;31;01;12;433;Portet-sur-Garonne;9812;124;9936;31433
76;31;02;02;434;Poubeau;80;4;84;31434
76;31;01;06;435;Poucharramet;935;14;949;31435
76;31;01;06;436;Pouy-de-Touges;412;10;422;31436
76;31;03;07;437;Pouze;85;4;89;31437
76;31;03;07;439;Préserville;720;15;735;31439
76;31;02;02;440;Proupiary;71;1;72;31440
76;31;03;13;441;Prunet;148;2;150;31441
76;31;01;01;442;Puydaniel;552;9;561;31442
76;31;02;06;443;Puymaurin;291;5;296;31443
76;31;03;08;444;Puysségur;139;4;143;31444
76;31;03;24;445;Quint-Fonsegrives;5896;118;6014;31445
76;31;03;25;446;Ramonville-Saint-Agne;14600;317;14917;31446
76;31;02;02;447;Razecueillé;35;1;36;31447
76;31;03;04;448;Rebigue;472;25;497;31448
76;31;02;14;449;Régades;139;4;143;31449
76;31;03;13;450;Renneville;545;13;558;31450
76;31;03;13;451;Revel;9637;297;9934;31451
76;31;02;14;452;Rieucazé;56;0;56;31452
76;31;03;13;453;Rieumajou;137;2;139;31453
76;31;01;06;454;Rieumes;3578;86;3664;31454
76;31;01;01;455;Rieux-Volvestre;2611;56;2667;31455
76;31;02;06;456;Riolas;51;1;52;31456
76;31;02;02;457;Roquefort-sur-Garonne;794;13;807;31457
76;31;01;12;458;Roques;4757;54;4811;31458
76;31;03;10;459;Roquesérière;756;19;775;31459
76;31;01;12;460;Roquettes;4212;68;4280;31460
76;31;02;02;461;Rouède;289;3;292;31461
76;31;03;10;462;Rouffiac-Tolosan;1931;41;1972;31462
76;31;03;13;463;Roumens;247;4;251;31463
76;31;01;11;464;Sabonnères;323;9;332;31464
76;31;02;02;465;Saccourvielle;19;0;19;31465
76;31;01;11;466;Saiguède;809;22;831;31466
76;31;03;05;467;Saint-Alban;6217;50;6267;31467
76;31;02;06;468;Saint-André;233;8;241;31468
76;31;01;06;469;Saint-Araille;137;3;140;31469
76;31;02;02;470;Saint-Aventin;64;3;67;31470
76;31;02;02;471;Saint-Béat-Lez;383;8;391;31471
76;31;02;02;472;Saint-Bertrand-de-Comminges;240;6;246;31472
76;31;03;08;473;Saint-Cézert;434;1;435;31473
76;31;01;01;474;Saint-Christaud;239;4;243;31474
76;31;01;09;475;Saint-Clar-de-Rivière;1410;27;1437;31475
76;31;01;06;476;Saint-Elix-le-Château;919;21;940;31476
76;31;02;06;477;Saint-Elix-Séglan;42;0;42;31477
76;31;03;13;478;Saint-Félix-Lauragais;1266;34;1300;31478
76;31;02;14;479;Saint-Ferréol-de-Comminges;60;1;61;31479
76;31;03;07;480;Sainte-Foy-d'Aigrefeuille;2174;66;2240;31480
76;31;01;06;481;Sainte-Foy-de-Peyrolières;2093;46;2139;31481
76;31;02;06;482;Saint-Frajou;213;4;217;31482
76;31;02;14;483;Saint-Gaudens;11773;564;12337;31483
76;31;03;10;484;Saint-Geniès-Bellevue;2522;65;2587;31484
76;31;03;13;485;Saint-Germier;116;2;118;31485
76;31;01;09;486;Saint-Hilaire;1373;22;1395;31486
76;31;02;14;487;Saint-Ignan;228;5;233;31487
76;31;03;23;488;Saint-Jean;11017;138;11155;31488
76;31;03;10;489;Saint-Jean-Lherm;395;12;407;31489
76;31;03;05;490;Saint-Jory;6383;68;6451;31490
76;31;03;13;491;Saint-Julia;413;11;424;31491
76;31;01;01;492;Saint-Julien-sur-Garonne;552;5;557;31492
76;31;02;14;493;Saint-Lary-Boujean;132;6;138;31493
76;31;02;06;494;Saint-Laurent;178;1;179;31494
76;31;03;07;495;Saint-Léon;1293;13;1306;31495
76;31;03;08;496;Sainte-Livrade;258;13;271;31496
76;31;03;10;497;Saint-Loup-Cammas;2221;46;2267;31497
76;31;02;14;498;Saint-Loup-en-Comminges;37;0;37;31498
76;31;01;11;499;Saint-Lys;9521;183;9704;31499
76;31;02;02;500;Saint-Mamet;555;19;574;31500
76;31;03;10;501;Saint-Marcel-Paulel;436;7;443;31501
76;31;02;14;502;Saint-Marcet;361;9;370;31502
76;31;02;02;503;Saint-Martory;997;11;1008;31503
76;31;02;02;504;Saint-Médard;223;16;239;31504
76;31;01;06;505;Saint-Michel;318;6;324;31505
76;31;03;04;506;Saint-Orens-de-Gameville;12696;229;12925;31506
76;31;03;08;507;Saint-Paul-sur-Save;1622;25;1647;31507
76;31;02;02;508;Saint-Paul-d'Oueil;34;0;34;31508
76;31;02;02;509;Saint-Pé-d'Ardet;155;1;156;31509
76;31;02;14;510;Saint-Pé-Delbosc;141;0;141;31510
76;31;03;10;511;Saint-Pierre;234;8;242;31511
76;31;03;13;512;Saint-Pierre-de-Lages;892;27;919;31512
76;31;02;14;513;Saint-Plancard;392;6;398;31513
76;31;03;13;514;Saint-Rome;59;2;61;31514
76;31;03;27;515;Saint-Rustice;436;9;445;31515
76;31;03;27;516;Saint-Sauveur;1791;16;1807;31516
76;31;01;01;517;Saint-Sulpice-sur-Lèze;2325;61;2386;31517
76;31;01;11;518;Saint-Thomas;576;15;591;31518
76;31;03;13;519;Saint-Vincent;200;8;208;31519
76;31;01;06;520;Sajas;122;3;125;31520
76;31;02;02;521;Saleich;339;8;347;31521
76;31;02;06;522;Salerm;59;2;61;31522
76;31;02;02;523;Salies-du-Salat;1763;106;1869;31523
76;31;02;02;524;Salles-et-Pratviel;129;2;131;31524
76;31;01;01;525;Salles-sur-Garonne;588;14;602;31525
76;31;03;08;526;La Salvetat-Saint-Gilles;8474;194;8668;31526
76;31;03;13;527;La Salvetat-Lauragais;150;3;153;31527
76;31;02;14;528;Saman;123;4;127;31528
76;31;02;06;529;Samouillan;112;2;114;31529
76;31;01;06;530;Sana;249;5;254;31530
76;31;02;14;531;Sarrecave;78;0;78;31531
76;31;02;14;532;Sarremezan;93;0;93;31532
76;31;01;12;533;Saubens;2297;51;2348;31533
76;31;03;13;534;Saussens;208;0;208;31534
76;31;02;02;535;Sauveterre-de-Comminges;682;17;699;31535
76;31;02;14;536;Saux-et-Pomarède;252;8;260;31536
76;31;02;14;537;Savarthès;180;5;185;31537
76;31;01;06;538;Savères;220;4;224;31538
76;31;02;14;539;Sédeilhac;62;3;65;31539
76;31;03;13;540;Ségreville;320;8;328;31540
76;31;03;03;541;Seilh;3284;73;3357;31541
76;31;02;02;542;Seilhan;210;3;213;31542
76;31;01;06;543;Sénarens;113;2;115;31543
76;31;02;02;544;Sengouagnet;215;2;217;31544
76;31;02;02;545;Sepx;210;4;214;31545
76;31;03;07;546;Seyre;130;2;132;31546
76;31;01;09;547;Seysses;9481;124;9605;31547
76;31;02;02;548;Signac;51;0;51;31548
76;31;02;02;549;Sode;19;0;19;31549
76;31;02;02;550;Soueich;523;15;538;31550
76;31;03;13;551;Tarabel;539;17;556;31551
76;31;02;06;552;Terrebasse;138;4;142;31552
76;31;03;08;553;Thil;1146;25;1171;31553
76;31;02;02;554;Touille;238;1;239;31554
76;31;03;99;555;Toulouse;493465;5131;498596;31555
76;31;02;14;556;Les Tourreilles;377;9;386;31556
76;31;03;26;557;Tournefeuille;28117;615;28732;31557
76;31;03;13;558;Toutens;388;5;393;31558
76;31;02;02;559;Trébons-de-Luchon;7;0;7;31559
76;31;03;13;560;Trébons-sur-la-Grasse;475;8;483;31560
76;31;03;23;561;L'Union;11798;164;11962;31561
76;31;02;02;562;Urau;120;1;121;31562
76;31;03;27;563;Vacquiers;1339;37;1376;31563
76;31;02;02;564;Valcabrère;142;1;143;31564
76;31;02;14;565;Valentine;878;15;893;31565
76;31;03;13;566;Vallègue;519;4;523;31566
76;31;03;13;567;Vallesvilles;435;6;441;31567
76;31;03;07;568;Varennes;272;5;277;31568
76;31;03;13;569;Vaudreuille;384;10;394;31569
76;31;03;13;570;Vaux;305;5;310;31570
76;31;03;13;571;Vendine;285;4;289;31571
76;31;01;12;572;Venerque;2702;86;2788;31572
76;31;03;10;573;Verfeil;3658;71;3729;31573
76;31;01;12;574;Vernet;3059;35;3094;31574
76;31;03;04;575;Vieille-Toulouse;1168;37;1205;31575
76;31;03;13;576;Vieillevigne;354;7;361;31576
76;31;03;08;577;Vignaux;144;0;144;31577
76;31;03;04;578;Vigoulet-Auzil;931;31;962;31578
76;31;03;10;579;Villariès;790;13;803;31579
76;31;01;12;580;Villate;1007;21;1028;31580
76;31;03;27;581;Villaudric;1578;32;1610;31581
76;31;03;13;582;Villefranche-de-Lauragais;4806;65;4871;31582
76;31;03;27;583;Villematier;1083;25;1108;31583
76;31;03;27;584;Villemur-sur-Tarn;6034;88;6122;31584
76;31;02;14;585;Villeneuve-de-Rivière;1790;42;1832;31585
76;31;02;14;586;Villeneuve-Lécussan;561;3;564;31586
76;31;03;27;587;Villeneuve-lès-Bouloc;1627;12;1639;31587
76;31;03;26;588;Villeneuve-Tolosane;10050;126;10176;31588
76;31;03;13;589;Villenouvelle;1431;19;1450;31589
76;31;02;02;590;Binos;45;0;45;31590
76;31;02;02;591;Escoulis;79;1;80;31591
76;31;03;08;592;Larra;2046;32;2078;31592
76;31;02;06;593;Cazac;86;0;86;31593
76;32;03;01;001;Aignan;726;54;780;32001
76;32;01;05;002;Ansan;79;5;84;32002
76;32;01;10;003;Antras;46;2;48;32003
76;32;03;01;004;Arblade-le-Bas;136;2;138;32004
76;32;02;12;005;Arblade-le-Haut;322;5;327;32005
76;32;02;11;007;Ardizas;223;5;228;32007
76;32;03;16;008;Armentieux;74;0;74;32008
76;32;03;16;009;Armous-et-Cau;90;1;91;32009
76;32;03;03;010;Arrouède;96;0;96;32010
76;32;01;05;012;Aubiet;1107;29;1136;32012
76;32;01;99;013;Auch;22173;1103;23276;32013
76;32;01;10;014;Augnax;115;5;120;32014
76;32;03;03;015;Aujan-Mournède;89;1;90;32015
76;32;01;13;016;Auradé;672;16;688;32016
76;32;03;01;017;Aurensan;133;5;138;32017
76;32;01;03;018;Aurimont;213;3;216;32018
76;32;01;06;019;Auterive;516;17;533;32019
76;32;03;15;020;Aux-Aussat;275;9;284;32020
76;32;02;11;021;Avensac;74;1;75;32021
76;32;03;01;022;Avéron-Bergelle;165;6;171;32022
76;32;02;09;023;Avezan;112;3;115;32023
76;32;01;07;024;Ayguetinte;162;3;165;32024
76;32;02;12;025;Ayzieu;160;2;162;32025
76;32;02;11;026;Bajonnette;111;0;111;32026
76;32;03;01;027;Barcelonne-du-Gers;1368;38;1406;32027
76;32;03;15;028;Barcugnan;105;3;108;32028
76;32;03;04;029;Barran;664;20;684;32029
76;32;03;16;030;Bars;123;3;126;32030
76;32;02;08;031;Bascous;169;2;171;32031
76;32;03;16;032;Bassoues;319;4;323;32032
76;32;01;08;033;Bazian;107;0;107;32033
76;32;03;15;034;Bazugues;53;3;56;32034
76;32;02;07;035;Beaucaire;241;4;245;32035
76;32;03;16;036;Beaumarchés;661;40;701;32036
76;32;02;02;037;Beaumont;129;7;136;32037
76;32;01;11;038;Beaupuy;206;8;214;32038
76;32;03;15;039;Beccas;119;4;123;32039
76;32;01;03;040;Bédéchan;136;1;137;32040
76;32;03;03;041;Bellegarde;173;4;177;32041
76;32;03;15;042;Belloc-Saint-Clamens;130;4;134;32042
76;32;01;08;043;Belmont;150;4;154;32043
76;32;02;07;044;Béraut;311;9;320;32044
76;32;03;15;045;Berdoues;418;19;437;32045
76;32;03;01;046;Bernède;205;1;206;32046
76;32;02;14;047;Berrac;111;1;112;32047
76;32;01;17;048;Betcave-Aguin;88;0;88;32048
76;32;02;12;049;Bétous;76;3;79;32049
76;32;03;15;050;Betplan;97;4;101;32050
76;32;01;17;051;Bézéril;129;2;131;32051
76;32;01;08;052;Bezolles;137;4;141;32052
76;32;03;03;053;Bézues-Bajon;193;3;196;32053
76;32;01;10;054;Biran;384;9;393;32054
76;32;02;09;055;Bivès;134;2;136;32055
76;32;01;05;056;Blanquefort;49;3;52;32056
76;32;02;07;057;Blaziert;131;3;134;32057
76;32;03;16;058;Blousson-Sérian;41;2;43;32058
76;32;01;10;059;Bonas;135;2;137;32059
76;32;03;06;060;Boucagnères;221;4;225;32060
76;32;01;03;061;Boulaur;186;3;189;32061
76;32;02;12;062;Bourrouillan;162;2;164;32062
76;32;03;01;063;Bouzon-Gellenave;174;8;182;32063
76;32;02;02;064;Bretagne-d'Armagnac;403;12;415;32064
76;32;03;04;065;Le Brouilh-Monbert;249;3;252;32065
76;32;02;09;066;Brugnens;253;12;265;32066
76;32;03;03;067;Cabas-Loumassès;51;4;55;32067
76;32;02;09;068;Cadeilhan;138;3;141;32068
76;32;01;17;069;Cadeillan;66;3;69;32069
76;32;03;01;070;Cahuzac-sur-Adour;211;3;214;32070
76;32;01;08;071;Caillavet;185;9;194;32071
76;32;01;08;072;Callian;49;1;50;32072
76;32;02;12;073;Campagne-d'Armagnac;215;3;218;32073
76;32;02;02;075;Cassaigne;228;4;232;32075
76;32;01;03;076;Castelnau-Barbarens;546;10;556;32076
76;32;03;16;077;Castelnau-d'Anglès;87;2;89;32077
76;32;02;09;078;Castelnau-d'Arbieu;231;9;240;32078
76;32;02;02;079;Castelnau d'Auzan Labarrère;1215;22;1237;32079
76;32;02;07;080;Castelnau-sur-l'Auvignon;143;6;149;32080
76;32;03;01;081;Castelnavet;131;2;133;32081
76;32;02;14;082;Castéra-Lectourois;353;6;359;32082
76;32;01;07;083;Castéra-Verduzan;1006;24;1030;32083
76;32;02;09;084;Castéron;52;2;54;32084
76;32;02;14;085;Castet-Arrouy;173;7;180;32085
76;32;03;15;086;Castex;78;2;80;32086
76;32;02;12;087;Castex-d'Armagnac;121;4;125;32087
76;32;01;08;088;Castillon-Debats;324;0;324;32088
76;32;01;10;089;Castillon-Massas;247;6;253;32089
76;32;01;17;090;Castillon-Savès;341;8;349;32090
76;32;01;10;091;Castin;358;17;375;32091
76;32;02;11;092;Catonvielle;92;4;96;32092
76;32;03;01;093;Caumont;103;7;110;32093
76;32;02;12;094;Caupenne-d'Armagnac;429;16;445;32094
76;32;02;07;095;Caussens;601;12;613;32095
76;32;02;12;096;Cazaubon;1654;36;1690;32096
76;32;01;08;097;Cazaux-d'Anglès;116;2;118;32097
76;32;01;17;098;Cazaux-Savès;323;5;328;32098
76;32;03;16;099;Cazaux-Villecomtal;72;2;74;32099
76;32;02;02;100;Cazeneuve;163;4;167;32100
76;32;02;09;101;Céran;227;3;230;32101
76;32;02;09;102;Cézan;228;2;230;32102
76;32;03;03;103;Chélan;166;8;174;32103
76;32;03;15;104;Clermont-Pouyguillès;162;3;165;32104
76;32;01;13;105;Clermont-Savès;397;11;408;32105
76;32;02;11;106;Cologne;927;70;997;32106
76;32;02;07;107;Condom;6493;206;6699;32107
76;32;03;01;108;Corneillan;153;10;163;32108
76;32;03;16;109;Couloumé-Mondebat;194;5;199;32109
76;32;02;08;110;Courrensan;399;5;404;32110
76;32;03;16;111;Courties;51;0;51;32111
76;32;01;10;112;Crastes;252;12;264;32112
76;32;02;12;113;Cravencères;90;1;91;32113
76;32;03;03;114;Cuélas;123;5;128;32114
76;32;02;08;115;Dému;328;3;331;32115
76;32;03;15;116;Duffort;149;4;153;32116
76;32;01;10;117;Duran;853;28;881;32117
76;32;03;06;118;Durban;138;5;143;32118
76;32;02;02;119;Eauze;3975;71;4046;32119
76;32;02;11;120;Encausse;425;9;434;32120
76;32;01;13;121;Endoufielle;506;16;522;32121
76;32;03;03;122;Esclassan-Labastide;345;10;355;32122
76;32;01;11;123;EscornebÅ“uf;566;13;579;32123
76;32;01;17;124;Espaon;187;0;187;32124
76;32;02;12;125;Espas;125;1;126;32125
76;32;03;15;126;Estampes;161;1;162;32126
76;32;02;12;127;Estang;656;15;671;32127
76;32;03;16;128;Estipouy;204;12;216;32128
76;32;02;09;129;Estramiac;149;0;149;32129
76;32;03;03;130;Faget-Abbatial;217;1;218;32130
76;32;02;14;131;Flamarens;157;2;159;32131
76;32;02;09;132;Fleurance;5924;111;6035;32132
76;32;02;02;133;Fourcès;261;2;263;32133
76;32;01;13;134;Frégouville;344;6;350;32134
76;32;03;01;135;Fustérouau;134;5;139;32135
76;32;03;16;136;Galiax;174;5;179;32136
76;32;01;17;138;Garravet;154;4;158;32138
76;32;02;09;139;Gaudonville;112;1;113;32139
76;32;01;17;140;Gaujac;70;0;70;32140
76;32;01;17;141;Gaujan;115;0;115;32141
76;32;02;09;142;Gavarret-sur-Aulouste;139;2;141;32142
76;32;02;14;143;Gazaupouy;273;11;284;32143
76;32;01;08;144;Gazax-et-Baccarisse;73;0;73;32144
76;32;03;01;145;Gée-Rivière;47;2;49;32145
76;32;02;14;146;Gimbrède;272;4;276;32146
76;32;01;11;147;Gimont;3016;69;3085;32147
76;32;01;11;148;Giscaro;103;0;103;32148
76;32;02;02;149;Gondrin;1201;35;1236;32149
76;32;02;09;150;Goutz;213;6;219;32150
76;32;03;01;151;Goux;63;0;63;32151
76;32;03;15;152;Haget;335;11;346;32152
76;32;03;06;153;Haulies;168;1;169;32153
76;32;02;11;154;Homps;111;1;112;32154
76;32;02;12;155;Le Houga;1161;51;1212;32155
76;32;03;15;156;Idrac-Respaillès;216;4;220;32156
76;32;01;05;157;L'Isle-Arné;190;3;193;32157
76;32;02;14;158;L'Isle-Bouzon;241;10;251;32158
76;32;03;16;159;L'Isle-de-Noé;550;14;564;32159
76;32;01;13;160;L'Isle-Jourdain;9072;222;9294;32160
76;32;03;16;161;Izotges;91;4;95;32161
76;32;01;10;162;Jegun;1147;50;1197;32162
76;32;03;16;163;Jû-Belloc;295;9;304;32163
76;32;03;16;164;Juillac;115;2;117;32164
76;32;01;05;165;Juilles;219;6;225;32165
76;32;01;08;166;Justian;121;1;122;32166
76;32;03;15;167;Laas;308;5;313;32167
76;32;03;03;169;Labarthe;147;4;151;32169
76;32;03;01;170;Labarthète;141;3;144;32170
76;32;01;17;171;Labastide-Savès;179;1;180;32171
76;32;03;15;172;Labéjan;295;15;310;32172
76;32;02;11;173;Labrihe;213;8;221;32173
76;32;03;16;174;Ladevèze-Rivière;222;4;226;32174
76;32;03;16;175;Ladevèze-Ville;220;7;227;32175
76;32;02;14;176;Lagarde;122;5;127;32176
76;32;03;15;177;Lagarde-Hachan;168;5;173;32177
76;32;02;07;178;Lagardère;77;3;80;32178
76;32;02;02;180;Lagraulet-du-Gers;562;9;571;32180
76;32;03;15;181;Laguian-Mazous;245;2;247;32181
76;32;01;17;182;Lahas;180;6;186;32182
76;32;01;05;183;Lahitte;232;11;243;32183
76;32;02;09;184;Lalanne;131;3;134;32184
76;32;03;03;185;Lalanne-Arqué;153;4;157;32185
76;32;03;03;186;Lamaguère;80;0;80;32186
76;32;03;15;187;Lamazère;119;7;126;32187
76;32;02;09;188;Lamothe-Goas;78;3;81;32188
76;32;02;12;189;Lannemaignan;106;3;109;32189
76;32;02;08;190;Lannepax;507;6;513;32190
76;32;02;12;191;Lanne-Soubiran;145;1;146;32191
76;32;03;01;192;Lannux;234;7;241;32192
76;32;02;12;193;Larée;233;3;236;32193
76;32;02;02;194;Larressingle;208;7;215;32194
76;32;02;14;195;Larroque-Engalin;45;2;47;32195
76;32;02;07;196;Larroque-Saint-Sernin;165;0;165;32196
76;32;02;02;197;Larroque-sur-l'Osse;223;6;229;32197
76;32;01;03;198;Lartigue;193;4;197;32198
76;32;03;16;199;Lasserrade;190;9;199;32199
76;32;03;04;200;Lasséran;372;11;383;32200
76;32;03;06;201;Lasseube-Propre;339;7;346;32201
76;32;02;12;202;Laujuzan;280;15;295;32202
76;32;02;02;203;LauraÃ«t;253;3;256;32203
76;32;01;10;204;Lavardens;369;11;380;32204
76;32;03;16;205;LaveraÃ«t;107;1;108;32205
76;32;01;17;206;Laymont;213;3;216;32206
76;32;01;05;207;Leboulin;342;17;359;32207
76;32;02;14;208;Lectoure;3672;355;4027;32208
76;32;03;01;209;Lelin-Lapujolle;283;3;286;32209
76;32;01;13;210;Lias;736;15;751;32210
76;32;02;12;211;Lias-d'Armagnac;195;7;202;32211
76;32;02;14;212;Ligardes;215;4;219;32212
76;32;01;17;213;Lombez;2156;36;2192;32213
76;32;02;12;214;Loubédat;101;3;104;32214
76;32;03;15;215;Loubersan;146;10;156;32215
76;32;03;03;216;Lourties-Monbrun;166;1;167;32216
76;32;03;16;217;Louslitges;61;2;63;32217
76;32;03;01;218;Loussous-Débat;63;0;63;32218
76;32;01;08;219;Lupiac;307;11;318;32219
76;32;02;12;220;Luppé-Violles;142;3;145;32220
76;32;01;05;221;Lussan;236;3;239;32221
76;32;02;12;222;Magnan;234;3;237;32222
76;32;02;09;223;Magnas;60;31;91;32223
76;32;02;07;224;Maignaut-Tauzia;234;2;236;32224
76;32;03;15;225;Malabat;104;5;109;32225
76;32;03;15;226;Manas-Bastanous;82;5;87;32226
76;32;02;12;227;Manciet;804;27;831;32227
76;32;03;03;228;Manent-Montané;92;1;93;32228
76;32;02;11;229;Mansempuy;71;8;79;32229
76;32;02;02;230;Mansencôme;46;4;50;32230
76;32;01;08;231;Marambat;437;14;451;32231
76;32;02;11;232;Maravat;41;0;41;32232
76;32;03;16;233;Marciac;1208;85;1293;32233
76;32;01;13;234;Marestaing;330;7;337;32234
76;32;03;01;235;MargouÃ«t-Meymes;161;8;169;32235
76;32;02;12;236;Marguestau;65;3;68;32236
76;32;01;05;237;Marsan;483;11;494;32237
76;32;03;15;238;Marseillan;86;3;89;32238
76;32;02;14;239;Marsolan;448;11;459;32239
76;32;03;16;240;Mascaras;63;4;67;32240
76;32;02;14;241;Mas-d'Auvignon;170;6;176;32241
76;32;03;03;242;Masseube;1498;397;1895;32242
76;32;02;12;243;Mauléon-d'Armagnac;269;3;272;32243
76;32;03;01;244;Maulichères;164;4;168;32244
76;32;03;01;245;Maumusson-Laguian;147;7;154;32245
76;32;02;12;246;Maupas;201;3;204;32246
76;32;01;11;247;Maurens;309;7;316;32247
76;32;02;09;248;Mauroux;144;4;148;32248
76;32;02;11;249;Mauvezin;2218;50;2268;32249
76;32;03;03;250;Meilhan;77;1;78;32250
76;32;01;10;251;Mérens;69;0;69;32251
76;32;03;15;252;Miélan;1111;20;1131;32252
76;32;02;14;253;Miradoux;525;12;537;32253
76;32;03;15;254;Miramont-d'Astarac;345;14;359;32254
76;32;02;09;255;Miramont-Latour;155;5;160;32255
76;32;03;15;256;Mirande;3450;301;3751;32256
76;32;01;08;257;Mirannes;61;4;65;32257
76;32;01;10;258;Mirepoix;230;5;235;32258
76;32;03;03;260;Monbardon;76;4;80;32260
76;32;01;17;261;Monblanc;370;7;377;32261
76;32;02;11;262;Monbrun;394;14;408;32262
76;32;03;15;263;Moncassin;127;3;130;32263
76;32;02;12;264;Monclar;211;3;214;32264
76;32;03;16;265;Monclar-sur-Losse;108;2;110;32265
76;32;03;03;266;Moncorneil-Grazan;145;1;146;32266
76;32;03;03;267;Monferran-Plavès;113;2;115;32267
76;32;01;13;268;Monferran-Savès;811;29;840;32268
76;32;02;11;269;Monfort;496;4;500;32269
76;32;01;17;270;Mongausy;84;1;85;32270
76;32;02;12;271;Monguilhem;298;8;306;32271
76;32;03;03;272;Monlaur-Bernet;167;3;170;32272
76;32;03;16;273;Monlezun;179;11;190;32273
76;32;02;12;274;Monlezun-d'Armagnac;205;3;208;32274
76;32;03;16;275;Monpardiac;45;1;46;32275
76;32;01;17;276;Montadet;71;1;72;32276
76;32;01;17;277;Montamat;121;3;124;32277
76;32;03;15;278;Montaut;118;7;125;32278
76;32;01;10;279;Montaut-les-Créneaux;710;19;729;32279
76;32;03;03;280;Mont-d'Astarac;94;2;96;32280
76;32;03;15;281;Mont-de-Marrast;107;5;112;32281
76;32;01;05;282;Montégut;677;12;689;32282
76;32;03;15;283;Montégut-Arros;284;7;291;32283
76;32;01;17;284;Montégut-Savès;63;1;64;32284
76;32;03;16;285;Montesquiou;572;18;590;32285
76;32;02;09;286;Montestruc-sur-Gers;701;11;712;32286
76;32;03;03;287;Monties;79;1;80;32287
76;32;01;05;288;Montiron;145;3;148;32288
76;32;01;17;289;Montpézat;239;4;243;32289
76;32;02;02;290;Montréal;1171;34;1205;32290
76;32;02;12;291;Mormès;120;2;122;32291
76;32;02;02;292;Mouchan;397;13;410;32292
76;32;03;16;293;Mouchès;74;2;76;32293
76;32;01;08;294;Mourède;75;3;78;32294
76;32;01;17;295;Nizas;138;8;146;32295
76;32;02;12;296;Nogaro;2027;165;2192;32296
76;32;01;17;297;Noilhan;378;11;389;32297
76;32;01;05;298;Nougaroulet;372;12;384;32298
76;32;02;08;299;Noulens;101;0;101;32299
76;32;03;06;300;Orbessan;294;3;297;32300
76;32;01;10;301;Ordan-Larroque;895;24;919;32301
76;32;03;06;302;Ornézan;226;11;237;32302
76;32;03;16;303;Pallanne;62;2;64;32303
76;32;03;03;304;Panassac;290;9;299;32304
76;32;02;12;305;Panjas;412;8;420;32305
76;32;02;09;306;Pauilhac;615;48;663;32306
76;32;01;04;307;Pavie;2501;119;2620;32307
76;32;01;17;308;Pébées;108;2;110;32308
76;32;01;17;309;Pellefigue;114;5;119;32309
76;32;02;12;310;Perchède;123;1;124;32310
76;32;02;14;311;Pergain-Taillac;325;6;331;32311
76;32;01;06;312;Pessan;672;14;686;32312
76;32;02;09;313;Pessoulens;139;4;143;32313
76;32;02;14;314;Peyrecave;75;5;80;32314
76;32;01;08;315;Peyrusse-Grande;156;2;158;32315
76;32;01;10;316;Peyrusse-Massas;106;3;109;32316
76;32;01;08;317;Peyrusse-Vieille;67;1;68;32317
76;32;02;09;318;Pis;111;2;113;32318
76;32;03;16;319;Plaisance;1429;26;1455;32319
76;32;02;14;320;Plieux;150;7;157;32320
76;32;01;17;321;Polastron;273;5;278;32321
76;32;01;17;322;Pompiac;203;3;206;32322
76;32;03;15;323;Ponsampère;108;5;113;32323
76;32;03;03;324;Ponsan-Soubiran;80;3;83;32324
76;32;03;01;325;Pouydraguin;130;3;133;32325
76;32;03;16;326;Pouylebon;145;4;149;32326
76;32;03;03;327;Pouy-Loubrin;85;1;86;32327
76;32;02;14;328;Pouy-Roquelaure;120;6;126;32328
76;32;02;09;329;Préchac;163;3;166;32329
76;32;03;16;330;Préchac-sur-Adour;195;5;200;32330
76;32;01;10;331;Preignan;1250;35;1285;32331
76;32;01;08;332;Préneron;126;1;127;32332
76;32;03;01;333;Projan;182;0;182;32333
76;32;01;13;334;Pujaudran;1578;39;1617;32334
76;32;01;10;335;Puycasquier;447;9;456;32335
76;32;01;17;336;Puylausic;160;9;169;32336
76;32;02;09;337;Puységur;74;3;77;32337
76;32;02;08;338;Ramouzens;168;5;173;32338
76;32;01;11;339;Razengues;245;9;254;32339
76;32;02;12;340;Réans;286;3;289;32340
76;32;02;09;341;Réjaumont;245;4;249;32341
76;32;03;16;342;Ricourt;57;2;59;32342
76;32;01;08;343;Riguepeu;175;7;182;32343
76;32;03;01;344;Riscle;1829;100;1929;32344
76;32;02;14;345;La Romieu;568;15;583;32345
76;32;01;08;346;Roquebrune;212;5;217;32346
76;32;01;10;347;Roquefort;283;7;290;32347
76;32;01;10;348;Roquelaure;562;23;585;32348
76;32;02;11;349;Roquelaure-Saint-Aubin;103;4;107;32349
76;32;02;07;350;Roquepine;33;2;35;32350
76;32;01;08;351;Roques;108;1;109;32351
76;32;01;08;352;Rozès;115;4;119;32352
76;32;01;17;353;Sabaillan;146;7;153;32353
76;32;03;01;354;Sabazan;138;1;139;32354
76;32;03;15;355;Sadeillan;86;2;88;32355
76;32;01;17;356;Saint-André;127;1;128;32356
76;32;02;11;357;Sainte-Anne;128;1;129;32357
76;32;02;14;358;Saint-Antoine;190;4;194;32358
76;32;02;11;359;Saint-Antonin;154;5;159;32359
76;32;01;08;360;Saint-Arailles;139;3;142;32360
76;32;03;03;361;Saint-Arroman;136;8;144;32361
76;32;03;16;362;Saint-Aunix-Lengros;143;3;146;32362
76;32;03;15;363;Sainte-Aurence-Cazaux;95;4;99;32363
76;32;02;14;364;Saint-Avit-Frandat;95;3;98;32364
76;32;03;03;365;Saint-Blancard;335;6;341;32365
76;32;02;11;366;Saint-Brès;74;1;75;32366
76;32;03;16;367;Saint-Christaud;64;2;66;32367
76;32;01;10;368;Sainte-Christie;544;11;555;32368
76;32;02;12;369;Sainte-Christie-d'Armagnac;376;12;388;32369
76;32;02;09;370;Saint-Clar;1046;66;1112;32370
76;32;02;09;371;Saint-Créac;80;1;81;32371
76;32;02;11;372;Saint-Cricq;288;4;292;32372
76;32;03;15;373;Sainte-Dode;204;10;214;32373
76;32;01;17;374;Saint-Elix-d'Astarac;181;6;187;32374
76;32;03;15;375;Saint-Elix-Theux;95;4;99;32375
76;32;02;11;376;Sainte-Gemme;114;3;117;32376
76;32;02;11;377;Saint-Georges;179;1;180;32377
76;32;03;01;378;Saint-Germé;499;6;505;32378
76;32;02;11;379;Saint-Germier;208;7;215;32379
76;32;02;12;380;Saint-Griède;138;10;148;32380
76;32;03;04;381;Saint-Jean-le-Comtal;411;20;431;32381
76;32;01;08;382;Saint-Jean-Poutge;309;14;323;32382
76;32;03;16;383;Saint-Justin;127;6;133;32383
76;32;01;10;384;Saint-Lary;278;6;284;32384
76;32;02;09;385;Saint-Léonard;184;1;185;32385
76;32;01;17;386;Saint-Lizier-du-Planté;143;1;144;32386
76;32;01;17;387;Saint-Loube;101;2;103;32387
76;32;01;11;388;Sainte-Marie;439;7;446;32388
76;32;03;15;389;Saint-Martin;457;20;477;32389
76;32;02;12;390;Saint-Martin-d'Armagnac;240;5;245;32390
76;32;02;14;391;Saint-Martin-de-Goyne;122;7;129;32391
76;32;01;03;392;Saint-Martin-Gimois;88;1;89;32392
76;32;03;15;393;Saint-Maur;137;5;142;32393
76;32;03;15;394;Saint-Médard;338;5;343;32394
76;32;02;14;395;Sainte-Mère;209;4;213;32395
76;32;02;14;396;Saint-Mézard;234;3;237;32396
76;32;03;15;397;Saint-Michel;244;14;258;32397
76;32;03;01;398;Saint-Mont;315;10;325;32398
76;32;02;11;399;Saint-Orens;81;3;84;32399
76;32;02;07;400;Saint-Orens-Pouy-Petit;208;9;217;32400
76;32;03;15;401;Saint-Ost;89;1;90;32401
76;32;01;08;402;Saint-Paul-de-BaÃ¯se;106;3;109;32402
76;32;01;08;403;Saint-Pierre-d'Aubézies;61;1;62;32403
76;32;02;07;404;Saint-Puy;589;15;604;32404
76;32;02;09;405;Sainte-Radegonde;178;6;184;32405
76;32;01;11;406;Saint-Sauvy;355;10;365;32406
76;32;01;17;407;Saint-Soulan;160;4;164;32407
76;32;02;12;408;Salles-d'Armagnac;134;4;138;32408
76;32;03;03;409;Samaran;91;0;91;32409
76;32;01;17;410;Samatan;2328;102;2430;32410
76;32;03;06;411;Sansan;100;3;103;32411
76;32;01;03;412;Saramon;842;14;856;32412
76;32;03;03;413;Sarcos;82;2;84;32413
76;32;03;01;414;Sarragachies;231;6;237;32414
76;32;03;15;415;Sarraguzan;90;1;91;32415
76;32;02;11;416;Sarrant;361;15;376;32416
76;32;02;09;417;La Sauvetat;403;13;416;32417
76;32;01;17;418;Sauveterre;279;64;343;32418
76;32;03;15;419;Sauviac;106;3;109;32419
76;32;01;17;420;Sauvimont;66;2;68;32420
76;32;01;17;421;Savignac-Mona;139;1;140;32421
76;32;03;16;422;Scieurac-et-Flourès;43;1;44;32422
76;32;02;08;423;Séailles;57;3;60;32423
76;32;03;01;424;Ségos;225;8;233;32424
76;32;01;13;425;Ségoufielle;1168;28;1196;32425
76;32;03;03;426;Seissan;1096;10;1106;32426
76;32;03;16;427;Sembouès;60;1;61;32427
76;32;01;03;428;Sémézies-Cachan;66;4;70;32428
76;32;02;14;429;Sempesserre;296;5;301;32429
76;32;03;03;430;Sère;80;0;80;32430
76;32;02;11;431;Sérempuy;39;4;43;32431
76;32;01;17;432;Seysses-Savès;242;2;244;32432
76;32;01;17;433;Simorre;711;17;728;32433
76;32;02;12;434;Sion;97;3;100;32434
76;32;02;11;435;Sirac;167;9;176;32435
76;32;02;11;436;Solomiac;482;6;488;32436
76;32;02;12;437;Sorbets;227;6;233;32437
76;32;03;03;438;Tachoires;101;0;101;32438
76;32;03;01;439;Tarsac;169;2;171;32439
76;32;03;16;440;Tasque;250;6;256;32440
76;32;02;09;441;Taybosc;61;0;61;32441
76;32;02;14;442;Terraube;381;4;385;32442
76;32;03;01;443;Termes-d'Armagnac;186;3;189;32443
76;32;02;11;444;Thoux;260;7;267;32444
76;32;03;16;445;Tieste-Uragnoux;156;5;161;32445
76;32;03;16;446;Tillac;285;6;291;32446
76;32;01;03;447;Tirent-Pontéjac;91;1;92;32447
76;32;02;11;448;Touget;507;16;523;32448
76;32;02;12;449;Toujouse;272;2;274;32449
76;32;03;16;450;Tourdun;128;4;132;32450
76;32;01;17;451;Tournan;182;2;184;32451
76;32;02;09;452;Tournecoupe;260;8;268;32452
76;32;01;10;453;Tourrenquets;111;6;117;32453
76;32;03;03;454;Traversères;69;3;72;32454
76;32;03;16;455;Troncens;183;5;188;32455
76;32;01;08;456;Tudelle;53;0;53;32456
76;32;02;09;457;Urdens;282;13;295;32457
76;32;02;12;458;Urgosse;233;3;236;32458
76;32;02;07;459;Valence-sur-BaÃ¯se;1122;20;1142;32459
76;32;03;01;460;Vergoignan;306;8;314;32460
76;32;03;01;461;Verlus;114;3;117;32461
76;32;01;08;462;Vic-Fezensac;3546;61;3607;32462
76;32;03;01;463;Viella;511;11;522;32463
76;32;03;15;464;Villecomtal-sur-Arros;840;20;860;32464
76;32;01;17;465;Villefranche;123;5;128;32465
76;32;03;15;466;Viozan;114;2;116;32466
76;32;01;05;467;Saint-Caprais;142;4;146;32467
76;32;03;03;468;Aussos;84;0;84;32468
75;33;05;21;001;Abzac;1982;26;2008;33001
75;33;03;27;002;Aillas;834;14;848;33002
75;33;02;26;003;Ambarès-et-Lagrave;16636;156;16792;33003
75;33;02;26;004;Ambès;3053;19;3072;33004
75;33;06;01;005;Andernos-les-Bains;12242;275;12517;33005
75;33;01;13;006;Anglade;931;12;943;33006
75;33;03;15;007;Arbanats;1335;7;1342;33007
75;33;03;12;008;Porte-de-Benauge;489;8;497;33008
75;33;06;32;009;Arcachon;11630;268;11898;33009
75;33;04;30;010;Arcins;529;7;536;33010
75;33;06;01;011;Arès;6381;122;6503;33011
75;33;04;30;012;Arsac;3747;48;3795;33012
75;33;02;17;013;Artigues-près-Bordeaux;8656;79;8735;33013
75;33;05;21;014;Les Artigues-de-Lussac;1110;21;1131;33014
75;33;05;16;015;Arveyres;1992;41;2033;33015
75;33;05;16;016;Asques;443;9;452;33016
75;33;03;29;017;Aubiac;276;11;287;33017
75;33;01;20;018;Val de Virvée;3621;42;3663;33018
75;33;06;01;019;Audenge;8680;121;8801;33019
75;33;03;27;020;Auriolles;143;0;143;33020
75;33;03;27;021;Auros;1049;14;1063;33021
75;33;04;30;022;Avensan;3018;41;3059;33022
75;33;02;08;023;Ayguemorte-les-Graves;1332;16;1348;33023
75;33;03;27;024;Bagas;301;9;310;33024
75;33;03;12;025;Baigneaux;450;4;454;33025
75;33;03;15;026;Balizac;497;5;502;33026
75;33;03;27;027;Barie;289;9;298;33027
75;33;05;10;028;Baron;1170;16;1186;33028
75;33;06;15;029;Le Barp;5605;81;5686;33029
75;33;03;15;030;Barsac;2074;22;2096;33030
75;33;03;27;031;Bassanne;131;5;136;33031
75;33;02;17;032;Bassens;7472;61;7533;33032
75;33;02;11;033;Baurech;919;7;926;33033
75;33;05;21;034;Bayas;460;4;464;33034
75;33;01;13;035;Bayon-sur-Gironde;721;2;723;33035
75;33;03;29;036;Bazas;4801;256;5057;33036
75;33;02;08;037;Beautiran;2330;39;2369;33037
75;33;04;22;038;Bégadan;915;8;923;33038
75;33;02;96;039;Bègles;30642;349;30991;33039
75;33;03;12;040;Béguey;1202;13;1215;33040
75;33;06;15;042;Belin-Béliet;5732;93;5825;33042
75;33;03;12;043;Bellebat;278;1;279;33043
75;33;03;12;044;Bellefond;220;6;226;33044
75;33;05;10;045;Belvès-de-Castillon;335;8;343;33045
75;33;03;29;046;Bernos-Beaulac;1125;30;1155;33046
75;33;01;13;047;Berson;1812;31;1843;33047
75;33;03;27;048;Berthez;266;7;273;33048
75;33;02;26;049;Beychac-et-Caillau;2489;27;2516;33049
75;33;03;29;050;Bieujac;639;8;647;33050
75;33;06;01;051;Biganos;10990;123;11113;33051
75;33;05;16;052;Les Billaux;1148;35;1183;33052
75;33;03;29;053;Birac;229;1;230;33053
75;33;03;27;054;Blaignac;286;5;291;33054
75;33;04;22;055;Blaignan-Prignac;464;4;468;33055
75;33;02;25;056;Blanquefort;15419;605;16024;33056
75;33;03;27;057;Blasimon;909;20;929;33057
75;33;01;13;058;Blaye;4838;112;4950;33058
75;33;02;12;059;Blésignac;306;6;312;33059
75;33;03;29;060;Bommes;454;67;521;33060
75;33;02;11;061;Bonnetan;990;19;1009;33061
75;33;05;21;062;Bonzac;742;12;754;33062
75;33;02;97;063;Bordeaux;260958;3299;264257;33063
75;33;05;10;064;Bossugan;38;0;38;33064
75;33;02;09;065;Bouliac;3706;72;3778;33065
75;33;03;27;066;Bourdelles;90;1;91;33066
75;33;01;13;067;Bourg;2278;38;2316;33067
75;33;03;29;068;Bourideys;93;3;96;33068
75;33;02;07;069;Le Bouscat;23890;277;24167;33069
75;33;04;30;070;Brach;786;2;788;33070
75;33;05;10;071;Branne;1307;17;1324;33071
75;33;03;27;072;Brannens;241;4;245;33072
75;33;01;13;073;Braud-et-Saint-Louis;1535;29;1564;33073
75;33;03;27;074;Brouqueyran;202;8;210;33074
75;33;02;07;075;Bruges;19403;187;19590;33075
75;33;03;15;076;Budos;808;14;822;33076
75;33;02;08;077;Cabanac-et-Villagrains;2413;26;2439;33077
75;33;05;10;078;Cabara;507;12;519;33078
75;33;05;16;079;Cadarsac;356;7;363;33079
75;33;02;08;080;Cadaujac;6464;70;6534;33080
75;33;03;12;081;Cadillac;2836;28;2864;33081
75;33;05;16;082;Cadillac-en-Fronsadais;1331;16;1347;33082
75;33;02;11;083;Camarsac;1019;13;1032;33083
75;33;02;11;084;Cambes;1732;17;1749;33084
75;33;02;11;085;Camblanes-et-Meynac;2984;142;3126;33085
75;33;05;10;086;Camiac-et-Saint-Denis;360;5;365;33086
75;33;03;27;087;Camiran;414;5;419;33087
75;33;05;21;088;Camps-sur-l'Isle;598;10;608;33088
75;33;01;13;089;Campugnan;503;6;509;33089
75;33;02;23;090;Canéjan;6061;73;6134;33090
75;33;03;12;093;Capian;775;17;792;33093
75;33;05;27;094;Caplong;217;7;224;33094
75;33;03;29;095;Captieux;1358;21;1379;33095
75;33;02;26;096;Carbon-Blanc;8254;82;8336;33096
75;33;04;30;097;Carcans;2418;36;2454;33097
75;33;03;12;098;Cardan;509;5;514;33098
75;33;02;11;099;Carignan-de-Bordeaux;4141;43;4184;33099
75;33;01;13;100;Cars;1201;21;1222;33100
75;33;01;13;101;Cartelègue;1233;21;1254;33101
75;33;03;27;102;Casseuil;383;4;387;33102
75;33;03;27;103;Castelmoron-d'Albret;53;0;53;33103
75;33;04;30;104;Castelnau-de-Médoc;4804;65;4869;33104
75;33;03;27;105;Castelviel;222;12;234;33105
75;33;03;29;106;Castets et Castillon;1454;19;1473;33106
75;33;05;10;108;Castillon-la-Bataille;3194;35;3229;33108
75;33;02;08;109;Castres-Gironde;2391;19;2410;33109
75;33;03;12;111;Caudrot;1117;15;1132;33111
75;33;03;27;112;Caumont;142;2;144;33112
75;33;03;29;113;Cauvignac;154;3;157;33113
75;33;01;20;114;Cavignac;2198;15;2213;33114
75;33;03;29;115;Cazalis;236;1;237;33115
75;33;03;29;116;Cazats;409;5;414;33116
75;33;03;27;117;Cazaugitat;225;3;228;33117
75;33;02;11;118;Cénac;2082;34;2116;33118
75;33;02;09;119;Cenon;25496;227;25723;33119
75;33;03;15;120;Cérons;2138;20;2158;33120
75;33;03;12;121;Cessac;190;2;192;33121
75;33;02;23;122;Cestas;17053;276;17329;33122
75;33;01;20;123;Cézac;2654;33;2687;33123
75;33;05;21;124;Chamadelle;727;15;742;33124
75;33;04;22;125;Cissac-Médoc;2191;27;2218;33125
75;33;01;20;126;Civrac-de-Blaye;860;22;882;33126
75;33;05;10;127;Civrac-sur-Dordogne;222;5;227;33127
75;33;04;22;128;Civrac-en-Médoc;659;14;673;33128
75;33;03;27;129;Cleyrac;155;0;155;33129
75;33;03;27;130;Coimères;1035;27;1062;33130
75;33;03;12;131;Coirac;209;2;211;33131
75;33;01;13;132;Comps;550;8;558;33132
75;33;05;10;133;Coubeyrac;72;1;73;33133
75;33;04;22;134;Couquèques;271;7;278;33134
75;33;03;12;135;Courpiac;128;2;130;33135
75;33;03;27;136;Cours-de-Monségur;283;4;287;33136
75;33;03;29;137;Cours-les-Bains;221;4;225;33137
75;33;05;21;138;Coutras;8602;130;8732;33138
75;33;03;27;139;Coutures;98;3;101;33139
75;33;02;11;140;Créon;4832;100;4932;33140
75;33;02;11;141;Croignon;691;9;700;33141
75;33;01;20;142;Cubnezais;1650;16;1666;33142
75;33;01;20;143;Cubzac-les-Ponts;2501;26;2527;33143
75;33;03;29;144;Cudos;792;130;922;33144
75;33;02;11;145;Cursan;659;18;677;33145
75;33;04;30;146;Cussac-Fort-Médoc;2330;28;2358;33146
75;33;05;10;147;Daignac;470;6;476;33147
75;33;05;10;148;Dardenac;88;5;93;33148
75;33;03;27;149;Daubèze;154;1;155;33149
75;33;03;27;150;Dieulivol;340;2;342;33150
75;33;01;20;151;Donnezac;915;18;933;33151
75;33;03;12;152;Donzac;119;5;124;33152
75;33;05;10;153;Doulezon;266;4;270;33153
75;33;05;21;154;Les Eglisottes-et-Chalaures;2142;101;2243;33154
75;33;03;29;155;Escaudes;158;4;162;33155
75;33;03;12;156;Escoussans;288;8;296;33156
75;33;05;10;157;Espiet;792;15;807;33157
75;33;03;27;158;Les Esseintes;240;8;248;33158
75;33;01;13;159;Etauliers;1481;14;1495;33159
75;33;05;27;160;Eynesse;587;17;604;33160
75;33;01;13;161;Eyrans;764;6;770;33161
75;33;02;25;162;Eysines;24488;264;24752;33162
75;33;03;12;163;Faleyras;433;6;439;33163
75;33;03;29;164;Fargues;1651;34;1685;33164
75;33;02;11;165;Fargues-Saint-Hilaire;3203;34;3237;33165
75;33;05;21;166;Le Fieu;510;4;514;33166
75;33;02;09;167;Floirac;18181;97;18278;33167
75;33;05;10;168;Flaujagues;587;9;596;33168
75;33;03;27;169;Floudès;109;4;113;33169
75;33;03;27;170;Fontet;789;16;805;33170
75;33;03;27;171;Fossès-et-Baleyssac;231;3;234;33171
75;33;01;13;172;Fours;287;13;300;33172
75;33;05;21;173;Francs;188;7;195;33173
75;33;05;16;174;Fronsac;1142;34;1176;33174
75;33;03;12;175;Frontenac;739;10;749;33175
75;33;03;12;176;Gabarnac;352;7;359;33176
75;33;04;22;177;Gaillan-en-Médoc;2344;42;2386;33177
75;33;03;29;178;Gajac;373;3;376;33178
75;33;05;16;179;Galgon;3022;55;3077;33179
75;33;03;29;180;Gans;190;8;198;33180
75;33;05;10;181;Gardegan-et-Tourtirac;280;4;284;33181
75;33;01;13;182;Gauriac;730;16;746;33182
75;33;01;20;183;Gauriaguet;1382;15;1397;33183
75;33;01;20;184;Générac;541;11;552;33184
75;33;05;10;185;Génissac;1987;36;2023;33185
75;33;05;10;186;Gensac;710;10;720;33186
75;33;03;27;187;Gironde-sur-Dropt;1316;24;1340;33187
75;33;03;29;188;Giscos;183;3;186;33188
75;33;03;12;189;Gornac;430;10;440;33189
75;33;03;29;190;Goualade;88;1;89;33190
75;33;05;21;191;Gours;586;4;590;33191
75;33;02;24;192;Gradignan;25694;334;26028;33192
75;33;04;22;193;Grayan-et-l'Hôpital;1486;23;1509;33193
75;33;05;10;194;Grézillac;698;15;713;33194
75;33;03;29;195;Grignols;1197;8;1205;33195
75;33;05;10;196;Guillac;160;4;164;33196
75;33;03;15;197;Guillos;451;6;457;33197
75;33;05;21;198;Guîtres;1591;35;1626;33198
75;33;06;14;199;Gujan-Mestras;21887;447;22334;33199
75;33;02;18;200;Le Haillan;11539;189;11728;33200
75;33;02;12;201;Haux;833;18;851;33201
75;33;03;15;202;Hostens;1433;18;1451;33202
75;33;04;30;203;Hourtin;3813;67;3880;33203
75;33;03;27;204;Hure;542;7;549;33204
75;33;03;15;205;Illats;1377;21;1398;33205
75;33;02;08;206;Isle-Saint-Georges;523;3;526;33206
75;33;05;16;207;Izon;6167;68;6235;33207
75;33;04;22;208;Jau-Dignac-et-Loirac;957;10;967;33208
75;33;05;10;209;Jugazan;283;7;290;33209
75;33;05;10;210;Juillac;229;4;233;33210
75;33;04;30;211;Labarde;599;2;601;33211
75;33;03;29;212;Labescau;124;1;125;33212
75;33;02;08;213;La Brède;4420;491;4911;33213
75;33;04;30;214;Lacanau;5070;72;5142;33214
75;33;03;12;215;Ladaux;194;6;200;33215
75;33;03;27;216;Lados;171;5;176;33216
75;33;05;21;218;Lagorce;1667;16;1683;33218
75;33;05;16;219;La Lande-de-Fronsac;2540;25;2565;33219
75;33;04;30;220;Lamarque;1323;12;1335;33220
75;33;03;27;221;Lamothe-Landerron;1166;23;1189;33221
75;33;05;16;222;Lalande-de-Pomerol;659;15;674;33222
75;33;03;27;223;Landerrouat;218;3;221;33223
75;33;03;27;224;Landerrouet-sur-Ségur;100;0;100;33224
75;33;03;15;225;Landiras;2195;37;2232;33225
75;33;03;12;226;Langoiran;2154;31;2185;33226
75;33;03;29;227;Langon;7357;146;7503;33227
75;33;01;13;228;Lansac;701;10;711;33228
75;33;06;01;229;Lanton;7285;139;7424;33229
75;33;05;21;230;Lapouyade;507;10;517;33230
75;33;03;12;231;Laroque;287;4;291;33231
75;33;03;29;232;Lartigue;39;0;39;33232
75;33;01;20;233;Laruscade;2844;21;2865;33233
75;33;02;11;234;Latresne;3523;146;3669;33234
75;33;03;29;235;Lavazan;230;2;232;33235
75;33;06;01;236;Lège-Cap-Ferret;8352;170;8522;33236
75;33;03;29;237;Léogeats;820;20;840;33237
75;33;02;08;238;Léognan;10571;173;10744;33238
75;33;03;29;239;Lerm-et-Musset;478;5;483;33239
75;33;04;22;240;Lesparre-Médoc;5808;99;5907;33240
75;33;03;12;241;Lestiac-sur-Garonne;571;8;579;33241
75;33;05;27;242;Les Lèves-et-Thoumeyragues;555;10;565;33242
75;33;05;16;243;Libourne;24257;544;24801;33243
75;33;03;29;244;Lignan-de-Bazas;439;8;447;33244
75;33;02;11;245;Lignan-de-Bordeaux;811;15;826;33245
75;33;05;27;246;Ligueux;150;6;156;33246
75;33;03;27;247;Listrac-de-Durèze;176;3;179;33247
75;33;04;30;248;Listrac-Médoc;2788;39;2827;33248
75;33;02;17;249;Lormont;23181;317;23498;33249
75;33;03;27;250;Loubens;313;8;321;33250
75;33;03;15;251;Louchats;730;9;739;33251
75;33;02;11;252;Loupes;834;12;846;33252
75;33;03;12;253;Loupiac;1118;10;1128;33253
75;33;03;27;254;Loupiac-de-la-Réole;510;8;518;33254
75;33;03;29;255;Lucmau;244;3;247;33255
75;33;02;25;256;Ludon-Médoc;5131;45;5176;33256
75;33;05;10;257;Lugaignac;496;6;502;33257
75;33;03;12;258;Lugasson;304;7;311;33258
75;33;05;16;259;Lugon-et-l'ÃŽle-du-Carnay;1346;24;1370;33259
75;33;06;15;260;Lugos;974;21;995;33260
75;33;05;21;261;Lussac;1240;38;1278;33261
75;33;02;30;262;Macau;4410;25;4435;33262
75;33;02;11;263;Madirac;277;4;281;33263
75;33;05;21;264;Maransin;1001;12;1013;33264
75;33;01;20;266;Marcenais;813;19;832;33266
75;33;04;30;268;Margaux-Cantenac;2876;31;2907;33268
75;33;05;27;269;Margueron;393;4;397;33269
75;33;03;29;270;Marimbault;183;8;191;33270
75;33;03;29;271;Marions;218;2;220;33271
75;33;01;20;272;Marsas;1213;22;1235;33272
75;33;02;19;273;Martignas-sur-Jalle;7624;131;7755;33273
75;33;02;08;274;Martillac;3279;40;3319;33274
75;33;03;12;275;Martres;106;1;107;33275
75;33;03;29;276;Masseilles;142;5;147;33276
75;33;03;27;277;Massugas;225;6;231;33277
75;33;03;27;278;Mauriac;236;6;242;33278
75;33;03;29;279;Mazères;775;10;785;33279
75;33;01;13;280;Mazion;542;4;546;33280
75;33;02;98;281;Mérignac;72197;723;72920;33281
75;33;03;27;282;Mérignas;350;4;354;33282
75;33;03;27;283;Mesterrieux;230;3;233;33283
75;33;06;14;284;Mios;10781;128;10909;33284
75;33;01;13;285;Mombrier;429;8;437;33285
75;33;03;27;287;Mongauzy;601;5;606;33287
75;33;03;12;288;Monprimblanc;287;4;291;33288
75;33;03;27;289;Monségur;1604;71;1675;33289
75;33;05;21;290;Montagne;1521;132;1653;33290
75;33;03;27;291;Montagoudin;178;3;181;33291
75;33;03;12;292;Montignac;137;7;144;33292
75;33;02;17;293;Montussan;3364;50;3414;33293
75;33;03;27;294;Morizès;549;8;557;33294
75;33;05;16;295;Mouillac;86;9;95;33295
75;33;05;10;296;Mouliets-et-Villemartin;1032;15;1047;33296
75;33;04;30;297;Moulis-en-Médoc;1877;34;1911;33297
75;33;05;10;298;Moulon;1006;19;1025;33298
75;33;03;12;299;Mourens;385;8;393;33299
75;33;04;22;300;Naujac-sur-Mer;1083;23;1106;33300
75;33;05;10;301;Naujan-et-Postiac;605;6;611;33301
75;33;05;21;302;Néac;345;11;356;33302
75;33;05;10;303;Nérigean;841;8;849;33303
75;33;03;27;304;Neuffons;145;4;149;33304
75;33;03;29;305;Le Nizan;509;5;514;33305
75;33;03;27;306;Noaillac;501;6;507;33306
75;33;03;29;307;Noaillan;1676;36;1712;33307
75;33;03;12;308;Omet;306;2;308;33308
75;33;04;22;309;Ordonnac;496;6;502;33309
75;33;03;15;310;Origne;184;2;186;33310
75;33;03;12;311;Paillet;1204;24;1228;33311
75;33;02;25;312;Parempuyre;9136;84;9220;33312
75;33;04;22;314;Pauillac;4997;82;5079;33314
75;33;05;21;315;Les Peintures;1622;21;1643;33315
75;33;03;27;316;Pellegrue;968;13;981;33316
75;33;05;20;317;Périssac;1194;16;1210;33317
75;33;02;99;318;Pessac;65245;762;66007;33318
75;33;05;10;319;Pessac-sur-Dordogne;446;9;455;33319
75;33;05;21;320;Petit-Palais-et-Cornemps;720;11;731;33320
75;33;01;20;321;Peujard;2148;28;2176;33321
75;33;02;25;322;Le Pian-Médoc;6890;141;7031;33322
75;33;03;12;323;Le Pian-sur-Garonne;910;18;928;33323
75;33;05;27;324;Pineuilh;4438;111;4549;33324
75;33;01;13;325;Plassac;935;21;956;33325
75;33;01;13;326;Pleine-Selve;219;5;224;33326
75;33;03;15;327;Podensac;3160;49;3209;33327
75;33;05;16;328;Pomerol;579;11;590;33328
75;33;03;29;329;Pompéjac;267;3;270;33329
75;33;02;11;330;Pompignac;3170;54;3224;33330
75;33;03;27;331;Pondaurat;463;14;477;33331
75;33;05;21;332;Porchères;867;11;878;33332
75;33;04;30;333;Le Porge;3294;46;3340;33333
75;33;03;15;334;Portets;2757;34;2791;33334
75;33;02;11;335;Le Pout;622;8;630;33335
75;33;03;29;336;Préchac;1003;13;1016;33336
75;33;03;15;337;Preignac;2154;33;2187;33337
75;33;01;13;339;Prignac-et-Marcamps;1374;29;1403;33339
75;33;01;13;341;Pugnac;2325;33;2358;33341
75;33;05;21;342;Puisseguin;823;21;844;33342
75;33;03;15;343;Pujols-sur-Ciron;830;16;846;33343
75;33;05;10;344;Pujols;528;6;534;33344
75;33;03;27;345;Le Puy;407;4;411;33345
75;33;03;27;346;Puybarban;418;11;429;33346
75;33;05;21;347;Puynormand;307;9;316;33347
75;33;04;22;348;Queyrac;1367;15;1382;33348
75;33;02;11;349;Quinsac;2195;22;2217;33349
75;33;05;10;350;Rauzan;1236;25;1261;33350
75;33;01;13;351;Reignac;1602;26;1628;33351
75;33;03;27;352;La Réole;4355;82;4437;33352
75;33;03;27;353;Rimons;198;4;202;33353
75;33;05;27;354;Riocaud;192;5;197;33354
75;33;03;12;355;Rions;1525;36;1561;33355
75;33;05;16;356;La Rivière;431;1;432;33356
75;33;03;29;357;Roaillan;1742;27;1769;33357
75;33;03;12;358;Romagne;467;8;475;33358
75;33;03;27;359;Roquebrune;284;3;287;33359
75;33;05;27;360;La Roquille;308;3;311;33360
75;33;03;27;361;Ruch;598;10;608;33361
75;33;05;21;362;Sablons;1300;15;1315;33362
75;33;02;11;363;Sadirac;4499;70;4569;33363
75;33;05;16;364;Saillans;385;7;392;33364
75;33;05;16;365;Saint-Aignan;201;9;210;33365
75;33;01;20;366;Saint-André-de-Cubzac;12372;181;12553;33366
75;33;03;12;367;Saint-André-du-Bois;432;4;436;33367
75;33;05;27;369;Saint-André-et-Appelles;675;12;687;33369
75;33;01;13;370;Saint-Androny;542;8;550;33370
75;33;03;27;372;Saint-Antoine-du-Queyret;56;2;58;33372
75;33;05;21;373;Saint-Antoine-sur-l'Isle;582;10;592;33373
75;33;01;13;374;Saint-Aubin-de-Blaye;866;19;885;33374
75;33;05;10;375;Saint-Aubin-de-Branne;368;8;376;33375
75;33;02;28;376;Saint-Aubin-de-Médoc;7495;214;7709;33376
75;33;05;27;377;Saint-Avit-de-Soulège;78;3;81;33377
75;33;05;27;378;Saint-Avit-Saint-Nazaire;1478;22;1500;33378
75;33;03;27;379;Saint-Brice;315;2;317;33379
75;33;01;13;380;Val-de-Livenne;1779;23;1802;33380
75;33;02;11;381;Saint-Caprais-de-Bordeaux;3399;34;3433;33381
75;33;01;20;382;Saint-Christoly-de-Blaye;1904;30;1934;33382
75;33;04;22;383;Saint-Christoly-Médoc;277;3;280;33383
75;33;05;21;384;Saint-Christophe-des-Bardes;418;7;425;33384
75;33;05;21;385;Saint-Christophe-de-Double;653;5;658;33385
75;33;05;21;386;Saint-Cibard;191;6;197;33386
75;33;05;21;387;Saint-Ciers-d'Abzac;1481;24;1505;33387
75;33;01;13;388;Saint-Ciers-de-Canesse;781;16;797;33388
75;33;01;13;389;Saint-Ciers-sur-Gironde;3021;42;3063;33389
75;33;05;10;390;Sainte-Colombe;422;9;431;33390
75;33;03;29;391;Saint-Côme;321;4;325;33391
75;33;03;12;392;Sainte-Croix-du-Mont;866;16;882;33392
75;33;05;21;393;Saint-Denis-de-Pile;5688;68;5756;33393
75;33;05;10;394;Saint-Emilion;1859;47;1906;33394
75;33;04;22;395;Saint-Estèphe;1592;50;1642;33395
75;33;05;10;396;Saint-Etienne-de-Lisse;195;4;199;33396
75;33;02;26;397;Sainte-Eulalie;4832;82;4914;33397
75;33;03;27;398;Saint-Exupéry;168;2;170;33398
75;33;03;27;399;Saint-Félix-de-Foncaude;289;7;296;33399
75;33;03;27;400;Saint-Ferme;340;5;345;33400
75;33;05;10;401;Sainte-Florence;148;2;150;33401
75;33;05;27;402;Sainte-Foy-la-Grande;2627;31;2658;33402
75;33;03;12;403;Sainte-Foy-la-Longue;131;2;133;33403
75;33;03;27;404;Sainte-Gemme;190;4;194;33404
75;33;01;13;405;Saint-Genès-de-Blaye;494;12;506;33405
75;33;05;10;406;Saint-Genès-de-Castillon;380;7;387;33406
75;33;05;20;407;Saint-Genès-de-Fronsac;856;17;873;33407
75;33;02;11;408;Saint-Genès-de-Lombaud;383;17;400;33408
75;33;03;12;409;Saint-Genis-du-Bois;86;1;87;33409
75;33;03;12;411;Saint-Germain-de-Grave;156;3;159;33411
75;33;04;22;412;Saint-Germain-d'Esteuil;1256;20;1276;33412
75;33;05;10;413;Saint-Germain-du-Puch;2231;36;2267;33413
75;33;05;16;414;Saint-Germain-de-la-Rivière;390;4;394;33414
75;33;01;20;415;Saint-Gervais;1905;20;1925;33415
75;33;01;20;416;Saint-Girons-d'Aiguevives;927;19;946;33416
75;33;04;30;417;Sainte-Hélène;2838;44;2882;33417
75;33;03;27;418;Saint-Hilaire-de-la-Noaille;375;7;382;33418
75;33;03;27;419;Saint-Hilaire-du-Bois;79;0;79;33419
75;33;05;10;420;Saint-Hippolyte;130;1;131;33420
75;33;05;10;421;Saint-Jean-de-Blaignac;463;7;470;33421
75;33;02;19;422;Saint-Jean-d'Illac;8980;163;9143;33422
75;33;04;22;423;Saint-Julien-Beychevelle;611;0;611;33423
75;33;04;30;424;Saint-Laurent-Médoc;4860;88;4948;33424
75;33;01;20;425;Saint-Laurent-d'Arce;1484;28;1512;33425
75;33;05;10;426;Saint-Laurent-des-Combes;252;1;253;33426
75;33;03;12;427;Saint-Laurent-du-Bois;247;5;252;33427
75;33;03;12;428;Saint-Laurent-du-Plan;84;0;84;33428
75;33;03;15;429;Saint-Léger-de-Balson;326;5;331;33429
75;33;02;12;431;Saint-Léon;341;4;345;33431
75;33;03;29;432;Saint-Loubert;236;2;238;33432
75;33;02;26;433;Saint-Loubès;9909;108;10017;33433
75;33;02;26;434;Saint-Louis-de-Montferrand;2161;15;2176;33434
75;33;03;12;435;Saint-Macaire;2078;95;2173;33435
75;33;06;15;436;Saint-Magne;1042;21;1063;33436
75;33;05;10;437;Saint-Magne-de-Castillon;2029;11;2040;33437
75;33;03;12;438;Saint-Maixant;1994;49;2043;33438
75;33;01;20;439;Saint-Mariens;1624;19;1643;33439
75;33;03;12;440;Saint-Martial;239;5;244;33440
75;33;01;13;441;Saint-Martin-Lacaussade;1158;98;1256;33441
75;33;05;21;442;Saint-Martin-de-Laye;550;5;555;33442
75;33;03;27;443;Saint-Martin-de-Lerm;154;3;157;33443
75;33;03;12;444;Saint-Martin-de-Sescas;576;10;586;33444
75;33;05;21;445;Saint-Martin-du-Bois;844;17;861;33445
75;33;03;27;446;Saint-Martin-du-Puy;168;1;169;33446
75;33;05;21;447;Saint-Médard-de-Guizières;2391;22;2413;33447
75;33;02;08;448;Saint-Médard-d'Eyrans;3098;40;3138;33448
75;33;02;28;449;Saint-Médard-en-Jalles;31808;520;32328;33449
75;33;03;29;450;Saint-Michel-de-Castelnau;245;3;248;33450
75;33;05;16;451;Saint-Michel-de-Fronsac;527;4;531;33451
75;33;03;15;452;Saint-Michel-de-Rieufret;836;13;849;33452
75;33;03;27;453;Saint-Michel-de-Lapujade;222;4;226;33453
75;33;02;08;454;Saint-Morillon;1724;21;1745;33454
75;33;01;13;456;Saint-Palais;497;8;505;33456
75;33;03;29;457;Saint-Pardon-de-Conques;600;10;610;33457
75;33;01;13;458;Saint-Paul;977;17;994;33458
75;33;05;10;459;Saint-Pey-d'Armens;187;3;190;33459
75;33;05;10;460;Saint-Pey-de-Castets;609;12;621;33460
75;33;05;10;461;Saint-Philippe-d'Aiguille;375;5;380;33461
75;33;05;27;462;Saint-Philippe-du-Seignal;493;10;503;33462
75;33;03;12;463;Saint-Pierre-d'Aurillac;1311;20;1331;33463
75;33;03;12;464;Saint-Pierre-de-Bat;289;6;295;33464
75;33;03;29;465;Saint-Pierre-de-Mons;1227;21;1248;33465
75;33;05;10;466;Saint-Quentin-de-Baron;2559;32;2591;33466
75;33;05;27;467;Saint-Quentin-de-Caplong;238;4;242;33467
75;33;05;10;468;Sainte-Radegonde;435;9;444;33468
75;33;05;16;470;Saint-Romain-la-Virvée;871;24;895;33470
75;33;04;22;471;Saint-Sauveur;1280;23;1303;33471
75;33;05;21;472;Saint-Sauveur-de-Puynormand;360;6;366;33472
75;33;01;20;473;Saint-Savin;3250;37;3287;33473
75;33;02;08;474;Saint-Selve;3423;41;3464;33474
75;33;01;13;475;Saint-Seurin-de-Bourg;408;6;414;33475
75;33;04;22;476;Saint-Seurin-de-Cadourne;704;12;716;33476
75;33;01;13;477;Saint-Seurin-de-Cursac;763;17;780;33477
75;33;05;21;478;Saint-Seurin-sur-l'Isle;3141;21;3162;33478
75;33;03;27;479;Saint-Sève;251;2;253;33479
75;33;05;10;480;Saint-Sulpice-de-Faleyrens;1316;29;1345;33480
75;33;03;27;481;Saint-Sulpice-de-Guilleragues;230;3;233;33481
75;33;03;27;482;Saint-Sulpice-de-Pommiers;250;3;253;33482
75;33;02;26;483;Saint-Sulpice-et-Cameyrac;4762;67;4829;33483
75;33;03;15;484;Saint-Symphorien;1831;31;1862;33484
75;33;05;10;485;Sainte-Terre;1910;32;1942;33485
75;33;01;13;486;Saint-Trojan;355;9;364;33486
75;33;02;26;487;Saint-Vincent-de-Paul;1000;8;1008;33487
75;33;05;10;488;Saint-Vincent-de-Pertignas;357;13;370;33488
75;33;01;20;489;Saint-Vivien-de-Blaye;354;5;359;33489
75;33;04;22;490;Saint-Vivien-de-Médoc;1791;24;1815;33490
75;33;03;27;491;Saint-Vivien-de-Monségur;383;5;388;33491
75;33;01;20;492;Saint-Yzan-de-Soudiac;2427;24;2451;33492
75;33;04;22;493;Saint-Yzans-de-Médoc;348;24;372;33493
75;33;04;30;494;Salaunes;1171;11;1182;33494
75;33;02;11;496;SallebÅ“uf;2630;40;2670;33496
75;33;06;15;498;Salles;7411;139;7550;33498
75;33;05;10;499;Les Salles-de-Castillon;333;9;342;33499
75;33;01;13;500;Samonac;429;9;438;33500
75;33;02;08;501;Saucats;3255;57;3312;33501
75;33;01;20;502;Saugon;485;5;490;33502
75;33;04;30;503;Saumos;532;9;541;33503
75;33;03;29;504;Sauternes;814;9;823;33504
75;33;02;12;505;La Sauve;1546;55;1601;33505
75;33;03;27;506;Sauveterre-de-Guyenne;1853;22;1875;33506
75;33;03;29;507;Sauviac;324;11;335;33507
75;33;03;27;508;Savignac;626;13;639;33508
75;33;05;21;509;Savignac-de-l'Isle;501;9;510;33509
75;33;03;12;510;Semens;218;1;219;33510
75;33;03;29;511;Sendets;339;4;343;33511
75;33;03;27;512;Sigalens;362;8;370;33512
75;33;03;29;513;Sillas;122;2;124;33513
75;33;04;22;514;Soulac-sur-Mer;2825;25;2850;33514
75;33;03;12;515;Soulignac;422;8;430;33515
75;33;03;27;516;Soussac;199;5;204;33516
75;33;04;30;517;Soussans;1655;17;1672;33517
75;33;02;12;518;Tabanac;1084;23;1107;33518
75;33;02;28;519;Le Taillan-Médoc;10141;145;10286;33519
75;33;03;27;520;Taillecavat;283;3;286;33520
75;33;04;22;521;Talais;764;7;771;33521
75;33;02;31;522;Talence;43820;979;44799;33522
75;33;03;12;523;Targon;2054;24;2078;33523
75;33;05;16;524;Tarnès;337;7;344;33524
75;33;01;13;525;Tauriac;1297;21;1318;33525
75;33;05;21;526;Tayac;133;3;136;33526
75;33;06;14;527;Le Teich;8500;179;8679;33527
75;33;04;30;528;Le Temple;633;7;640;33528
75;33;06;32;529;La Teste-de-Buch;26168;378;26546;33529
75;33;01;13;530;Teuillac;880;9;889;33530
75;33;05;10;531;Tizac-de-Curton;346;5;351;33531
75;33;05;21;532;Tizac-de-Lapouyade;472;9;481;33532
75;33;03;29;533;Toulenne;2752;28;2780;33533
75;33;02;12;534;Le Tourne;802;11;813;33534
75;33;02;11;535;Tresses;4895;52;4947;33535
75;33;03;15;536;Le Tuzan;257;5;262;33536
75;33;03;29;537;Uzeste;459;10;469;33537
75;33;04;22;538;Valeyrac;539;10;549;33538
75;33;05;16;539;Vayres;4123;53;4176;33539
75;33;04;22;540;Vendays-Montalivet;2410;37;2447;33540
75;33;04;22;541;Vensac;1017;17;1034;33541
75;33;05;16;542;Vérac;946;14;960;33542
75;33;03;12;543;Verdelais;1020;9;1029;33543
75;33;04;22;544;Le Verdon-sur-Mer;1326;11;1337;33544
75;33;04;22;545;Vertheuil;1314;22;1336;33545
75;33;05;10;546;Vignonet;503;12;515;33546
75;33;03;29;547;Villandraut;1120;26;1146;33547
75;33;05;16;548;Villegouge;1250;24;1274;33548
75;33;03;12;549;Villenave-de-Rions;348;6;354;33549
75;33;02;33;550;Villenave-d'Ornon;36754;205;36959;33550
75;33;01;13;551;Villeneuve;397;6;403;33551
75;33;03;15;552;Virelade;1092;13;1105;33552
75;33;01;20;553;Virsac;1171;5;1176;33553
75;33;02;17;554;Yvrac;2838;23;2861;33554
75;33;06;14;555;Marcheprime;4992;81;5073;33555
76;34;01;21;001;Abeilhan;1795;24;1819;34001
76;34;01;14;002;Adissan;1259;25;1284;34002
76;34;01;01;003;Agde;29600;400;30000;34003
76;34;01;24;004;Agel;245;4;249;34004
76;34;02;11;005;Agonès;285;9;294;34005
76;34;01;24;006;Aigne;271;7;278;34006
76;34;01;24;007;Aigues-Vives;470;5;475;34007
76;34;01;06;008;Les Aires;605;11;616;34008
76;34;01;21;009;Alignan-du-Vent;1753;28;1781;34009
76;34;02;09;010;Aniane;2918;39;2957;34010
76;34;02;09;011;Arboras;111;4;115;34011
76;34;02;09;012;Argelliers;973;25;998;34012
76;34;02;06;013;Aspiran;1662;29;1691;34013
76;34;02;23;014;Assas;1488;42;1530;34014
76;34;01;24;015;Assignan;164;3;167;34015
76;34;02;09;016;Aumelas;531;17;548;34016
76;34;01;14;017;Aumes;494;16;510;34017
76;34;01;05;018;Autignac;923;15;938;34018
76;34;01;06;019;Avène;276;8;284;34019
76;34;01;24;020;Azillanet;360;12;372;34020
76;34;01;24;021;Babeau-Bouldoux;297;6;303;34021
76;34;03;07;022;Baillargues;7654;101;7755;34022
76;34;03;08;023;Balaruc-les-Bains;6991;91;7082;34023
76;34;03;08;024;Balaruc-le-Vieux;2648;42;2690;34024
76;34;01;04;025;Bassan;2155;35;2190;34025
76;34;01;24;026;Beaufort;221;4;225;34026
76;34;03;07;027;Beaulieu;2144;49;2193;34027
76;34;01;06;028;Bédarieux;5743;231;5974;34028
76;34;02;09;029;Bélarga;681;10;691;34029
76;34;01;24;030;Berlou;211;0;211;34030
76;34;01;01;031;Bessan;5162;76;5238;34031
76;34;01;98;032;Béziers;78308;1242;79550;34032
76;34;03;12;033;Boisseron;2072;41;2113;34033
76;34;01;24;034;Boisset;39;1;40;34034
76;34;02;09;035;La Boissière;1028;19;1047;34035
76;34;02;11;036;Le Bosc;1362;24;1386;34036
76;34;01;04;037;Boujan-sur-Libron;3367;56;3423;34037
76;34;01;06;038;Le Bousquet-d'Orb;1584;24;1608;34038
76;34;03;14;039;Bouzigues;1643;24;1667;34039
76;34;01;06;040;Brenas;54;0;54;34040
76;34;02;06;041;Brignac;940;17;957;34041
76;34;02;11;042;Brissac;605;14;619;34042
76;34;02;23;043;Buzignargues;361;5;366;34043
76;34;01;05;044;Cabrerolles;341;10;351;34044
76;34;02;14;045;Cabrières;524;16;540;34045
76;34;01;24;046;Cambon-et-Salvergues;49;0;49;34046
76;34;02;09;047;Campagnan;699;10;709;34047
76;34;03;12;048;Campagne;310;5;315;34048
76;34;01;06;049;Camplong;229;4;233;34049
76;34;03;13;050;Candillargues;1950;26;1976;34050
76;34;02;06;051;Canet;3506;46;3552;34051
76;34;01;24;052;Capestang;3281;59;3340;34052
76;34;01;06;053;Carlencas-et-Levas;128;0;128;34053
76;34;01;24;054;Cassagnoles;106;1;107;34054
76;34;01;24;055;Castanet-le-Haut;216;3;219;34055
76;34;01;21;056;Castelnau-de-Guers;1253;24;1277;34056
76;34;03;20;057;Castelnau-le-Lez;22534;382;22916;34057
76;34;03;07;058;Castries;6294;103;6397;34058
76;34;01;24;059;La Caunette;315;6;321;34059
76;34;02;11;060;Causse-de-la-Selle;402;5;407;34060
76;34;01;05;061;Causses-et-Veyran;619;10;629;34061
76;34;01;05;062;Caussiniojouls;152;1;153;34062
76;34;01;21;063;Caux;2538;47;2585;34063
76;34;02;11;064;Le Caylar;458;14;472;34064
76;34;01;24;065;Cazedarnes;608;11;619;34065
76;34;02;23;066;Cazevieille;215;3;218;34066
76;34;02;11;067;Cazilhac;1536;40;1576;34067
76;34;01;14;068;Cazouls-d'Hérault;412;9;421;34068
76;34;01;05;069;Cazouls-lès-Béziers;5060;94;5154;34069
76;34;01;24;070;Cébazan;627;12;639;34070
76;34;01;06;071;Ceilhes-et-Rocozels;329;5;334;34071
76;34;02;11;072;Celles;27;1;28;34072
76;34;01;04;073;Cers;2560;50;2610;34073
76;34;01;24;074;Cessenon-sur-Orb;2336;49;2385;34074
76;34;01;24;075;Cesseras;413;8;421;34075
76;34;02;06;076;Ceyras;1368;26;1394;34076
76;34;03;20;077;Clapiers;5411;101;5512;34077
76;34;02;11;078;Claret;1671;37;1708;34078
76;34;02;06;079;Clermont-l'Hérault;9029;161;9190;34079
76;34;01;24;080;Colombières-sur-Orb;482;14;496;34080
76;34;01;05;081;Colombiers;2684;44;2728;34081
76;34;02;23;082;Combaillaux;1742;41;1783;34082
76;34;01;06;083;Combes;326;3;329;34083
76;34;01;03;084;Corneilhan;1724;31;1755;34084
76;34;01;21;085;Coulobres;353;4;357;34085
76;34;01;24;086;Courniou;616;13;629;34086
76;34;03;22;087;Cournonsec;3454;31;3485;34087
76;34;03;22;088;Cournonterral;6423;78;6501;34088
76;34;01;24;089;Creissan;1313;26;1339;34089
76;34;03;07;090;Le Crès;9310;133;9443;34090
76;34;02;11;091;Le Cros;56;0;56;34091
76;34;01;24;092;Cruzy;967;17;984;34092
76;34;01;06;093;Dio-et-Valquières;146;5;151;34093
76;34;01;04;094;Espondeilhan;1109;23;1132;34094
76;34;03;22;095;Fabrègues;7293;127;7420;34095
76;34;01;05;096;Faugères;546;9;555;34096
76;34;01;24;097;Félines-Minervois;473;6;479;34097
76;34;01;24;098;Ferrals-les-Montagnes;153;4;157;34098
76;34;02;11;099;Ferrières-les-Verreries;48;1;49;34099
76;34;01;24;100;Ferrières-Poussarou;55;4;59;34100
76;34;01;21;101;Florensac;5057;79;5136;34101
76;34;02;11;102;Fontanès;349;9;358;34102
76;34;02;14;103;Fontès;1045;19;1064;34103
76;34;01;05;104;Fos;126;0;126;34104
76;34;01;05;105;Fouzilhon;254;3;257;34105
76;34;02;11;106;Fozières;180;9;189;34106
76;34;01;24;107;Fraisse-sur-Agout;343;3;346;34107
76;34;03;08;108;Frontignan;23028;227;23255;34108
76;34;01;05;109;Gabian;844;19;863;34109
76;34;03;12;110;Galargues;733;26;759;34110
76;34;02;11;111;Ganges;4098;102;4200;34111
76;34;03;12;112;Garrigues;207;4;211;34112
76;34;03;08;113;Gigean;6507;79;6586;34113
76;34;02;09;114;Gignac;6480;114;6594;34114
76;34;02;11;115;Gorniès;118;1;119;34115
76;34;03;15;116;Grabels;8798;99;8897;34116
76;34;01;06;117;Graissessac;608;9;617;34117
76;34;02;23;118;Guzargues;502;12;514;34118
76;34;01;06;119;Hérépian;1515;26;1541;34119
76;34;03;20;120;Jacou;6808;102;6910;34120
76;34;01;06;121;Joncels;285;13;298;34121
76;34;02;09;122;Jonquières;528;7;535;34122
76;34;03;10;123;Juvignac;11344;103;11447;34123
76;34;02;06;124;Lacoste;308;10;318;34124
76;34;02;09;125;Lagamas;111;4;115;34125
76;34;01;06;126;Lamalou-les-Bains;2500;17;2517;34126
76;34;03;13;127;Lansargues;3099;43;3142;34127
76;34;02;11;128;Laroque;1625;31;1656;34128
76;34;03;10;129;Lattes;17453;227;17680;34129
76;34;01;05;130;Laurens;1770;29;1799;34130
76;34;02;11;131;Lauret;638;20;658;34131
76;34;02;11;132;Lauroux;205;2;207;34132
76;34;02;11;133;Lavalette;57;0;57;34133
76;34;03;10;134;Lavérune;3328;54;3382;34134
76;34;01;02;135;Lespignan;3299;54;3353;34135
76;34;01;14;136;Lézignan-la-Cèbe;1567;29;1596;34136
76;34;02;06;137;Liausson;148;7;155;34137
76;34;02;14;138;Lieuran-Cabrières;333;13;346;34138
76;34;01;04;139;Lieuran-lès-Béziers;1385;40;1425;34139
76;34;01;03;140;Lignan-sur-Orb;3218;85;3303;34140
76;34;01;24;141;La Livinière;521;8;529;34141
76;34;02;11;142;Lodève;7477;237;7714;34142
76;34;03;14;143;Loupian;2191;39;2230;34143
76;34;01;06;144;Lunas;661;13;674;34144
76;34;03;12;145;Lunel;26385;242;26627;34145
76;34;03;12;146;Lunel-Viel;4367;45;4412;34146
76;34;01;05;147;Magalas;3371;52;3423;34147
76;34;01;05;148;Maraussan;4628;85;4713;34148
76;34;01;05;149;Margon;717;2;719;34149
76;34;03;01;150;Marseillan;7734;104;7838;34150
76;34;03;12;151;Marsillargues;6407;78;6485;34151
76;34;02;11;152;Mas-de-Londres;672;10;682;34152
76;34;02;23;153;Les Matelles;2005;41;2046;34153
76;34;03;13;154;Mauguio;16705;194;16899;34154
76;34;01;05;155;Maureilhan;2260;48;2308;34155
76;34;02;06;156;Mérifons;44;3;47;34156
76;34;03;14;157;Mèze;12307;166;12473;34157
76;34;01;24;158;Minerve;103;1;104;34158
76;34;03;08;159;Mireval;3310;50;3360;34159
76;34;01;24;160;Mons;627;15;642;34160
76;34;01;05;161;Montady;3960;75;4035;34161
76;34;01;14;162;Montagnac;4324;59;4383;34162
76;34;02;09;163;Montarnaud;4052;47;4099;34163
76;34;03;07;164;Montaud;1028;11;1039;34164
76;34;03;14;165;Montbazin;2934;60;2994;34165
76;34;01;21;166;Montblanc;2865;51;2916;34166
76;34;01;24;167;Montels;254;4;258;34167
76;34;01;05;168;Montesquieu;74;0;74;34168
76;34;03;20;169;Montferrier-sur-Lez;3960;162;4122;34169
76;34;01;24;170;Montouliers;213;5;218;34170
76;34;02;11;171;Montoulieu;163;4;167;34171
76;34;03;99;172;Montpellier;295542;3391;298933;34172
76;34;02;09;173;Montpeyroux;1360;24;1384;34173
76;34;02;11;174;Moulès-et-Baucels;866;26;892;34174
76;34;02;06;175;Mourèze;205;5;210;34175
76;34;03;13;176;Mudaison;2753;29;2782;34176
76;34;02;23;177;Murles;324;10;334;34177
76;34;01;05;178;Murviel-lès-Béziers;3105;54;3159;34178
76;34;03;22;179;Murviel-lès-Montpellier;1863;30;1893;34179
76;34;02;06;180;Nébian;1437;23;1460;34180
76;34;01;05;181;Neffiès;1039;25;1064;34181
76;34;01;21;182;Nézignan-l'Evêque;1827;29;1856;34182
76;34;01;02;183;Nissan-lez-Enserune;3996;61;4057;34183
76;34;01;14;184;Nizas;677;15;692;34184
76;34;02;11;185;Notre-Dame-de-Londres;507;11;518;34185
76;34;02;06;186;Octon;522;12;534;34186
76;34;01;24;187;Olargues;662;14;676;34187
76;34;02;11;188;Olmet-et-Villecun;188;4;192;34188
76;34;01;24;189;Olonzac;1687;19;1706;34189
76;34;01;24;190;Oupia;237;7;244;34190
76;34;01;05;191;Pailhès;571;12;583;34191
76;34;03;13;192;Palavas-les-Flots;5844;41;5885;34192
76;34;01;24;193;Pardailhan;177;6;183;34193
76;34;02;06;194;Paulhan;4016;53;4069;34194
76;34;02;11;195;Pégairolles-de-Buèges;55;1;56;34195
76;34;02;11;196;Pégairolles-de-l'Escalette;159;5;164;34196
76;34;02;14;197;Péret;1040;17;1057;34197
76;34;03;10;198;Pérols;9016;122;9138;34198
76;34;01;21;199;Pézenas;8002;271;8273;34199
76;34;01;06;200;Pézènes-les-Mines;236;10;246;34200
76;34;01;24;201;Pierrerue;293;7;300;34201
76;34;03;22;202;Pignan;7959;109;8068;34202
76;34;01;21;203;Pinet;1906;22;1928;34203
76;34;02;09;204;Plaissan;1373;17;1390;34204
76;34;02;11;205;Les Plans;283;10;293;34205
76;34;01;24;206;Poilhes;538;11;549;34206
76;34;01;21;207;Pomérols;2196;44;2240;34207
76;34;02;09;208;Popian;358;15;373;34208
76;34;01;01;209;Portiragnes;3104;64;3168;34209
76;34;02;09;210;Le Pouget;2082;46;2128;34210
76;34;01;06;211;Le Poujol-sur-Orb;1008;30;1038;34211
76;34;02;11;212;Poujols;175;6;181;34212
76;34;03;14;213;Poussan;5993;78;6071;34213
76;34;01;05;214;Pouzolles;1172;18;1190;34214
76;34;02;09;215;Pouzols;959;22;981;34215
76;34;01;06;216;Le Pradal;334;9;343;34216
76;34;03;23;217;Prades-le-Lez;5908;111;6019;34217
76;34;01;24;218;Prades-sur-Vernazobre;310;8;318;34218
76;34;01;24;219;Prémian;505;9;514;34219
76;34;02;11;220;Le Puech;251;5;256;34220
76;34;02;09;221;Puéchabon;499;11;510;34221
76;34;02;09;222;Puilacher;616;13;629;34222
76;34;01;05;223;Puimisson;1152;23;1175;34223
76;34;01;21;224;Puissalicon;1348;23;1371;34224
76;34;01;24;225;Puisserguier;3037;50;3087;34225
76;34;01;24;226;Quarante;1796;26;1822;34226
76;34;03;07;227;Restinclières;2109;29;2138;34227
76;34;01;24;228;Rieussec;77;5;82;34228
76;34;01;24;229;Riols;739;26;765;34229
76;34;02;11;230;Les Rives;147;4;151;34230
76;34;02;11;231;Romiguières;21;2;23;34231
76;34;01;24;232;Roquebrun;604;11;615;34232
76;34;02;11;233;Roqueredonde;210;3;213;34233
76;34;01;05;234;Roquessels;97;1;98;34234
76;34;01;24;235;Rosis;275;5;280;34235
76;34;02;11;236;Rouet;68;0;68;34236
76;34;01;05;237;Roujan;2187;29;2216;34237
76;34;02;11;238;Saint-André-de-Buèges;36;1;37;34238
76;34;02;09;239;Saint-André-de-Sangonis;6198;106;6304;34239
76;34;03;13;240;Saint-Aunès;3786;33;3819;34240
76;34;02;09;241;Saint-Bauzille-de-la-Sylve;873;14;887;34241
76;34;02;23;242;Saint-Bauzille-de-Montmel;1074;24;1098;34242
76;34;02;11;243;Saint-Bauzille-de-Putois;2001;31;2032;34243
76;34;03;07;244;Saint-Brès;3209;43;3252;34244
76;34;01;24;245;Saint-Chinian;1697;34;1731;34245
76;34;03;12;246;Entre-Vignes;2107;44;2151;34246
76;34;02;23;247;Saint-Clément-de-Rivière;5016;244;5260;34247
76;34;02;23;248;Sainte-Croix-de-Quintillargues;943;17;960;34248
76;34;03;07;249;Saint-Drézéry;2735;58;2793;34249
76;34;01;24;250;Saint-Etienne-d'Albagnan;302;7;309;34250
76;34;02;11;251;Saint-Etienne-de-Gourgas;519;17;536;34251
76;34;01;06;252;Saint-Etienne-Estréchoux;253;5;258;34252
76;34;02;11;253;Saint-Félix-de-l'Héras;34;1;35;34253
76;34;02;06;254;Saint-Félix-de-Lodez;1163;32;1195;34254
76;34;02;23;255;Saint-Gély-du-Fesc;10197;265;10462;34255
76;34;03;07;256;Saint-Geniès-des-Mourgues;2017;33;2050;34256
76;34;01;06;257;Saint-Geniès-de-Varensal;216;2;218;34257
76;34;01;05;258;Saint-Geniès-de-Fontedit;1669;30;1699;34258
76;34;03;22;259;Saint-Georges-d'Orques;5552;66;5618;34259
76;34;01;06;260;Saint-Gervais-sur-Mare;855;15;870;34260
76;34;02;09;261;Saint-Guilhem-le-Désert;245;8;253;34261
76;34;02;09;262;Saint-Guiraud;250;0;250;34262
76;34;02;23;263;Saint-Hilaire-de-Beauvoir;433;3;436;34263
76;34;02;11;264;Saint-Jean-de-Buèges;210;0;210;34264
76;34;02;23;265;Saint-Jean-de-Cornies;750;23;773;34265
76;34;02;23;266;Saint-Jean-de-Cuculles;500;7;507;34266
76;34;02;09;267;Saint-Jean-de-Fos;1727;34;1761;34267
76;34;02;11;268;Saint-Jean-de-la-Blaquière;634;17;651;34268
76;34;01;24;269;Saint-Jean-de-Minervois;147;6;153;34269
76;34;03;10;270;Saint-Jean-de-Védas;11086;204;11290;34270
76;34;01;24;271;Saint-Julien;219;3;222;34271
76;34;03;12;272;Saint-Just;3278;29;3307;34272
76;34;01;24;273;Saint-Martin-de-l'Arçon;143;5;148;34273
76;34;02;11;274;Saint-Martin-de-Londres;2766;26;2792;34274
76;34;02;23;276;Saint-Mathieu-de-Tréviers;4883;96;4979;34276
76;34;02;11;277;Saint-Maurice-Navacelles;186;6;192;34277
76;34;02;11;278;Saint-Michel;55;1;56;34278
76;34;01;05;279;Saint-Nazaire-de-Ladarez;325;3;328;34279
76;34;03;12;280;Saint-Nazaire-de-Pézan;615;7;622;34280
76;34;02;09;281;Saint-Pargoire;2329;37;2366;34281
76;34;02;09;282;Saint-Paul-et-Valmalle;1248;19;1267;34282
76;34;02;11;283;Saint-Pierre-de-la-Fage;135;1;136;34283
76;34;01;24;284;Saint-Pons-de-Thomières;1794;185;1979;34284
76;34;01;14;285;Saint-Pons-de-Mauchiens;638;11;649;34285
76;34;02;11;286;Saint-Privat;401;12;413;34286
76;34;02;09;287;Saint-Saturnin-de-Lucian;267;7;274;34287
76;34;03;12;288;Saint-Sériès;976;22;998;34288
76;34;01;21;289;Saint-Thibéry;2807;36;2843;34289
76;34;02;23;290;Saint-Vincent-de-Barbeyrargues;719;10;729;34290
76;34;01;24;291;Saint-Vincent-d'Olargues;355;23;378;34291
76;34;02;06;292;Salasc;302;6;308;34292
76;34;01;24;293;La Salvetat-sur-Agout;1132;20;1152;34293
76;34;03;12;294;Saturargues;1011;19;1030;34294
76;34;03;22;295;Saussan;1616;33;1649;34295
76;34;03;12;296;Saussines;1004;21;1025;34296
76;34;02;11;297;Sauteyrargues;426;8;434;34297
76;34;01;04;298;Sauvian;5485;97;5582;34298
76;34;01;02;299;Sérignan;7504;158;7662;34299
76;34;01;04;300;Servian;5233;92;5325;34300
76;34;03;25;301;Sète;43858;601;44459;34301
76;34;01;24;302;Siran;744;8;752;34302
76;34;02;11;303;Sorbs;38;1;39;34303
76;34;02;11;304;Soubès;920;12;932;34304
76;34;01;24;305;Le Soulié;127;0;127;34305
76;34;02;11;306;Soumont;174;2;176;34306
76;34;03;07;307;Sussargues;2802;57;2859;34307
76;34;01;06;308;Taussac-la-Billière;457;13;470;34308
76;34;02;23;309;Teyran;4595;107;4702;34309
76;34;01;05;310;Thézan-lès-Béziers;3029;74;3103;34310
76;34;01;21;311;Tourbes;1719;157;1876;34311
76;34;01;06;312;La Tour-sur-Orb;1279;29;1308;34312
76;34;02;09;313;Tressan;676;24;700;34313
76;34;02;23;314;Le Triadou;576;13;589;34314
76;34;02;14;315;Usclas-d'Hérault;430;5;435;34315
76;34;02;11;316;Usclas-du-Bosc;226;2;228;34316
76;34;02;11;317;La Vacquerie-et-Saint-Martin-de-Castries;186;7;193;34317
76;34;02;11;318;Vacquières;721;12;733;34318
76;34;01;05;319;Vailhan;151;4;155;34319
76;34;02;23;320;Vailhauquès;2584;56;2640;34320
76;34;03;13;321;Valergues;2057;29;2086;34321
76;34;02;11;322;Valflaunès;766;24;790;34322
76;34;02;06;323;Valmascle;44;0;44;34323
76;34;01;02;324;Valras-Plage;4206;58;4264;34324
76;34;01;21;325;Valros;1641;32;1673;34325
76;34;01;24;326;Vélieux;91;0;91;34326
76;34;03;07;327;Vendargues;6423;84;6507;34327
76;34;02;09;328;Vendémian;1122;27;1149;34328
76;34;01;02;329;Vendres;2723;81;2804;34329
76;34;01;24;331;Verreries-de-Moussans;95;2;97;34331
76;34;01;01;332;Vias;5717;65;5782;34332
76;34;03;08;333;Vic-la-Gardiole;3373;28;3401;34333
76;34;01;24;334;Vieussan;269;0;269;34334
76;34;01;06;335;Villemagne-l'Argentière;419;12;431;34335
76;34;01;04;336;Villeneuve-lès-Béziers;4102;53;4155;34336
76;34;03;22;337;Villeneuve-lès-Maguelone;10344;121;10465;34337
76;34;02;06;338;Villeneuvette;69;3;72;34338
76;34;01;24;339;Villespassans;174;2;176;34339
76;34;03;12;340;Villetelle;1467;43;1510;34340
76;34;03;14;341;Villeveyrac;3859;68;3927;34341
76;34;02;11;342;Viols-en-Laval;206;4;210;34342
76;34;02;11;343;Viols-le-Fort;1228;28;1256;34343
76;34;03;13;344;La Grande-Motte;8696;104;8800;34344
53;35;03;13;001;Acigné;6834;164;6998;35001
53;35;01;12;002;Amanlis;1759;37;1796;35002
53;35;03;01;003;Andouillé-Neuville;946;9;955;35003
53;35;01;01;004;Val-Couesnon;4137;88;4225;35004
53;35;01;10;005;Arbrissel;313;12;325;35005
53;35;01;10;006;Argentré-du-Plessis;4502;129;4631;35006
53;35;03;01;007;Aubigné;485;2;487;35007
53;35;01;10;008;Availles-sur-Seiche;674;18;692;35008
53;35;04;07;009;Baguer-Morvan;1703;27;1730;35009
53;35;04;07;010;Baguer-Pican;1738;16;1754;35010
53;35;02;02;012;Bain-de-Bretagne;7314;165;7479;35012
53;35;02;17;013;Bains-sur-Oust;3503;162;3665;35013
53;35;01;10;014;Bais;2455;32;2487;35014
53;35;01;27;015;Balazé;2218;48;2266;35015
53;35;02;11;016;Baulon;2188;61;2249;35016
53;35;04;06;017;La Baussaine;673;10;683;35017
53;35;01;09;018;La Bazouge-du-Désert;1069;21;1090;35018
53;35;01;01;019;Bazouges-la-Pérouse;1856;27;1883;35019
53;35;01;09;021;Beaucé;1357;36;1393;35021
53;35;03;15;022;Bécherel;688;15;703;35022
53;35;03;16;023;Bédée;4417;73;4490;35023
53;35;03;03;024;Betton;12265;259;12524;35024
53;35;01;08;025;Billé;1054;15;1069;35025
53;35;03;15;026;Bléruais;102;6;108;35026
53;35;03;15;027;Boisgervilly;1707;33;1740;35027
53;35;01;05;028;Boistrudan;722;14;736;35028
53;35;04;06;029;Bonnemain;1539;25;1564;35029
53;35;02;02;030;La Bosse-de-Bretagne;676;17;693;35030
53;35;03;13;031;La BouÃ«xière;4526;101;4627;35031
53;35;03;12;032;Bourgbarré;4515;62;4577;35032
53;35;02;11;033;Bourg-des-Comptes;3295;69;3364;35033
53;35;04;07;034;La Boussac;1200;24;1224;35034
53;35;02;11;035;Bovel;598;11;609;35035
53;35;03;24;037;Bréal-sous-Montfort;6404;81;6485;35037
53;35;01;27;038;Bréal-sous-Vitré;633;21;654;35038
53;35;03;13;039;Brécé;2059;43;2102;35039
53;35;03;16;040;Breteil;3655;78;3733;35040
53;35;01;12;041;Brie;1006;17;1023;35041
53;35;01;10;042;Brielles;670;30;700;35042
53;35;04;07;044;Broualan;381;10;391;35044
53;35;02;17;045;Bruc-sur-Aff;866;19;885;35045
53;35;02;11;046;Les Brulais;540;8;548;35046
53;35;03;04;047;Bruz;18905;461;19366;35047
53;35;04;25;049;Cancale;5226;91;5317;35049
53;35;04;06;050;Cardroc;593;9;602;35050
53;35;03;03;051;Cesson-Sévigné;17082;534;17616;35051
53;35;01;27;052;Champeaux;514;15;529;35052
53;35;02;02;054;Chanteloup;1815;45;1860;35054
53;35;03;20;055;Chantepie;10278;191;10469;35055
53;35;04;06;056;La Chapelle-aux-Filtzméens;814;20;834;35056
53;35;02;11;057;La Chapelle-BouÃ«xic;1496;26;1522;35057
53;35;03;15;058;La Chapelle-Chaussée;1295;15;1310;35058
53;35;03;03;059;La Chapelle-des-Fougeretz;4682;96;4778;35059
53;35;03;15;060;La Chapelle du Lou du Lac;1011;19;1030;35060
53;35;01;27;061;La Chapelle-Erbrée;711;17;728;35061
53;35;01;09;062;La Chapelle-Janson;1475;27;1502;35062
53;35;01;08;063;La Chapelle-Saint-Aubert;452;6;458;35063
53;35;02;17;064;La Chapelle-de-Brain;984;20;1004;35064
53;35;03;24;065;La Chapelle-Thouarault;2219;44;2263;35065
53;35;03;04;066;Chartres-de-Bretagne;8157;134;8291;35066
53;35;03;13;067;Chasné-sur-Illet;1598;28;1626;35067
53;35;01;05;068;Châteaubourg;7336;154;7490;35068
53;35;03;05;069;Châteaugiron;10283;263;10546;35069
53;35;04;07;070;Châteauneuf-d'Ille-et-Vilaine;1710;25;1735;35070
53;35;01;01;071;Le Châtellier;436;6;442;35071
53;35;01;27;072;Châtillon-en-Vendelais;1675;35;1710;35072
53;35;01;01;075;Chauvigné;808;19;827;35075
53;35;03;24;076;Chavagne;4268;82;4350;35076
53;35;01;10;077;Chelun;347;11;358;35077
53;35;04;07;078;Cherrueix;1092;22;1114;35078
53;35;03;03;079;Chevaigné;2325;57;2382;35079
53;35;03;24;080;Cintré;2410;62;2472;35080
53;35;03;14;081;Clayes;908;30;938;35081
53;35;01;10;082;CoÃ«smes;1465;35;1500;35082
53;35;02;11;084;Comblessac;695;11;706;35084
53;35;04;06;085;Combourg;5963;142;6105;35085
53;35;01;08;086;Combourtillé;611;9;620;35086
53;35;01;27;087;Cornillé;964;32;996;35087
53;35;03;12;088;Corps-Nuds;3434;56;3490;35088
53;35;02;02;089;La Couyère;455;12;467;35089
53;35;02;02;090;Crevin;2862;40;2902;35090
53;35;03;15;091;Le Crouais;597;6;603;35091
53;35;04;06;092;Cuguen;834;14;848;35092
53;35;04;26;093;Dinard;10181;526;10707;35093
53;35;04;06;094;Dingé;1638;24;1662;35094
53;35;04;07;095;Dol-de-Bretagne;5738;332;6070;35095
53;35;01;05;096;Domagné;2383;55;2438;35096
53;35;01;10;097;Domalain;2020;51;2071;35097
53;35;02;02;098;La Dominelais;1396;27;1423;35098
53;35;03;05;099;Domloup;3680;65;3745;35099
53;35;03;13;101;Dourdain;1195;21;1216;35101
53;35;01;10;102;Drouges;510;10;520;35102
53;35;01;10;103;Eancé;420;10;430;35103
53;35;04;07;104;Epiniac;1417;26;1443;35104
53;35;01;27;105;Erbrée;1697;53;1750;35105
53;35;02;02;106;Ercé-en-Lamée;1514;14;1528;35106
53;35;03;13;107;Ercé-près-Liffré;1949;35;1984;35107
53;35;01;10;108;Essé;1061;23;1084;35108
53;35;01;10;109;Etrelles;2585;59;2644;35109
53;35;03;01;110;Feins;1014;19;1033;35110
53;35;01;09;111;Le Ferré;710;6;716;35111
53;35;01;09;112;Fleurigné;939;26;965;35112
53;35;01;10;114;Forges-la-Forêt;261;6;267;35114
53;35;01;97;115;Fougères;20595;653;21248;35115
53;35;04;07;116;La Fresnais;2571;58;2629;35116
53;35;03;15;117;GaÃ«l;1619;22;1641;35117
53;35;03;01;118;Gahard;1525;24;1549;35118
53;35;01;10;119;Gennes-sur-Seiche;946;21;967;35119
53;35;03;14;120;Gévezé;5521;109;5630;35120
53;35;03;08;121;Gosné;2000;37;2037;35121
53;35;04;25;122;La Gouesnière;1943;46;1989;35122
53;35;02;11;123;Goven;4321;90;4411;35123
53;35;02;02;124;Grand-Fougeray;2455;38;2493;35124
53;35;01;10;125;La Guerche-de-Bretagne;4249;147;4396;35125
53;35;02;11;126;Guichen;8674;203;8877;35126
53;35;02;11;127;Guignen;3986;97;4083;35127
53;35;03;14;128;Guipel;1701;39;1740;35128
53;35;04;14;130;Hédé-Bazouges;2247;54;2301;35130
53;35;03;24;131;L'Hermitage;4629;81;4710;35131
53;35;04;07;132;Hirel;1389;34;1423;35132
53;35;03;16;133;Iffendic;4553;93;4646;35133
53;35;04;06;134;Les Iffs;273;12;285;35134
53;35;03;15;135;IrodouÃ«r;2263;37;2300;35135
53;35;01;12;136;Janzé;8470;159;8629;35136
53;35;01;08;137;Javené;2105;70;2175;35137
53;35;01;09;138;Laignelet;1173;28;1201;35138
53;35;03;04;139;Laillé;5116;149;5265;35139
53;35;02;02;140;Lalleu;561;10;571;35140
53;35;01;27;141;Landavran;693;21;714;35141
53;35;01;09;142;Landéan;1183;22;1205;35142
53;35;03;15;143;Landujan;929;30;959;35143
53;35;03;15;144;Langan;1031;19;1050;35144
53;35;02;17;145;Langon;1385;25;1410;35145
53;35;03;14;146;Langouet;606;2;608;35146
53;35;04;06;148;Lanrigan;157;0;157;35148
53;35;02;11;149;Lassy;1757;39;1796;35149
53;35;01;08;150;Lécousse;3260;95;3355;35150
53;35;02;17;151;Lieuron;777;15;792;35151
53;35;03;13;152;Liffré;7949;137;8086;35152
53;35;04;07;153;Lillemer;367;11;378;35153
53;35;03;08;154;Livré-sur-Changeon;1718;41;1759;35154
53;35;02;17;155;Lohéac;648;15;663;35155
53;35;04;06;156;Longaulnay;612;10;622;35156
53;35;01;09;157;Le Loroux;643;15;658;35157
53;35;04;06;159;Lourmais;326;3;329;35159
53;35;02;11;160;Loutehel;247;5;252;35160
53;35;01;05;161;Louvigné-de-Bais;1912;36;1948;35161
53;35;01;09;162;Louvigné-du-Désert;3340;59;3399;35162
53;35;01;09;163;Luitré-Dompierre;1823;29;1852;35163
53;35;01;01;164;Marcillé-Raoul;743;11;754;35164
53;35;01;10;165;Marcillé-Robert;951;21;972;35165
53;35;01;27;166;Marpiré;1027;15;1042;35166
53;35;01;10;167;Martigné-Ferchaud;2583;65;2648;35167
53;35;02;11;168;Val d'Anast;3954;81;4035;35168
53;35;03;16;169;Maxent;1470;17;1487;35169
53;35;01;27;170;Mecé;607;16;623;35170
53;35;03;15;171;Médréac;1819;48;1867;35171
53;35;04;06;172;Meillac;1918;30;1948;35172
53;35;03;14;173;Melesse;6958;107;7065;35173
53;35;01;09;174;Mellé;649;12;661;35174
53;35;02;11;175;Mernel;1012;16;1028;35175
53;35;02;17;176;Guipry-Messac;7107;142;7249;35176
53;35;03;14;177;La Mézière;4971;121;5092;35177
53;35;03;08;178;Mézières-sur-Couesnon;1799;19;1818;35178
53;35;04;07;179;Miniac-Morvan;4148;80;4228;35179
53;35;03;15;180;Miniac-sous-Bécherel;792;16;808;35180
53;35;04;26;181;Le Minihic-sur-Rance;1483;35;1518;35181
53;35;01;27;183;Mondevert;820;21;841;35183
53;35;03;15;184;Montauban-de-Bretagne;6086;246;6332;35184
53;35;01;27;185;Montautour;266;1;267;35185
53;35;04;07;186;Mont-Dol;1085;31;1116;35186
53;35;03;16;187;Monterfil;1332;45;1377;35187
53;35;03;16;188;Montfort-sur-Meu;6726;173;6899;35188
53;35;03;03;189;Montgermont;3515;62;3577;35189
53;35;01;09;190;Monthault;250;8;258;35190
53;35;01;01;191;Les Portes du Coglais;2319;49;2368;35191
53;35;01;27;192;Montreuil-des-Landes;232;5;237;35192
53;35;03;14;193;Montreuil-le-Gast;1972;44;2016;35193
53;35;01;27;194;Montreuil-sous-Pérouse;1006;32;1038;35194
53;35;03;01;195;Montreuil-sur-Ille;2390;35;2425;35195
53;35;03;24;196;Mordelles;7338;141;7479;35196
53;35;03;01;197;Mouazé;1718;19;1737;35197
53;35;01;10;198;Moulins;713;25;738;35198
53;35;01;10;199;Moussé;343;9;352;35199
53;35;01;10;200;Moutiers;919;16;935;35200
53;35;03;15;201;Muel;885;7;892;35201
53;35;02;02;202;La NoÃ«-Blanche;1022;9;1031;35202
53;35;03;16;203;La Nouaye;353;5;358;35203
53;35;03;12;204;Nouvoitou;3281;59;3340;35204
53;35;01;01;205;Noyal-sous-Bazouges;380;8;388;35205
53;35;03;04;206;Noyal-Châtillon-sur-Seiche;7003;127;7130;35206
53;35;03;05;207;Noyal-sur-Vilaine;6133;150;6283;35207
53;35;03;12;208;Orgères;5152;124;5276;35208
53;35;03;23;210;Pacé;11860;329;12189;35210
53;35;03;16;211;Paimpont;1772;40;1812;35211
53;35;02;02;212;Pancé;1191;32;1223;35212
53;35;01;08;214;Parcé;649;1;650;35214
53;35;01;09;215;Parigné;1331;43;1374;35215
53;35;03;14;216;Parthenay-de-Bretagne;1780;28;1808;35216
53;35;01;10;217;Le Pertre;1380;29;1409;35217
53;35;02;02;218;Le Petit-Fougeray;883;20;903;35218
53;35;02;17;219;Pipriac;3813;76;3889;35219
53;35;03;05;220;Piré-Chancé;3031;54;3085;35220
53;35;02;02;221;Pléchâtel;2780;54;2834;35221
53;35;04;07;222;Pleine-Fougères;1973;33;2006;35222
53;35;03;16;223;Plélan-le-Grand;4008;87;4095;35223
53;35;04;07;224;Plerguer;2796;52;2848;35224
53;35;04;06;225;Plesder;781;15;796;35225
53;35;04;06;226;Pleugueneuc;1927;27;1954;35226
53;35;03;16;227;Pleumeleuc;3474;51;3525;35227
53;35;04;26;228;Pleurtuit;6982;124;7106;35228
53;35;01;27;229;Pocé-les-Bois;1319;52;1371;35229
53;35;01;09;230;Poilley;374;4;378;35230
53;35;02;02;231;Poligné;1195;31;1226;35231
53;35;01;27;232;Princé;391;7;398;35232
53;35;04;06;233;Québriac;1578;37;1615;35233
53;35;03;15;234;Quédillac;1194;17;1211;35234
53;35;01;10;235;Rannée;1076;47;1123;35235
53;35;02;17;236;Redon;9287;745;10032;35236
53;35;02;17;237;Renac;1034;22;1056;35237
53;35;03;98;238;Rennes;220488;4167;224655;35238
53;35;01;10;239;Retiers;4438;96;4534;35239
53;35;03;24;240;Le Rheu;8932;293;9225;35240
53;35;04;26;241;La Richardais;2403;85;2488;35241
53;35;01;01;242;Rimou;345;4;349;35242
53;35;01;08;243;Romagné;2458;55;2513;35243
53;35;01;01;244;Romazy;248;3;251;35244
53;35;03;15;245;Romillé;4032;73;4105;35245
53;35;04;07;246;Roz-Landrieux;1361;27;1388;35246
53;35;04;07;247;Roz-sur-Couesnon;998;12;1010;35247
53;35;04;07;248;Sains;459;8;467;35248
53;35;02;02;249;Sainte-Anne-sur-Vilaine;1029;14;1043;35249
53;35;03;12;250;Saint-Armel;2206;39;2245;35250
53;35;03;01;251;Saint-Aubin-d'Aubigné;3916;82;3998;35251
53;35;01;27;252;Saint-Aubin-des-Landes;923;34;957;35252
53;35;03;08;253;Saint-Aubin-du-Cormier;4006;162;4168;35253
53;35;04;07;255;Saint-Benoît-des-Ondes;975;30;1005;35255
53;35;04;26;256;Saint-Briac-sur-Mer;2193;63;2256;35256
53;35;01;01;257;Maen Roch;4958;96;5054;35257
53;35;04;06;258;Saint-Brieuc-des-Iffs;331;9;340;35258
53;35;04;07;259;Saint-Broladre;1140;22;1162;35259
53;35;01;27;260;Saint-Christophe-des-Bois;563;6;569;35260
53;35;01;08;261;Saint-Christophe-de-Valains;235;2;237;35261
53;35;01;10;262;Sainte-Colombe;356;6;362;35262
53;35;04;25;263;Saint-Coulomb;2820;88;2908;35263
53;35;01;05;264;Saint-Didier;2034;45;2079;35264
53;35;04;06;265;Saint-Domineuc;2562;49;2611;35265
53;35;03;12;266;Saint-Erblon;3311;73;3384;35266
53;35;02;17;268;Saint-Ganton;429;8;437;35268
53;35;04;07;270;Saint-Georges-de-Gréhaigne;371;4;375;35270
53;35;01;09;271;Saint-Georges-de-Reintembault;1487;26;1513;35271
53;35;01;10;272;Saint-Germain-du-Pinel;951;23;974;35272
53;35;01;01;273;Saint-Germain-en-Coglès;2062;31;2093;35273
53;35;03;14;274;Saint-Germain-sur-Ille;962;15;977;35274
53;35;03;14;275;Saint-Gilles;5178;85;5263;35275
53;35;03;14;276;Saint-Gondran;571;12;583;35276
53;35;03;16;277;Saint-Gonlay;377;6;383;35277
53;35;03;03;278;Saint-Grégoire;9890;372;10262;35278
53;35;04;07;279;Saint-Guinoux;1207;28;1235;35279
53;35;01;01;280;Saint-Hilaire-des-Landes;1025;20;1045;35280
53;35;03;22;281;Saint-Jacques-de-la-Lande;13948;158;14106;35281
53;35;01;08;282;Rives-du-Couesnon;2886;52;2938;35282
53;35;01;05;283;Saint-Jean-sur-Vilaine;1334;23;1357;35283
53;35;04;26;284;Saint-Jouan-des-Guérets;2683;71;2754;35284
53;35;02;17;285;Saint-Just;1055;23;1078;35285
53;35;04;06;286;Saint-Léger-des-Prés;284;10;294;35286
53;35;04;26;287;Saint-Lunaire;2460;88;2548;35287
53;35;04;99;288;Saint-Malo;46803;1338;48141;35288
53;35;02;17;289;Saint-Malo-de-Phily;1076;18;1094;35289
53;35;03;15;290;Saint-Malon-sur-Mel;578;11;589;35290
53;35;04;07;291;Saint-Marcan;437;9;446;35291
53;35;01;01;292;Saint-Marc-le-Blanc;1633;39;1672;35292
53;35;02;17;294;Sainte-Marie;2265;65;2330;35294
53;35;03;15;295;Saint-Maugan;538;11;549;35295
53;35;03;14;296;Saint-Médard-sur-Ille;1322;23;1345;35296
53;35;03;15;297;Saint-Méen-le-Grand;4599;164;4763;35297
53;35;04;25;299;Saint-Méloir-des-Ondes;4327;108;4435;35299
53;35;01;27;300;Saint-M'Hervé;1356;39;1395;35300
53;35;03;15;302;Saint-Onen-la-Chapelle;1127;24;1151;35302
53;35;01;08;304;Saint-Ouen-des-Alleux;1313;29;1342;35304
53;35;03;16;305;Saint-Péran;418;8;426;35305
53;35;04;07;306;Saint-Père-Marc-en-Poulet;2333;163;2496;35306
53;35;03;15;307;Saint-Pern;1042;19;1061;35307
53;35;04;06;308;Mesnil-Roc'h;4336;75;4411;35308
53;35;01;01;309;Saint-Rémy-du-Plain;819;13;832;35309
53;35;01;08;310;Saint-Sauveur-des-Landes;1531;27;1558;35310
53;35;02;11;311;Saint-Séglin;584;4;588;35311
53;35;02;11;312;Saint-Senoux;1829;48;1877;35312
53;35;04;07;314;Saint-Suliac;943;50;993;35314
53;35;03;13;315;Saint-Sulpice-la-Forêt;1382;41;1423;35315
53;35;02;02;316;Saint-Sulpice-des-Landes;827;9;836;35316
53;35;03;14;317;Saint-Symphorien;589;61;650;35317
53;35;04;06;318;Saint-Thual;947;21;968;35318
53;35;03;16;319;Saint-Thurial;2114;43;2157;35319
53;35;03;15;320;Saint-Uniac;540;4;544;35320
53;35;02;02;321;Saulnières;794;10;804;35321
53;35;02;02;322;Le Sel-de-Bretagne;1109;27;1136;35322
53;35;01;09;324;La Selle-en-Luitré;616;17;633;35324
53;35;01;10;325;La Selle-Guerchaise;155;6;161;35325
53;35;03;01;326;Sens-de-Bretagne;2566;41;2607;35326
53;35;03;05;327;Servon-sur-Vilaine;3804;88;3892;35327
53;35;02;17;328;Sixt-sur-Aff;2135;43;2178;35328
53;35;04;07;329;Sougéal;547;11;558;35329
53;35;01;27;330;Taillis;993;26;1019;35330
53;35;03;16;331;Talensac;2489;51;2540;35331
53;35;02;02;332;Teillay;1069;11;1080;35332
53;35;01;10;333;Le Theil-de-Bretagne;1725;33;1758;35333
53;35;03;13;334;Thorigné-Fouillard;8575;211;8786;35334
53;35;01;10;335;Thourie;837;22;859;35335
53;35;01;01;336;Le Tiercent;182;3;185;35336
53;35;04;06;337;Tinténiac;3739;191;3930;35337
53;35;01;10;338;Torcé;1223;29;1252;35338
53;35;04;07;339;Trans-la-Forêt;591;4;595;35339
53;35;03;16;340;Treffendel;1307;24;1331;35340
53;35;04;06;342;Trémeheuc;347;12;359;35342
53;35;02;02;343;TresbÅ“uf;1244;20;1264;35343
53;35;04;06;345;Trévérien;895;23;918;35345
53;35;04;06;346;Trimer;209;4;213;35346
53;35;01;27;347;Val-d'Izé;2580;57;2637;35347
53;35;01;10;350;Vergéal;806;24;830;35350
53;35;03;24;351;Le Verger;1436;24;1460;35351
53;35;03;12;352;Vern-sur-Seiche;8169;146;8315;35352
53;35;03;24;353;Vezin-le-Coquet;6114;113;6227;35353
53;35;04;07;354;Vieux-Viel;317;2;319;35354
53;35;03;01;355;Vieux-Vy-sur-Couesnon;1245;6;1251;35355
53;35;03;14;356;Vignoc;2025;25;2050;35356
53;35;01;09;357;Villamée;306;5;311;35357
53;35;04;07;358;La Ville-ès-Nonais;1220;32;1252;35358
53;35;01;10;359;Visseiche;838;17;855;35359
53;35;01;27;360;Vitré;18487;553;19040;35360
53;35;04;07;361;Le Vivier-sur-Mer;1054;7;1061;35361
53;35;04;07;362;Le Tronchet;1177;9;1186;35362
53;35;03;04;363;Pont-Péan;4413;106;4519;35363
24;36;03;11;001;Aigurande;1420;27;1447;36001
24;36;04;10;002;Aize;118;0;118;36002
24;36;04;01;003;Ambrault;891;23;914;36003
24;36;04;13;004;Anjouin;322;8;330;36004
24;36;02;01;005;Ardentes;3850;82;3932;36005
24;36;02;02;006;Argenton-sur-Creuse;4880;213;5093;36006
24;36;02;04;007;Argy;601;9;610;36007
24;36;02;04;008;Arpheuilles;222;9;231;36008
24;36;02;01;009;Arthon;1218;43;1261;36009
24;36;01;03;010;Azay-le-Ferron;867;18;885;36010
24;36;04;13;011;Bagneux;175;2;177;36011
24;36;02;02;012;Baraize;363;0;363;36012
24;36;02;10;013;Baudres;428;5;433;36013
24;36;02;02;014;Bazaiges;199;6;205;36014
24;36;01;12;015;Beaulieu;54;1;55;36015
24;36;01;12;016;Bélâbre;945;22;967;36016
24;36;03;08;017;La Berthenoux;368;5;373;36017
24;36;01;03;018;Le Blanc;6250;222;6472;36018
24;36;04;08;019;Bommiers;312;5;317;36019
24;36;01;12;020;Bonneuil;74;1;75;36020
24;36;04;09;021;Les Bordes;891;20;911;36021
24;36;02;02;022;Bouesse;410;8;418;36022
24;36;02;10;023;Bouges-le-Château;261;5;266;36023
24;36;02;10;024;Bretagne;130;1;131;36024
24;36;03;08;025;Briantes;608;11;619;36025
24;36;02;10;026;Brion;596;8;604;36026
24;36;04;08;027;Brives;249;6;255;36027
24;36;03;11;028;La Buxerette;115;2;117;36028
24;36;04;10;029;Buxeuil;230;3;233;36029
24;36;03;11;030;Buxières-d'Aillac;244;4;248;36030
24;36;02;04;031;Buzançais;4516;74;4590;36031
24;36;02;02;032;Ceaulmont;724;22;746;36032
24;36;02;02;033;Celon;398;4;402;36033
24;36;04;13;034;Chabris;2763;38;2801;36034
24;36;01;12;035;Chaillac;1086;14;1100;36035
24;36;01;12;036;Chalais;149;1;150;36036
24;36;04;10;037;La Champenoise;283;6;289;36037
24;36;03;08;038;Champillet;137;2;139;36038
24;36;02;04;040;La Chapelle-Orthemale;102;0;102;36040
24;36;04;10;041;La Chapelle-Saint-Laurian;140;1;141;36041
24;36;02;02;042;Chasseneuil;703;11;714;36042
24;36;03;11;043;Chassignolles;574;23;597;36043
24;36;02;99;044;Châteauroux;43122;1540;44662;36044
24;36;02;04;045;Châtillon-sur-Indre;2360;34;2394;36045
24;36;03;08;046;La Châtre;4054;117;4171;36046
24;36;01;12;047;La Châtre-Langlin;504;8;512;36047
24;36;02;02;048;Chavin;271;9;280;36048
24;36;01;12;049;Chazelet;125;2;127;36049
24;36;02;04;050;Chezelles;457;7;464;36050
24;36;01;12;051;Chitray;186;5;191;36051
24;36;04;09;052;Chouday;153;2;155;36052
24;36;01;03;053;Ciron;543;13;556;36053
24;36;02;04;054;Cléré-du-Bois;233;7;240;36054
24;36;02;04;055;Clion;1004;18;1022;36055
24;36;03;11;056;Cluis;984;15;999;36056
24;36;02;10;057;Coings;881;23;904;36057
24;36;01;03;058;Concremiers;645;17;662;36058
24;36;04;08;059;Condé;233;8;241;36059
24;36;03;11;060;Crevant;703;14;717;36060
24;36;03;11;061;Crozon-sur-Vauvre;332;9;341;36061
24;36;02;02;062;Cuzion;441;6;447;36062
24;36;02;05;063;Déols;7609;149;7758;36063
24;36;02;01;064;Diors;749;16;765;36064
24;36;04;10;065;Diou;260;5;265;36065
24;36;01;03;066;Douadic;441;14;455;36066
24;36;01;12;067;Dunet;101;3;104;36067
24;36;04;13;068;Dun-le-PoÃ«lier;422;7;429;36068
24;36;02;13;069;Ecueillé;1216;23;1239;36069
24;36;02;02;070;Eguzon-Chantôme;1345;37;1382;36070
24;36;02;01;071;Etrechet;1012;20;1032;36071
24;36;03;08;073;Feusines;213;5;218;36073
24;36;02;04;074;Fléré-la-Rivière;536;9;545;36074
24;36;04;10;075;Fontenay;89;1;90;36075
24;36;01;03;076;Fontgombault;249;3;252;36076
24;36;02;13;077;Fontguenand;245;3;248;36077
24;36;03;11;078;Fougerolles;356;5;361;36078
24;36;02;10;079;Francillon;77;1;78;36079
24;36;02;13;080;Frédille;72;2;74;36080
24;36;02;02;081;Gargilesse-Dampierre;280;8;288;36081
24;36;02;13;082;Gehée;252;1;253;36082
24;36;04;10;083;Giroux;117;4;121;36083
24;36;03;11;084;Gournay;287;2;289;36084
24;36;04;10;085;Guilly;247;6;253;36085
24;36;02;13;086;Heugnes;390;8;398;36086
24;36;01;03;087;Ingrandes;312;5;317;36087
24;36;04;09;088;Issoudun;11477;290;11767;36088
24;36;02;01;089;Jeu-les-Bois;405;6;411;36089
24;36;02;13;090;Jeu-Maloches;118;2;120;36090
24;36;03;08;091;Lacs;656;18;674;36091
24;36;02;13;092;Langé;270;8;278;36092
24;36;02;10;093;Levroux;2923;37;2960;36093
24;36;01;12;094;Lignac;449;7;456;36094
24;36;03;08;095;Lignerolles;106;2;108;36095
24;36;01;03;096;Lingé;214;3;217;36096
24;36;04;10;097;Liniez;323;9;332;36097
24;36;04;10;098;Lizeray;85;3;88;36098
24;36;03;11;099;Lourdoueix-Saint-Michel;299;4;303;36099
24;36;03;08;100;Lourouer-Saint-Laurent;261;6;267;36100
24;36;02;12;101;Luant;1536;39;1575;36101
24;36;04;10;102;Luçay-le-Libre;102;2;104;36102
24;36;02;13;103;Luçay-le-Mâle;1340;16;1356;36103
24;36;01;03;104;Lurais;234;2;236;36104
24;36;01;03;105;Lureuil;257;3;260;36105
24;36;01;12;106;Luzeret;155;1;156;36106
24;36;02;13;107;Lye;728;12;740;36107
24;36;03;11;108;Lys-Saint-Georges;214;2;216;36108
24;36;03;11;109;Le Magny;1054;19;1073;36109
24;36;03;11;110;Maillet;260;6;266;36110
24;36;03;11;111;Malicornay;193;3;196;36111
24;36;02;01;112;Mâron;750;19;769;36112
24;36;01;03;113;Martizay;938;20;958;36113
24;36;01;12;114;Mauvières;296;8;304;36114
24;36;04;13;115;Menetou-sur-Nahon;128;2;130;36115
24;36;04;10;116;Ménétréols-sous-Vatan;118;1;119;36116
24;36;02;02;117;Le Menoux;429;7;436;36117
24;36;02;12;118;Méobecq;378;3;381;36118
24;36;01;03;119;Mérigny;540;13;553;36119
24;36;03;11;120;Mers-sur-Indre;669;12;681;36120
24;36;04;08;121;Meunet-Planches;172;6;178;36121
24;36;04;10;122;Meunet-sur-Vatan;197;2;199;36122
24;36;01;03;123;Mézières-en-Brenne;990;20;1010;36123
24;36;01;12;124;Migné;274;11;285;36124
24;36;04;09;125;Migny;120;5;125;36125
24;36;03;11;126;Montchevrier;446;5;451;36126
24;36;03;11;127;Montgivray;1570;36;1606;36127
24;36;02;01;128;Montierchaume;1673;167;1840;36128
24;36;03;11;129;Montipouret;557;14;571;36129
24;36;03;08;130;Montlevicq;108;2;110;36130
24;36;02;02;131;Mosnay;472;7;479;36131
24;36;03;08;132;La Motte-Feuilly;64;3;67;36132
24;36;03;11;133;Mouhers;216;6;222;36133
24;36;01;12;134;Mouhet;402;12;414;36134
24;36;02;10;135;Moulins-sur-Céphons;295;6;301;36135
24;36;02;04;136;Murs;129;3;132;36136
24;36;01;03;137;Néons-sur-Creuse;365;16;381;36137
24;36;03;08;138;Néret;187;7;194;36138
24;36;02;12;139;Neuillay-les-Bois;657;16;673;36139
24;36;04;08;140;Neuvy-Pailloux;1174;21;1195;36140
24;36;03;11;141;Neuvy-Saint-Sépulchre;1652;38;1690;36141
24;36;02;04;142;Niherne;1583;31;1614;36142
24;36;03;08;143;Nohant-Vic;449;13;462;36143
24;36;01;12;144;Nuret-le-Ferron;295;7;302;36144
24;36;01;03;145;Obterre;177;3;180;36145
24;36;03;11;146;Orsennes;728;10;738;36146
24;36;04;13;147;Orville;138;3;141;36147
24;36;01;12;148;Oulches;410;3;413;36148
24;36;02;04;149;Palluau-sur-Indre;794;12;806;36149
24;36;01;12;150;Parnac;496;9;505;36150
24;36;04;10;152;Paudy;440;3;443;36152
24;36;01;03;153;Paulnay;339;8;347;36153
24;36;02;02;154;Le Pêchereau;1859;38;1897;36154
24;36;02;13;155;Pellevoisin;791;55;846;36155
24;36;03;08;156;Pérassay;366;2;368;36156
24;36;01;12;157;La Pérouille;451;13;464;36157
24;36;02;02;158;Badecon-le-Pin;765;9;774;36158
24;36;02;01;159;Le Poinçonnet;5820;174;5994;36159
24;36;02;02;160;Pommiers;214;5;219;36160
24;36;02;02;161;Le Pont-Chrétien-Chabenet;937;10;947;36161
24;36;04;13;162;Poulaines;826;19;845;36162
24;36;03;08;163;Pouligny-Notre-Dame;669;11;680;36163
24;36;03;08;164;Pouligny-Saint-Martin;225;3;228;36164
24;36;01;03;165;Pouligny-Saint-Pierre;1036;28;1064;36165
24;36;02;13;166;Préaux;166;4;170;36166
24;36;01;03;167;Preuilly-la-Ville;157;3;160;36167
24;36;01;12;168;Prissac;586;15;601;36168
24;36;04;08;169;Pruniers;511;10;521;36169
24;36;04;10;170;Reboursin;104;0;104;36170
24;36;04;10;171;Reuilly;2010;37;2047;36171
24;36;01;12;172;Rivarennes;528;10;538;36172
24;36;01;03;173;Rosnay;519;13;532;36173
24;36;01;12;174;Roussines;361;11;372;36174
24;36;02;10;175;Rouvres-les-Bois;276;2;278;36175
24;36;01;03;176;Ruffec;586;8;594;36176
24;36;01;12;177;Sacierges-Saint-Martin;325;6;331;36177
24;36;01;03;178;Saint-Aigny;277;12;289;36178
24;36;04;10;179;Saint-Aoustrille;232;0;232;36179
24;36;03;08;180;Saint-Août;825;18;843;36180
24;36;04;08;181;Saint-Aubin;167;3;170;36181
24;36;01;12;182;Saint-Benoît-du-Sault;576;17;593;36182
24;36;03;08;184;Saint-Chartier;495;8;503;36184
24;36;04;13;185;Saint-Christophe-en-Bazelle;362;3;365;36185
24;36;03;08;186;Saint-Christophe-en-Boucherie;256;3;259;36186
24;36;01;12;187;Saint-Civran;132;2;134;36187
24;36;02;04;188;Saint-Cyran-du-Jambot;182;150;332;36188
24;36;03;11;189;Saint-Denis-de-Jouhet;967;13;980;36189
24;36;04;01;190;Sainte-Fauste;270;1;271;36190
24;36;04;10;191;Saint-Florentin;532;7;539;36191
24;36;01;12;192;Saint-Gaultier;1772;23;1795;36192
24;36;01;03;193;Sainte-Gemme;256;8;264;36193
24;36;02;04;194;Saint-Genou;950;16;966;36194
24;36;04;09;195;Saint-Georges-sur-Arnon;571;14;585;36195
24;36;01;12;196;Saint-Gilles;100;3;103;36196
24;36;01;12;197;Saint-Hilaire-sur-Benaize;292;7;299;36197
24;36;02;04;198;Saint-Lactencin;406;14;420;36198
24;36;04;10;199;Sainte-Lizaigne;1145;24;1169;36199
24;36;02;02;200;Saint-Marcel;1506;24;1530;36200
24;36;02;89;202;Saint-Maur;3685;77;3762;36202
24;36;02;04;203;Saint-Médard;52;0;52;36203
24;36;01;03;204;Saint-Michel-en-Brenne;323;7;330;36204
24;36;04;10;205;Saint-Pierre-de-Jards;109;4;113;36205
24;36;03;11;207;Saint-Plantaire;611;13;624;36207
24;36;03;08;208;Sainte-Sévère-sur-Indre;774;14;788;36208
24;36;04;10;209;Saint-Valentin;268;13;281;36209
24;36;03;11;210;Sarzay;300;11;311;36210
24;36;02;01;211;Sassierges-Saint-Germain;457;8;465;36211
24;36;01;03;212;Saulnay;155;2;157;36212
24;36;01;03;213;Sauzelles;256;4;260;36213
24;36;03;08;214;Sazeray;300;10;310;36214
24;36;04;09;215;Ségry;496;13;509;36215
24;36;02;13;216;Selles-sur-Nahon;65;1;66;36216
24;36;04;13;217;Sembleçay;98;3;101;36217
24;36;02;04;218;Sougé;144;6;150;36218
24;36;02;02;219;Tendu;648;7;655;36219
24;36;01;12;220;Thenay;896;18;914;36220
24;36;03;08;221;Thevet-Saint-Julien;382;8;390;36221
24;36;04;08;222;Thizay;234;7;241;36222
24;36;01;12;223;Tilly;139;4;143;36223
24;36;01;03;224;Tournon-Saint-Martin;1132;25;1157;36224
24;36;02;04;225;Le Tranger;181;1;182;36225
24;36;03;11;226;Tranzault;353;1;354;36226
24;36;03;08;227;Urciers;248;2;250;36227
24;36;02;13;228;Valençay;2338;107;2445;36228
24;36;04;13;229;Val-Fouzon;957;10;967;36229
24;36;04;10;230;Vatan;1945;39;1984;36230
24;36;02;02;231;Velles;964;20;984;36231
24;36;02;12;232;VendÅ“uvres;1052;16;1068;36232
24;36;02;13;233;La Vernelle;741;8;749;36233
24;36;03;08;234;Verneuil-sur-Igneraie;326;6;332;36234
24;36;02;13;235;Veuil;376;8;384;36235
24;36;03;08;236;Vicq-Exemplet;317;5;322;36236
24;36;02;13;237;Vicq-sur-Nahon;716;19;735;36237
24;36;03;08;238;Vigoulant;99;3;102;36238
24;36;01;12;239;Vigoux;461;6;467;36239
24;36;03;08;240;Vijon;298;4;302;36240
24;36;02;04;241;Villedieu-sur-Indre;2687;47;2734;36241
24;36;02;10;242;Villegongis;107;1;108;36242
24;36;02;13;243;Villegouin;319;4;323;36243
24;36;02;13;244;Villentrois-Faverolles-en-Berry;873;6;879;36244
24;36;01;03;246;Villiers;168;2;170;36246
24;36;02;10;247;Vineuil;1228;22;1250;36247
24;36;04;01;248;Vouillon;231;3;234;36248
24;37;03;06;001;Abilly;1149;17;1166;37001
24;37;01;08;002;Ambillou;1757;29;1786;37002
24;37;03;01;003;Amboise;12533;379;12912;37003
24;37;01;13;004;Anché;423;11;434;37004
24;37;01;13;005;Antogny-le-Tillac;508;5;513;37005
24;37;02;11;006;Artannes-sur-Indre;2649;52;2701;37006
24;37;01;13;007;Assay;166;4;170;37007
24;37;03;03;008;Athée-sur-Cher;2716;39;2755;37008
24;37;03;04;009;Autrèche;439;4;443;37009
24;37;03;04;010;Auzouer-en-Touraine;2222;70;2292;37010
24;37;01;05;011;Avoine;1868;39;1907;37011
24;37;01;13;012;Avon-les-Roches;554;3;557;37012
24;37;01;08;013;Avrillé-les-Ponceaux;468;10;478;37013
24;37;02;05;014;Azay-le-Rideau;3501;99;3600;37014
24;37;02;03;015;Azay-sur-Cher;3099;68;3167;37015
24;37;03;09;016;Azay-sur-Indre;367;14;381;37016
24;37;02;02;018;Ballan-Miré;8102;140;8242;37018
24;37;03;06;019;Barrou;455;10;465;37019
24;37;03;09;020;Beaulieu-lès-Loches;1761;33;1794;37020
24;37;01;04;021;Beaumont-Louestault;1719;19;1738;37021
24;37;01;05;022;Beaumont-en-Véron;2689;90;2779;37022
24;37;03;09;023;Beaumont-Village;242;5;247;37023
24;37;01;08;024;Benais;906;27;933;37024
24;37;02;02;025;Berthenay;692;6;698;37025
24;37;03;06;026;Betz-le-Château;536;4;540;37026
24;37;03;03;027;Bléré;5257;65;5322;37027
24;37;03;06;028;Bossay-sur-Claise;744;23;767;37028
24;37;03;06;029;Bossée;328;5;333;37029
24;37;03;04;030;Le Boulay;795;7;802;37030
24;37;01;08;031;Bourgueil;3894;77;3971;37031
24;37;03;06;032;Bournan;271;7;278;37032
24;37;03;06;033;Boussay;210;5;215;37033
24;37;01;13;034;Braslou;301;7;308;37034
24;37;01;13;035;Braye-sous-Faye;291;6;297;37035
24;37;01;08;036;Braye-sur-Maulne;189;1;190;37036
24;37;01;08;037;Brèches;215;5;220;37037
24;37;02;05;038;Bréhémont;750;8;758;37038
24;37;03;09;039;Bridoré;494;13;507;37039
24;37;01;13;040;Brizay;262;9;271;37040
24;37;01;04;041;Bueil-en-Touraine;323;5;328;37041
24;37;01;05;042;Candes-Saint-Martin;185;3;188;37042
24;37;03;01;043;Cangey;1051;24;1075;37043
24;37;03;06;044;La Celle-Guenand;369;5;374;37044
24;37;03;06;045;La Celle-Saint-Avant;1059;15;1074;37045
24;37;03;03;046;Céré-la-Ronde;437;8;445;37046
24;37;01;04;047;Cerelles;1215;26;1241;37047
24;37;03;06;048;Chambon;321;5;326;37048
24;37;03;09;049;Chambourg-sur-Indre;1250;25;1275;37049
24;37;02;10;050;Chambray-lès-Tours;11880;262;12142;37050
24;37;01;13;051;Champigny-sur-Veude;829;8;837;37051
24;37;02;19;052;Chançay;1135;18;1153;37052
24;37;03;09;053;Chanceaux-près-Loches;119;7;126;37053
24;37;02;19;054;Chanceaux-sur-Choisille;3525;47;3572;37054
24;37;01;08;055;Channay-sur-Lathan;816;16;832;37055
24;37;02;05;056;La Chapelle-aux-Naux;569;10;579;37056
24;37;03;06;057;La Chapelle-Blanche-Saint-Martin;681;14;695;37057
24;37;01;08;058;La Chapelle-sur-Loire;1446;26;1472;37058
24;37;01;04;059;Charentilly;1306;31;1337;37059
24;37;03;01;060;Chargé;1311;20;1331;37060
24;37;03;06;061;Charnizay;501;16;517;37061
24;37;01;08;062;Château-la-Vallière;1736;18;1754;37062
24;37;03;04;063;Château-Renault;4917;78;4995;37063
24;37;03;06;064;Chaumussay;226;7;233;37064
24;37;01;13;065;Chaveignes;549;5;554;37065
24;37;03;09;066;Chédigny;560;5;565;37066
24;37;02;05;067;Cheillé;1816;21;1837;37067
24;37;01;04;068;Chemillé-sur-Dême;729;10;739;37068
24;37;03;09;069;Chemillé-sur-Indrois;230;8;238;37069
24;37;03;03;070;Chenonceaux;351;5;356;37070
24;37;01;13;071;Chezelles;132;2;134;37071
24;37;01;05;072;Chinon;8104;318;8422;37072
24;37;03;03;073;Chisseaux;583;14;597;37073
24;37;01;08;074;Chouzé-sur-Loire;2085;24;2109;37074
24;37;03;03;075;Cigogné;461;5;466;37075
24;37;01;05;076;Cinais;398;10;408;37076
24;37;01;08;077;Cinq-Mars-la-Pile;3729;51;3780;37077
24;37;03;06;078;Ciran;412;8;420;37078
24;37;03;03;079;Civray-de-Touraine;1791;57;1848;37079
24;37;03;06;080;Civray-sur-Esves;203;4;207;37080
24;37;01;08;081;Cléré-les-Pins;1401;20;1421;37081
24;37;01;08;082;Continvoir;447;4;451;37082
24;37;03;03;083;Cormery;1800;26;1826;37083
24;37;01;08;084;Couesmes;538;6;544;37084
24;37;03;03;085;Courçay;801;23;824;37085
24;37;01;08;086;Courcelles-de-Touraine;498;8;506;37086
24;37;01;13;087;Courcoué;247;9;256;37087
24;37;01;05;088;Couziers;110;1;111;37088
24;37;01;13;089;Cravant-les-Côteaux;655;18;673;37089
24;37;01;13;090;Crissay-sur-Manse;109;2;111;37090
24;37;03;03;091;La Croix-en-Touraine;2379;59;2438;37091
24;37;03;04;092;Crotelles;665;14;679;37092
24;37;01;13;093;Crouzilles;535;6;541;37093
24;37;03;06;094;Cussay;561;16;577;37094
24;37;03;04;095;Dame-Marie-les-Bois;347;7;354;37095
24;37;03;03;096;Dierre;619;10;629;37096
24;37;03;09;097;Dolus-le-Sec;673;23;696;37097
24;37;03;06;098;Draché;751;19;770;37098
24;37;02;02;099;Druye;964;12;976;37099
24;37;03;03;100;Epeigné-les-Bois;406;4;410;37100
24;37;01;04;101;Epeigné-sur-Dême;155;2;157;37101
24;37;03;06;103;Esves-le-Moutier;144;2;146;37103
24;37;02;11;104;Esvres;6109;111;6220;37104
24;37;01;13;105;Faye-la-Vineuse;253;6;259;37105
24;37;03;04;106;La Ferrière;320;4;324;37106
24;37;03;06;107;Ferrière-Larçon;238;5;243;37107
24;37;03;09;108;Ferrière-sur-Beaulieu;716;14;730;37108
24;37;02;12;109;Fondettes;10301;523;10824;37109
24;37;03;03;110;Francueil;1383;35;1418;37110
24;37;03;09;111;Genillé;1505;32;1537;37111
24;37;01;08;112;Gizeux;378;7;385;37112
24;37;03;06;113;Le Grand-Pressigny;875;19;894;37113
24;37;03;06;114;La Guerche;174;1;175;37114
24;37;03;06;115;Descartes;3366;61;3427;37115
24;37;03;04;116;Les Hermites;557;16;573;37116
24;37;01;08;117;Hommes;875;10;885;37117
24;37;01;05;118;Huismes;1425;35;1460;37118
24;37;01;13;119;L'ÃŽle-Bouchard;1527;38;1565;37119
24;37;01;13;121;Jaulnay;253;4;257;37121
24;37;02;07;122;Joué-lès-Tours;38444;412;38856;37122
24;37;01;08;123;Langeais;4455;63;4518;37123
24;37;02;10;124;Larçay;2500;40;2540;37124
24;37;01;13;125;Lémeré;531;2;533;37125
24;37;01;05;126;Lerné;325;8;333;37126
24;37;03;09;127;Le Liège;339;8;347;37127
24;37;02;05;128;Lignières-de-Touraine;1296;23;1319;37128
24;37;01;13;129;Ligré;1058;21;1079;37129
24;37;03;06;130;Ligueil;2130;33;2163;37130
24;37;03;01;131;Limeray;1278;22;1300;37131
24;37;03;09;132;Loches;6199;536;6735;37132
24;37;03;09;133;Loché-sur-Indrois;474;10;484;37133
24;37;03;06;134;Louans;677;14;691;37134
24;37;03;06;136;Le Louroux;527;3;530;37136
24;37;01;08;137;Lublé;140;3;143;37137
24;37;03;01;138;Lussault-sur-Loire;842;16;858;37138
24;37;02;12;139;Luynes;5101;143;5244;37139
24;37;01;13;140;Luzé;239;5;244;37140
24;37;03;03;141;Luzillé;966;18;984;37141
24;37;01;13;142;Maillé;568;4;572;37142
24;37;03;06;143;Manthelan;1348;28;1376;37143
24;37;01;05;144;Marçay;529;6;535;37144
24;37;03;06;145;Marcé-sur-Esves;240;1;241;37145
24;37;01;08;146;Marcilly-sur-Maulne;219;3;222;37146
24;37;01;13;147;Marcilly-sur-Vienne;562;10;572;37147
24;37;01;13;148;Marigny-Marmande;603;6;609;37148
24;37;01;04;149;Marray;483;7;490;37149
24;37;01;08;150;Mazières-de-Touraine;1390;13;1403;37150
24;37;02;12;151;La Membrolle-sur-Choisille;3300;62;3362;37151
24;37;02;19;152;Mettray;2068;66;2134;37152
24;37;02;19;153;Monnaie;4643;54;4697;37153
24;37;02;11;154;Montbazon;4542;91;4633;37154
24;37;03;04;155;Monthodon;641;8;649;37155
24;37;02;10;156;Montlouis-sur-Loire;10868;149;11017;37156
24;37;03;09;157;Montrésor;322;4;326;37157
24;37;03;01;158;Montreuil-en-Touraine;776;11;787;37158
24;37;02;11;159;Monts;7876;143;8019;37159
24;37;03;04;160;Morand;343;6;349;37160
24;37;03;01;161;Mosnes;806;13;819;37161
24;37;03;06;162;Mouzay;468;17;485;37162
24;37;03;01;163;Nazelles-Négron;3508;56;3564;37163
24;37;01;13;165;Neuil;439;5;444;37165
24;37;03;01;166;Neuillé-le-Lierre;794;7;801;37166
24;37;01;04;167;Neuillé-Pont-Pierre;2098;37;2135;37167
24;37;03;06;168;Neuilly-le-Brignon;289;9;298;37168
24;37;03;04;169;Neuville-sur-Brenne;920;28;948;37169
24;37;01;04;170;Neuvy-le-Roi;1081;63;1144;37170
24;37;03;01;171;Noizay;1134;19;1153;37171
24;37;02;19;172;Notre-Dame-d'Oé;4234;83;4317;37172
24;37;03;09;173;Nouans-les-Fontaines;737;9;746;37173
24;37;01;13;174;Nouâtre;812;16;828;37174
24;37;03;04;175;Nouzilly;1244;31;1275;37175
24;37;01;13;176;Noyant-de-Touraine;1183;49;1232;37176
24;37;03;09;177;Orbigny;715;16;731;37177
24;37;01;13;178;Panzoult;611;4;615;37178
24;37;02;19;179;Parçay-Meslay;2474;32;2506;37179
24;37;01;13;180;Parçay-sur-Vienne;636;6;642;37180
24;37;03;06;181;Paulmy;234;10;244;37181
24;37;01;04;182;Pernay;1409;15;1424;37182
24;37;03;09;183;Perrusson;1464;27;1491;37183
24;37;03;06;184;Le Petit-Pressigny;338;7;345;37184
24;37;03;01;185;Pocé-sur-Cisse;1675;73;1748;37185
24;37;02;11;186;Pont-de-Ruan;1212;13;1225;37186
24;37;01;13;187;Ports-sur-Vienne;360;7;367;37187
24;37;01;13;188;Pouzay;896;6;902;37188
24;37;03;06;189;Preuilly-sur-Claise;1004;21;1025;37189
24;37;01;13;190;Pussigny;166;3;169;37190
24;37;01;13;191;Razines;231;6;237;37191
24;37;03;09;192;Reignac-sur-Indre;1278;18;1296;37192
24;37;01;08;193;Restigné;1149;26;1175;37193
24;37;02;19;194;Reugny;1751;33;1784;37194
24;37;02;02;195;La Riche;10317;80;10397;37195
24;37;01;13;196;Richelieu;1664;18;1682;37196
24;37;02;05;197;Rigny-Ussé;511;13;524;37197
24;37;01;08;198;Rillé;312;2;314;37198
24;37;01;13;199;Rilly-sur-Vienne;471;9;480;37199
24;37;02;05;200;Rivarennes;987;14;1001;37200
24;37;01;05;201;Rivière;703;20;723;37201
24;37;01;05;202;La Roche-Clermault;527;11;538;37202
24;37;02;19;203;Rochecorbon;3145;90;3235;37203
24;37;01;04;204;Rouziers-de-Touraine;1345;23;1368;37204
24;37;02;05;205;Saché;1403;16;1419;37205
24;37;01;04;206;Saint-Antoine-du-Rocher;1715;36;1751;37206
24;37;01;04;207;Saint-Aubin-le-Dépeint;338;2;340;37207
24;37;02;14;208;Saint-Avertin;14995;297;15292;37208
24;37;01;05;210;Saint-Benoît-la-Forêt;849;17;866;37210
24;37;02;11;211;Saint-Branchs;2625;32;2657;37211
24;37;02;13;212;Sainte-Catherine-de-Fierbois;774;11;785;37212
24;37;01;04;213;Saint-Christophe-sur-le-Nais;1105;24;1129;37213
24;37;02;12;214;Saint-Cyr-sur-Loire;16419;415;16834;37214
24;37;01;13;216;Saint-Epain;1575;28;1603;37216
24;37;02;12;217;Saint-Etienne-de-Chigny;1653;20;1673;37217
24;37;03;06;218;Saint-Flovier;571;12;583;37218
24;37;02;02;219;Saint-Genouph;1039;17;1056;37219
24;37;01;05;220;Saint-Germain-sur-Vienne;364;4;368;37220
24;37;03;09;221;Saint-Hippolyte;623;8;631;37221
24;37;03;09;222;Saint-Jean-Saint-Germain;761;29;790;37222
24;37;01;08;223;Saint-Laurent-de-Lin;319;2;321;37223
24;37;03;04;224;Saint-Laurent-en-Gâtines;943;15;958;37224
24;37;03;03;225;Saint-Martin-le-Beau;3181;57;3238;37225
24;37;01;13;226;Sainte-Maure-de-Touraine;4150;52;4202;37226
24;37;01;08;228;Saint-Nicolas-de-Bourgueil;1095;14;1109;37228
24;37;03;04;229;Saint-Nicolas-des-Motets;247;8;255;37229
24;37;03;01;230;Saint-Ouen-les-Vignes;993;19;1012;37230
24;37;01;04;231;Saint-Paterne-Racan;1647;25;1672;37231
24;37;01;08;232;Coteaux-sur-Loire;1900;39;1939;37232
24;37;02;14;233;Saint-Pierre-des-Corps;15967;250;16217;37233
24;37;03;09;234;Saint-Quentin-sur-Indrois;497;15;512;37234
24;37;03;01;236;Saint-Règle;608;11;619;37236
24;37;01;04;237;Saint-Roch;1254;18;1272;37237
24;37;03;09;238;Saint-Senoch;541;8;549;37238
24;37;03;04;240;Saunay;709;15;724;37240
24;37;01;08;241;Savigné-sur-Lathan;1342;22;1364;37241
24;37;01;05;242;Savigny-en-Véron;1563;32;1595;37242
24;37;02;02;243;Savonnières;3234;76;3310;37243
24;37;01;13;244;Sazilly;250;4;254;37244
24;37;01;04;245;Semblançay;2173;45;2218;37245
24;37;03;09;246;Sennevières;207;4;211;37246
24;37;03;06;247;Sepmes;617;10;627;37247
24;37;01;05;248;Seuilly;375;21;396;37248
24;37;01;04;249;Sonzay;1399;20;1419;37249
24;37;02;11;250;Sorigny;2752;76;2828;37250
24;37;01;08;251;Souvigné;874;11;885;37251
24;37;03;01;252;Souvigny-de-Touraine;393;6;399;37252
24;37;03;03;253;Sublaines;182;6;188;37253
24;37;03;09;254;Tauxigny-Saint-Bauld;1722;29;1751;37254
24;37;01;13;255;Tavant;264;1;265;37255
24;37;01;13;256;Theneuil;293;3;296;37256
24;37;02;05;257;Thilouze;1769;23;1792;37257
24;37;01;05;258;Thizay;288;3;291;37258
24;37;03;06;259;Tournon-Saint-Pierre;460;10;470;37259
24;37;01;13;260;La Tour-Saint-Gelin;520;8;528;37260
24;37;02;99;261;Tours;137087;2756;139843;37261
24;37;01;13;262;Trogues;296;4;300;37262
24;37;02;11;263;Truyes;2452;40;2492;37263
24;37;02;05;264;Vallères;1299;20;1319;37264
24;37;03;06;265;Varennes;240;5;245;37265
24;37;02;11;266;Veigné;6423;118;6541;37266
24;37;02;10;267;Véretz;4570;80;4650;37267
24;37;01;13;268;Verneuil-le-Château;128;0;128;37268
24;37;03;09;269;Verneuil-sur-Indre;474;11;485;37269
24;37;02;19;270;Vernou-sur-Brenne;2713;41;2754;37270
24;37;02;05;271;Villaines-les-Rochers;1048;9;1057;37271
24;37;02;02;272;Villandry;1133;37;1170;37272
24;37;02;10;273;La Ville-aux-Dames;5585;71;5656;37273
24;37;01;04;274;Villebourg;301;3;304;37274
24;37;03;09;275;Villedômain;119;2;121;37275
24;37;03;04;276;Villedômer;1329;31;1360;37276
24;37;03;09;277;Villeloin-Coulangé;588;3;591;37277
24;37;02;11;278;Villeperdue;1074;7;1081;37278
24;37;01;08;279;Villiers-au-Bouin;754;7;761;37279
24;37;03;06;280;Vou;225;6;231;37280
24;37;02;19;281;Vouvray;3254;70;3324;37281
24;37;03;06;282;Yzeures-sur-Creuse;1354;27;1381;37282
84;38;02;03;001;Les Abrets en Dauphiné;6389;106;6495;38001
84;38;01;13;002;Les Adrets;1044;29;1073;38002
84;38;03;21;003;Agnin;1149;22;1171;38003
84;38;01;23;004;L'Albenc;1279;25;1304;38004
84;38;01;19;005;Allemond;946;18;964;38005
84;38;01;13;006;Allevard;4023;106;4129;38006
84;38;01;15;008;Ambel;27;0;27;38008
84;38;03;21;009;Anjou;1045;24;1069;38009
84;38;02;04;010;Annoisin-Chatelans;696;18;714;38010
84;38;02;04;011;Anthon;1077;13;1090;38011
84;38;02;03;012;Aoste;2882;54;2936;38012
84;38;02;08;013;Apprieu;3380;91;3471;38013
84;38;03;26;015;Artas;1824;38;1862;38015
84;38;03;28;017;Assieu;1586;36;1622;38017
84;38;01;23;018;Auberives-en-Royans;363;10;373;38018
84;38;03;28;019;Auberives-sur-Varèze;1480;29;1509;38019
84;38;01;19;020;Auris;183;4;187;38020
84;38;02;17;022;Les Avenières Veyrins-Thuellin;7804;159;7963;38022
84;38;01;15;023;Avignonet;198;5;203;38023
84;38;02;17;026;La Balme-les-Grottes;1100;12;1112;38026
84;38;01;13;027;Barraux;1950;57;2007;38027
84;38;02;24;029;La Bâtie-Montgascon;1941;41;1982;38029
84;38;01;25;030;Beaucroissant;1740;30;1770;38030
84;38;01;15;031;Beaufin;21;0;21;38031
84;38;03;01;032;Beaufort;561;11;572;38032
84;38;01;23;033;Beaulieu;635;18;653;38033
84;38;03;21;034;Beaurepaire;4977;83;5060;38034
84;38;03;01;035;Beauvoir-de-Marc;1114;15;1129;38035
84;38;01;23;036;Beauvoir-en-Royans;95;2;97;38036
84;38;03;21;037;Bellegarde-Poussieu;991;14;1005;38037
84;38;02;08;038;Belmont;599;14;613;38038
84;38;01;18;039;Bernin;3025;104;3129;38039
84;38;01;19;040;Besse;141;1;142;38040
84;38;01;23;041;Bessins;107;3;110;38041
84;38;02;08;042;Bévenais;1023;21;1044;38042
84;38;02;08;043;Bilieu;1575;43;1618;38043
84;38;02;08;044;Biol;1454;41;1495;38044
84;38;01;16;045;Biviers;2331;92;2423;38045
84;38;02;08;046;Bizonnes;991;15;1006;38046
84;38;02;08;047;Blandin;149;3;152;38047
84;38;02;26;048;Bonnefamille;1073;18;1091;38048
84;38;03;01;049;Bossieu;302;7;309;38049
84;38;02;17;050;Le Bouchage;629;9;638;38050
84;38;03;21;051;Bougé-Chambalud;1351;21;1372;38051
84;38;01;19;052;Le Bourg-d'Oisans;3286;103;3389;38052
84;38;02;02;053;Bourgoin-Jallieu;28834;609;29443;38053
84;38;02;17;054;Bouvesse-Quirieu;1542;21;1563;38054
84;38;02;17;055;Brangues;632;8;640;38055
84;38;03;01;056;Bressieux;93;2;95;38056
84;38;01;05;057;Bresson;671;12;683;38057
84;38;03;01;058;Brézins;2186;37;2223;38058
84;38;01;20;059;Brié-et-Angonnes;2545;42;2587;38059
84;38;03;01;060;Brion;141;5;146;38060
84;38;01;29;061;La Buisse;3235;70;3305;38061
84;38;01;13;062;La Buissière;732;12;744;38062
84;38;02;08;063;Burcin;441;14;455;38063
84;38;02;24;064;Cessieu;3113;70;3183;38064
84;38;02;08;065;Châbons;2119;50;2169;38065
84;38;03;21;066;Chalon;175;4;179;38066
84;38;02;26;067;Chamagnieu;1697;38;1735;38067
84;38;01;20;068;Champagnier;1200;30;1230;38068
84;38;03;01;069;Champier;1436;23;1459;38069
84;38;01;13;070;Le Champ-près-Froges;1211;14;1225;38070
84;38;01;20;071;Champ-sur-Drac;3172;32;3204;38071
84;38;03;21;072;Chanas;2726;42;2768;38072
84;38;01;15;073;Chantepérier;195;3;198;38073
84;38;01;23;074;Chantesse;360;6;366;38074
84;38;01;13;075;Chapareillan;2986;107;3093;38075
84;38;02;24;076;La Chapelle-de-la-Tour;1886;67;1953;38076
84;38;03;21;077;La Chapelle-de-Surieu;757;16;773;38077
84;38;01;13;078;La Chapelle-du-Bard;584;6;590;38078
84;38;02;03;080;Charancieu;767;20;787;38080
84;38;03;26;081;Charantonnay;1969;45;2014;38081
84;38;02;08;082;Charavines;1918;46;1964;38082
84;38;02;17;083;Charette;450;15;465;38083
84;38;01;25;084;Charnècles;1407;26;1433;38084
84;38;02;04;085;Charvieu-Chavagneux;10102;84;10186;38085
84;38;01;23;086;Chasselay;402;8;410;38086
84;38;03;27;087;Chasse-sur-Rhône;6308;57;6365;38087
84;38;02;08;089;Chassignieu;225;5;230;38089
84;38;01;15;090;Château-Bernard;268;5;273;38090
84;38;02;02;091;Châteauvilain;753;13;766;38091
84;38;01;23;092;Châtelus;91;3;94;38092
84;38;03;01;093;Châtenay;439;7;446;38093
84;38;03;01;094;Châtonnay;2020;42;2062;38094
84;38;01;23;095;Chatte;2480;159;2639;38095
84;38;02;04;097;Chavanoz;4869;64;4933;38097
84;38;02;08;098;Chélieu;712;18;730;38098
84;38;01;23;099;Chevrières;726;23;749;38099
84;38;01;13;100;Le Cheylas;2528;43;2571;38100
84;38;03;28;101;Cheyssieu;1028;16;1044;38101
84;38;02;14;102;Chèzeneuve;626;21;647;38102
84;38;01;15;103;Chichilianne;306;2;308;38103
84;38;02;03;104;Chimilin;1411;32;1443;38104
84;38;01;08;105;Chirens;2369;45;2414;38105
84;38;01;15;106;Cholonge;346;9;355;38106
84;38;03;28;107;Chonas-l'Amballan;1679;51;1730;38107
84;38;01;23;108;Choranche;120;0;120;38108
84;38;02;04;109;Chozeau;1051;27;1078;38109
84;38;03;27;110;Chuzelles;2260;44;2304;38110
84;38;01;06;111;Claix;7924;216;8140;38111
84;38;01;19;112;Clavans-en-Haut-Oisans;100;1;101;38112
84;38;01;15;113;Clelles;536;6;542;38113
84;38;03;28;114;Clonas-sur-Varèze;1450;33;1483;38114
84;38;01;15;115;Saint-Martin-de-la-Cluze;730;19;749;38115
84;38;01;15;116;Cognet;40;0;40;38116
84;38;01;23;117;Cognin-les-Gorges;630;14;644;38117
84;38;02;08;118;Colombe;1625;44;1669;38118
84;38;01;18;120;La Combe-de-Lancey;709;17;726;38120
84;38;02;17;124;Corbelin;2238;47;2285;38124
84;38;01;16;126;Corenc;4075;130;4205;38126
84;38;01;15;127;Cornillon-en-Trièves;163;5;168;38127
84;38;01;15;128;Corps;450;5;455;38128
84;38;01;07;129;Corrençon-en-Vercors;360;17;377;38129
84;38;03;01;130;La Côte-Saint-André;4829;277;5106;38130
84;38;03;28;131;Les Côtes-d'Arey;2024;75;2099;38131
84;38;01;15;132;Les Côtes-de-Corps;73;0;73;38132
84;38;01;29;133;Coublevie;5216;400;5616;38133
84;38;03;21;134;Cour-et-Buis;920;19;939;38134
84;38;02;17;135;Courtenay;1282;21;1303;38135
84;38;02;14;136;Crachier;530;16;546;38136
84;38;01;23;137;Cras;432;13;445;38137
84;38;02;04;138;Crémieu;3375;64;3439;38138
84;38;02;17;139;Creys-Mépieu;1503;19;1522;38139
84;38;01;18;140;Crolles;8293;256;8549;38140
84;38;03;14;141;Culin;758;15;773;38141
84;38;03;26;144;Diémoz;2799;37;2836;38144
84;38;02;04;146;Dizimieu;827;26;853;38146
84;38;02;08;147;Doissin;885;25;910;38147
84;38;02;24;148;Dolomieu;3192;71;3263;38148
84;38;02;02;149;Domarin;1675;36;1711;38149
84;38;01;16;150;Domène;6677;70;6747;38150
84;38;01;05;151;Echirolles;36932;212;37144;38151
84;38;02;02;152;Eclose-Badinières;1441;29;1470;38152
84;38;01;07;153;Engins;449;20;469;38153
84;38;01;15;154;Entraigues;221;2;223;38154
84;38;01;03;155;Entre-deux-Guiers;1871;30;1901;38155
84;38;02;02;156;Les Eparres;972;32;1004;38156
84;38;03;28;157;Estrablin;3535;73;3608;38157
84;38;01;05;158;Eybens;9980;119;10099;38158
84;38;02;08;159;Eydoche;539;13;552;38159
84;38;03;28;160;Eyzin-Pinet;2303;115;2418;38160
84;38;03;01;161;Faramans;1062;6;1068;38161
84;38;02;24;162;Faverges-de-la-Tour;1464;40;1504;38162
84;38;01;13;163;Le Haut-Bréda;387;9;396;38163
84;38;01;13;166;La Flachère;466;10;476;38166
84;38;02;08;167;Flachères;540;5;545;38167
84;38;01;97;169;Fontaine;23211;234;23445;38169
84;38;01;10;170;Fontanil-Cornillon;3172;35;3207;38170
84;38;03;01;171;La Forteresse;328;4;332;38171
84;38;02;14;172;Four;1625;33;1658;38172
84;38;01;19;173;Le Freney-d'Oisans;247;7;254;38173
84;38;03;01;174;La Frette;1092;23;1115;38174
84;38;01;13;175;Froges;3392;59;3451;38175
84;38;02;26;176;Frontonas;2096;55;2151;38176
84;38;01;19;177;La Garde;103;0;103;38177
84;38;01;22;179;Gières;7134;86;7220;38179
84;38;03;01;180;Gillonnay;1013;38;1051;38180
84;38;01;13;181;Goncelin;2476;36;2512;38181
84;38;02;08;182;Le Grand-Lemps;3079;57;3136;38182
84;38;02;03;183;Granieu;502;9;511;38183
84;38;03;26;184;Grenay;1627;21;1648;38184
84;38;01;98;185;Grenoble;158198;2243;160441;38185
84;38;01;15;186;Gresse-en-Vercors;377;12;389;38186
84;38;01;20;187;Le Gua;1796;25;1821;38187
84;38;01;20;188;Herbeys;1362;23;1385;38188
84;38;03;26;189;Heyrieux;4712;64;4776;38189
84;38;02;04;190;Hières-sur-Amby;1171;28;1199;38190
84;38;01;19;191;Huez;1306;34;1340;38191
84;38;01;13;192;Hurtières;195;6;201;38192
84;38;02;14;193;L'Isle-d'Abeau;16584;318;16902;38193
84;38;01;08;194;Izeaux;2137;35;2172;38194
84;38;01;23;195;Izeron;745;9;754;38195
84;38;02;04;197;Janneyrias;1816;20;1836;38197
84;38;03;21;198;Jarcieu;1059;22;1081;38198
84;38;03;28;199;Jardin;2156;56;2212;38199
84;38;01;20;200;Jarrie;3779;69;3848;38200
84;38;01;15;203;Laffrey;465;8;473;38203
84;38;01;15;204;Lalley;192;5;197;38204
84;38;01;07;205;Lans-en-Vercors;2676;119;2795;38205
84;38;01;18;206;Laval-en-Belledonne;983;36;1019;38206
84;38;01;15;207;Lavaldens;151;3;154;38207
84;38;01;15;208;Lavars;148;3;151;38208
84;38;03;01;209;Lentiol;235;7;242;38209
84;38;02;04;210;Leyrieu;871;14;885;38210
84;38;03;01;211;Lieudieu;352;5;357;38211
84;38;01;19;212;Livet-et-Gavet;1284;8;1292;38212
84;38;03;08;213;Longechenal;584;12;596;38213
84;38;01;18;214;Lumbin;2166;73;2239;38214
84;38;03;27;215;Luzinay;2314;44;2358;38215
84;38;01;23;216;Malleval-en-Vercors;54;2;56;38216
84;38;01;15;217;Marcieu;71;2;73;38217
84;38;03;01;218;Marcilloles;1176;21;1197;38218
84;38;03;01;219;Marcollin;645;15;660;38219
84;38;03;01;221;Marnans;141;3;144;38221
84;38;02;08;222;Massieu;750;17;767;38222
84;38;02;14;223;Maubec;1876;66;1942;38223
84;38;01;15;224;Mayres-Savel;91;3;94;38224
84;38;01;07;225;Autrans-Méaudre en Vercors;3039;103;3142;38225
84;38;01;15;226;Mens;1393;75;1468;38226
84;38;02;03;228;Merlas;479;18;497;38228
84;38;01;16;229;Meylan;17786;391;18177;38229
84;38;02;02;230;Meyrié;1023;43;1066;38230
84;38;03;14;231;Meyrieu-les-Etangs;1025;30;1055;38231
84;38;03;01;232;Meyssiez;638;12;650;38232
84;38;01;15;235;Miribel-Lanchâtre;456;8;464;38235
84;38;01;03;236;Miribel-les-Echelles;1733;38;1771;38236
84;38;01;19;237;MizoÃ«n;190;4;194;38237
84;38;03;27;238;Moidieu-Détourbe;1941;42;1983;38238
84;38;01;25;239;Moirans;7499;156;7655;38239
84;38;03;21;240;Moissieu-sur-Dolon;738;15;753;38240
84;38;01;15;241;Monestier-d'Ambel;16;0;16;38241
84;38;01;15;242;Monestier-de-Clermont;1428;31;1459;38242
84;38;01;15;243;Le Monestier-du-Percy;250;6;256;38243
84;38;03;21;244;Monsteroux-Milieu;797;19;816;38244
84;38;01;23;245;Montagne;269;4;273;38245
84;38;02;24;246;Montagnieu;1132;17;1149;38246
84;38;02;17;247;Montalieu-Vercieu;3467;55;3522;38247
84;38;01;25;248;Montaud;524;21;545;38248
84;38;01;16;249;Montbonnot-Saint-Martin;5477;562;6039;38249
84;38;02;24;250;Montcarra;569;17;586;38250
84;38;01;19;252;Montchaboud;337;9;346;38252
84;38;01;19;253;Les Deux Alpes;1929;36;1965;38253
84;38;01;15;254;Monteynard;500;13;513;38254
84;38;03;01;255;Montfalcon;139;0;139;38255
84;38;02;08;256;Montferrat;1833;23;1856;38256
84;38;02;08;257;Montrevel;446;12;458;38257
84;38;01;10;258;Mont-Saint-Martin;76;4;80;38258
84;38;03;21;259;Montseveroux;972;16;988;38259
84;38;02;04;260;Moras;525;18;543;38260
84;38;02;17;261;Morestel;4526;99;4625;38261
84;38;01;23;263;Morette;391;5;396;38263
84;38;01;19;264;La Morte;136;0;136;38264
84;38;01;15;265;La Motte-d'Aveillans;1692;21;1713;38265
84;38;01;15;266;La Motte-Saint-Martin;450;9;459;38266
84;38;03;01;267;Mottier;768;13;781;38267
84;38;01;13;268;Le Moutaret;264;3;267;38268
84;38;01;15;269;La Mure;4920;208;5128;38269
84;38;01;29;270;La Murette;1858;65;1923;38270
84;38;01;16;271;Murianette;862;11;873;38271
84;38;01;23;272;Murinais;399;7;406;38272
84;38;01;15;273;Nantes-en-Ratier;464;19;483;38273
84;38;01;23;275;Serre-Nerpol;308;41;349;38275
84;38;02;02;276;Nivolas-Vermelle;2648;69;2717;38276
84;38;01;20;277;Notre-Dame-de-Commiers;536;6;542;38277
84;38;01;23;278;Notre-Dame-de-l'Osier;498;9;507;38278
84;38;01;19;279;Notre-Dame-de-Mésage;1131;12;1143;38279
84;38;01;15;280;Notre-Dame-de-Vaulx;521;21;542;38280
84;38;01;07;281;Noyarey;2256;77;2333;38281
84;38;02;17;282;Optevoz;871;28;899;38282
84;38;01;15;283;Oris-en-Rattier;109;3;112;38283
84;38;03;01;284;Ornacieux-Balbins;849;27;876;38284
84;38;01;19;285;Ornon;161;4;165;38285
84;38;01;19;286;Oulles;6;0;6;38286
84;38;02;08;287;Oyeu;1039;20;1059;38287
84;38;03;26;288;Oytier-Saint-Oblas;1668;32;1700;38288
84;38;01;19;289;Oz;213;4;217;38289
84;38;03;21;290;Pact;855;15;870;38290
84;38;03;01;291;Pajay;1153;17;1170;38291
84;38;02;08;292;Villages du Lac de Paladru;2528;60;2588;38292
84;38;02;04;294;Panossas;660;16;676;38294
84;38;02;17;295;Parmilieu;723;12;735;38295
84;38;02;24;296;Le Passage;876;37;913;38296
84;38;02;17;297;Arandon-Passins;1851;43;1894;38297
84;38;03;21;298;Le Péage-de-Roussillon;6516;59;6575;38298
84;38;01;15;299;Pellafol;137;2;139;38299
84;38;03;01;300;Penol;362;9;371;38300
84;38;01;15;301;Percy;175;4;179;38301
84;38;01;13;303;La Pierre;565;5;570;38303
84;38;01;15;304;Pierre-Châtel;1493;37;1530;38304
84;38;03;21;307;Pisieu;521;9;530;38307
84;38;03;01;308;Plan;271;2;273;38308
84;38;01;22;309;Poisat;2127;27;2154;38309
84;38;01;25;310;Poliénas;1212;16;1228;38310
84;38;03;21;311;Pommier-de-Beaurepaire;709;15;724;38311
84;38;01;15;313;Ponsonnas;296;15;311;38313
84;38;01;13;314;Pontcharra;7348;171;7519;38314
84;38;02;03;315;Le Pont-de-Beauvoisin;3570;142;3712;38315
84;38;02;04;316;Pont-de-Chéruy;5980;44;6024;38316
84;38;01;20;317;Le Pont-de-Claix;10716;76;10792;38317
84;38;03;27;318;Pont-Evêque;5313;50;5363;38318
84;38;01;23;319;Pont-en-Royans;785;31;816;38319
84;38;02;17;320;Porcieu-Amblagnieu;1786;40;1826;38320
84;38;01;15;321;Prébois;165;8;173;38321
84;38;01;23;322;Presles;92;2;94;38322
84;38;02;03;323;Pressins;1161;22;1183;38323
84;38;03;21;324;Primarette;716;18;734;38324
84;38;01;10;325;Proveysieux;513;9;522;38325
84;38;01;15;326;Prunières;367;12;379;38326
84;38;01;10;328;Quaix-en-Chartreuse;897;33;930;38328
84;38;01;15;329;Quet-en-Beaumont;68;0;68;38329
84;38;01;23;330;Quincieu;102;1;103;38330
84;38;01;25;331;Réaumont;998;31;1029;38331
84;38;01;25;332;Renage;3467;51;3518;38332
84;38;01;23;333;Rencurel;324;6;330;38333
84;38;01;18;334;Revel;1313;43;1356;38334
84;38;03;21;335;Revel-Tourdan;1051;26;1077;38335
84;38;03;28;336;Reventin-Vaugris;1974;35;2009;38336
84;38;01;25;337;Rives;6668;83;6751;38337
84;38;01;23;338;La Rivière;740;9;749;38338
84;38;02;26;339;Roche;2128;56;2184;38339
84;38;03;28;340;Les Roches-de-Condrieu;1981;37;2018;38340
84;38;02;24;341;Rochetoirin;1090;40;1130;38341
84;38;01;15;342;Roissard;316;7;323;38342
84;38;02;03;343;Romagnieu;1584;31;1615;38343
84;38;03;21;344;Roussillon;8457;119;8576;38344
84;38;01;23;345;Rovon;611;10;621;38345
84;38;03;01;346;Royas;397;7;404;38346
84;38;03;01;347;Roybon;1132;27;1159;38347
84;38;02;02;348;Ruy-Montceau;4717;108;4825;38348
84;38;03;21;349;Sablons;2285;22;2307;38349
84;38;01;18;350;Sainte-Agnès;554;18;572;38350
84;38;03;14;351;Saint-Agnin-sur-Bion;1089;22;1111;38351
84;38;02;14;352;Saint-Alban-de-Roche;2130;61;2191;38352
84;38;03;28;353;Saint-Alban-du-Rhône;840;19;859;38353
84;38;02;03;354;Saint-Albin-de-Vaulserre;410;5;415;38354
84;38;01;15;355;Saint-Andéol;123;6;129;38355
84;38;01;23;356;Saint-André-en-Royans;310;18;328;38356
84;38;02;24;357;Saint-André-le-Gaz;2760;143;2903;38357
84;38;03;01;358;Sainte-Anne-sur-Gervonde;717;11;728;38358
84;38;01;23;359;Saint Antoine l'Abbaye;1162;28;1190;38359
84;38;01;23;360;Saint-Appolinard;414;8;422;38360
84;38;01;15;361;Saint-Arey;79;3;82;38361
84;38;01;29;362;Saint-Aupre;1157;53;1210;38362
84;38;03;21;363;Saint-Barthélemy;932;38;970;38363
84;38;01;19;364;Saint-Barthélemy-de-Séchilienne;430;4;434;38364
84;38;02;04;365;Saint-Baudille-de-la-Tour;814;19;833;38365
84;38;01;15;366;Saint-Baudille-et-Pipet;260;8;268;38366
84;38;01;25;368;Saint-Blaise-du-Buis;1094;25;1119;38368
84;38;02;24;369;Sainte-Blandine;985;38;1023;38369
84;38;01;23;370;Saint-Bonnet-de-Chavagne;653;18;671;38370
84;38;02;03;372;Saint-Bueil;724;10;734;38372
84;38;01;29;373;Saint-Cassien;1149;42;1191;38373
84;38;02;02;374;Saint-Chef;3689;91;3780;38374
84;38;01;19;375;Saint-Christophe-en-Oisans;110;0;110;38375
84;38;01;03;376;Saint-Christophe-sur-Guiers;824;9;833;38376
84;38;02;24;377;Saint-Clair-de-la-Tour;3456;59;3515;38377
84;38;03;28;378;Saint-Clair-du-Rhône;3705;86;3791;38378
84;38;03;01;379;Saint-Clair-sur-Galaure;269;8;277;38379
84;38;02;08;380;Saint-Didier-de-Bizonnes;308;5;313;38380
84;38;02;24;381;Saint-Didier-de-la-Tour;2098;53;2151;38381
84;38;01;10;382;Saint-Egrève;15944;220;16164;38382
84;38;01;29;383;Saint-Etienne-de-Crossey;2595;108;2703;38383
84;38;03;01;384;Saint-Etienne-de-Saint-Geoirs;3206;44;3250;38384
84;38;02;03;386;Saint-Geoire-en-Valdaine;2394;41;2435;38386
84;38;03;01;387;Saint-Geoirs;506;13;519;38387
84;38;01;20;388;Saint-Georges-de-Commiers;2537;32;2569;38388
84;38;03;26;389;Saint-Georges-d'Espéranche;3439;68;3507;38389
84;38;01;23;390;Saint-Gervais;544;9;553;38390
84;38;01;15;391;Saint-Guillaume;247;5;252;38391
84;38;02;04;392;Saint-Hilaire-de-Brens;615;22;637;38392
84;38;03;01;393;Saint-Hilaire-de-la-Côte;1558;33;1591;38393
84;38;01;23;394;Saint-Hilaire-du-Rosier;1869;32;1901;38394
84;38;01;18;395;Plateau-des-Petites-Roches;2380;73;2453;38395
84;38;01;15;396;Saint-Honoré;810;27;837;38396
84;38;01;18;397;Saint-Ismier;7064;314;7378;38397
84;38;02;03;398;Saint-Jean-d'Avelanne;976;16;992;38398
84;38;03;14;399;Saint-Jean-de-Bournay;4590;101;4691;38399
84;38;01;25;400;Saint-Jean-de-Moirans;3564;80;3644;38400
84;38;02;24;401;Saint-Jean-de-Soudain;1636;40;1676;38401
84;38;01;15;402;Saint-Jean-de-Vaulx;529;19;548;38402
84;38;01;15;403;Saint-Jean-d'Hérans;286;5;291;38403
84;38;01;18;404;Saint-Jean-le-Vieux;300;4;304;38404
84;38;01;03;405;Saint-Joseph-de-Rivière;1224;28;1252;38405
84;38;03;21;406;Saint-Julien-de-l'Herms;152;4;156;38406
84;38;01;29;407;La Sure en Chartreuse;987;30;1017;38407
84;38;03;26;408;Saint-Just-Chaleyssin;2656;61;2717;38408
84;38;01;23;409;Saint-Just-de-Claix;1311;33;1344;38409
84;38;01;23;410;Saint-Lattier;1399;24;1423;38410
84;38;01;03;412;Saint-Laurent-du-Pont;4510;102;4612;38412
84;38;01;15;413;Saint-Laurent-en-Beaumont;429;9;438;38413
84;38;01;15;414;Sainte-Luce;41;2;43;38414
84;38;02;02;415;Saint-Marcel-Bel-Accueil;1432;39;1471;38415
84;38;01;23;416;Saint-Marcellin;7766;179;7945;38416
84;38;01;13;417;Sainte-Marie-d'Alloix;479;17;496;38417
84;38;01;13;418;Sainte-Marie-du-Mont;235;2;237;38418
84;38;01;15;419;Saint-Martin-de-Clelles;185;2;187;38419
84;38;02;03;420;Saint-Martin-de-Vaulserre;248;5;253;38420
84;38;01;22;421;Saint-Martin-d'Hères;37935;265;38200;38421
84;38;01;19;422;Saint-Martin-d'Uriage;5512;175;5687;38422
84;38;01;10;423;Saint-Martin-le-Vinoux;5880;62;5942;38423
84;38;01;15;424;Saint-Maurice-en-Trièves;168;3;171;38424
84;38;03;28;425;Saint-Maurice-l'Exil;6387;94;6481;38425
84;38;01;13;426;Saint-Maximin;656;16;672;38426
84;38;03;01;427;Saint-Michel-de-Saint-Geoirs;299;4;303;38427
84;38;01;15;428;Saint-Michel-en-Beaumont;31;0;31;38428
84;38;01;15;429;Saint-Michel-les-Portes;281;7;288;38429
84;38;01;18;430;Saint-Mury-Monteymond;325;7;332;38430
84;38;01;18;431;Saint-Nazaire-les-Eymes;2960;90;3050;38431
84;38;01;29;432;Saint-Nicolas-de-Macherin;977;25;1002;38432
84;38;01;07;433;Saint-Nizier-du-Moucherotte;1083;31;1114;38433
84;38;02;08;434;Saint-Ondras;648;6;654;38434
84;38;01;20;436;Saint-Paul-de-Varces;2247;41;2288;38436
84;38;03;01;437;Saint-Paul-d'Izeaux;293;6;299;38437
84;38;01;15;438;Saint-Paul-lès-Monestier;267;1;268;38438
84;38;01;13;439;Crêts en Belledonne;3372;55;3427;38439
84;38;03;01;440;Saint-Pierre-de-Bressieux;758;16;774;38440
84;38;01;03;442;Saint-Pierre-de-Chartreuse;962;26;988;38442
84;38;01;23;443;Saint-Pierre-de-Chérennes;465;12;477;38443
84;38;01;15;444;Saint-Pierre-de-Méaroz;116;6;122;38444
84;38;01;19;445;Saint-Pierre-de-Mésage;781;6;787;38445
84;38;01;03;446;Saint-Pierre-d'Entremont;570;14;584;38446
84;38;03;28;448;Saint-Prim;1407;31;1438;38448
84;38;02;26;449;Saint-Quentin-Fallavier;6020;64;6084;38449
84;38;01;25;450;Saint-Quentin-sur-Isère;1475;19;1494;38450
84;38;02;04;451;Saint-Romain-de-Jalionas;3346;41;3387;38451
84;38;03;21;452;Saint-Romain-de-Surieu;368;10;378;38452
84;38;01;23;453;Saint-Romans;1785;41;1826;38453
84;38;01;23;454;Saint-Sauveur;2107;50;2157;38454
84;38;02;02;455;Saint-Savin;4202;83;4285;38455
84;38;01;15;456;Châtel-en-Trièves;477;10;487;38456
84;38;03;01;457;Saint-Siméon-de-Bressieux;2921;65;2986;38457
84;38;02;17;458;Saint-Sorlin-de-Morestel;614;16;630;38458
84;38;03;28;459;Saint-Sorlin-de-Vienne;918;7;925;38459
84;38;02;08;460;Saint-Sulpice-des-Rivoires;431;12;443;38460
84;38;01;15;462;Saint-Théoffrey;540;14;554;38462
84;38;01;23;463;Saint-Vérand;1713;38;1751;38463
84;38;02;24;464;Saint-Victor-de-Cessieu;2249;49;2298;38464
84;38;02;17;465;Saint-Victor-de-Morestel;1093;22;1115;38465
84;38;01;13;466;Saint-Vincent-de-Mercuze;1505;48;1553;38466
84;38;02;02;467;Salagnon;1452;38;1490;38467
84;38;03;21;468;Salaise-sur-Sanne;4488;71;4559;38468
84;38;01;15;469;La Salette-Fallavaux;68;0;68;38469
84;38;01;15;470;La Salle-en-Beaumont;335;8;343;38470
84;38;01;16;471;Le Sappey-en-Chartreuse;1133;30;1163;38471
84;38;01;10;472;Sarcenas;214;4;218;38472
84;38;03;01;473;Sardieu;1158;22;1180;38473
84;38;01;07;474;Sassenage;11062;197;11259;38474
84;38;02;26;475;Satolas-et-Bonce;2487;28;2515;38475
84;38;03;01;476;Savas-Mépin;898;10;908;38476
84;38;01;19;478;Séchilienne;1063;13;1076;38478
84;38;03;01;479;Porte-des-Bonnevaux;2016;52;2068;38479
84;38;03;27;480;Septème;2071;41;2112;38480
84;38;02;02;481;Sérézin-de-la-Tour;1106;32;1138;38481
84;38;02;17;483;Sermérieu;1659;50;1709;38483
84;38;03;27;484;Serpaize;2116;27;2143;38484
84;38;01;06;485;Seyssinet-Pariset;11891;142;12033;38485
84;38;01;06;486;Seyssins;7827;108;7935;38486
84;38;03;27;487;Seyssuel;2049;52;2101;38487
84;38;02;04;488;Siccieu-Saint-Julien-et-Carisieu;583;16;599;38488
84;38;01;15;489;Siévoz;133;2;135;38489
84;38;03;01;490;Sillans;1946;47;1993;38490
84;38;01;15;492;Sinard;703;21;724;38492
84;38;02;17;494;Soleymieu;797;21;818;38494
84;38;01;23;495;La Sône;585;4;589;38495
84;38;03;21;496;Sonnay;1239;25;1264;38496
84;38;01;15;497;Sousville;143;0;143;38497
84;38;02;02;498;Succieu;735;22;757;38498
84;38;01;15;499;Susville;1206;16;1222;38499
84;38;01;23;500;Têche;574;6;580;38500
84;38;01;13;501;Tencin;2128;23;2151;38501
84;38;01;18;503;La Terrasse;2510;127;2637;38503
84;38;01;13;504;Theys;1995;95;2090;38504
84;38;03;01;505;Thodure;772;15;787;38505
84;38;02;04;507;Tignieu-Jameyzieu;7555;99;7654;38507
84;38;02;24;508;Torchefelon;794;26;820;38508
84;38;02;24;509;La Tour-du-Pin;8167;207;8374;38509
84;38;01;13;511;Le Touvet;3176;101;3277;38511
84;38;03;14;512;Tramolé;777;25;802;38512
84;38;01;15;513;Treffort;301;7;308;38513
84;38;01;15;514;Tréminis;177;1;178;38514
84;38;02;04;515;Trept;2212;56;2268;38515
84;38;01;16;516;La Tronche;6602;140;6742;38516
84;38;01;25;517;Tullins;7816;123;7939;38517
84;38;01;15;518;Valbonnais;506;12;518;38518
84;38;03;26;519;Valencin;2879;49;2928;38519
84;38;02;08;520;Valencogne;698;20;718;38520
84;38;01;15;521;La Valette;67;2;69;38521
84;38;01;15;522;Valjouffrey;130;2;132;38522
84;38;01;23;523;Varacieux;843;19;862;38523
84;38;01;20;524;Varces-Allières-et-Risset;8301;164;8465;38524
84;38;02;17;525;Vasselin;461;5;466;38525
84;38;01;23;526;Vatilieu;360;11;371;38526
84;38;01;19;527;Vaujany;342;4;346;38527
84;38;01;19;528;Vaulnaveys-le-Bas;1321;30;1351;38528
84;38;01;19;529;Vaulnaveys-le-Haut;3965;60;4025;38529
84;38;02;14;530;Vaulx-Milieu;2537;51;2588;38530
84;38;02;03;531;Velanne;561;6;567;38531
84;38;02;04;532;Vénérieu;923;10;933;38532
84;38;01;22;533;Venon;732;16;748;38533
84;38;02;04;535;Vernas;262;7;269;38535
84;38;03;28;536;Vernioz;1397;24;1421;38536
84;38;02;26;537;La Verpillière;7293;88;7381;38537
84;38;01;18;538;Le Versoud;4933;64;4997;38538
84;38;02;17;539;Vertrieu;617;21;638;38539
84;38;01;07;540;Veurey-Voroize;1433;26;1459;38540
84;38;02;04;542;Veyssilieu;330;15;345;38542
84;38;02;17;543;Vézeronce-Curtin;2142;35;2177;38543
84;38;03;99;544;Vienne;29993;341;30334;38544
84;38;01;20;545;Vif;8547;126;8673;38545
84;38;02;17;546;Vignieu;973;81;1054;38546
84;38;01;18;547;Villard-Bonnot;7249;105;7354;38547
84;38;01;07;548;Villard-de-Lans;4234;225;4459;38548
84;38;01;19;549;Villard-Notre-Dame;28;3;31;38549
84;38;01;19;550;Villard-Reculas;57;0;57;38550
84;38;01;19;551;Villard-Reymond;40;1;41;38551
84;38;01;15;552;Villard-Saint-Christophe;403;12;415;38552
84;38;02;14;553;Villefontaine;18835;271;19106;38553
84;38;02;04;554;Villemoirieu;1820;69;1889;38554
84;38;03;01;555;Villeneuve-de-Marc;1160;30;1190;38555
84;38;03;21;556;Ville-sous-Anjou;1179;20;1199;38556
84;38;02;04;557;Villette-d'Anthon;5113;89;5202;38557
84;38;03;27;558;Villette-de-Vienne;1920;31;1951;38558
84;38;01;23;559;Vinay;4352;73;4425;38559
84;38;02;08;560;Val-de-Virieu;1537;19;1556;38560
84;38;03;01;561;Viriville;1664;32;1696;38561
84;38;01;19;562;Vizille;7246;168;7414;38562
84;38;01;29;563;Voiron;20372;499;20871;38563
84;38;02;03;564;Voissant;234;10;244;38564
84;38;01;29;565;Voreppe;9275;373;9648;38565
84;38;01;25;566;Vourey;1700;48;1748;38566
84;38;01;19;567;Chamrousse;407;5;412;38567
27;39;01;17;001;Abergement-la-Ronce;859;25;884;39001
27;39;01;01;002;Abergement-le-Grand;61;1;62;39002
27;39;01;03;003;Abergement-le-Petit;46;0;46;39003
27;39;01;01;004;Abergement-lès-Thésy;53;3;56;39004
27;39;01;01;006;Aiglepierre;444;16;460;39006
27;39;02;09;007;Alièze;151;5;156;39007
27;39;01;02;008;Amange;444;49;493;39008
27;39;02;04;009;Andelot-en-Montagne;509;11;520;39009
27;39;02;13;010;Andelot-Morval;93;1;94;39010
27;39;01;17;011;Annoire;404;5;409;39011
27;39;01;01;013;Arbois;3295;209;3504;39013
27;39;01;02;014;Archelange;216;6;222;39014
27;39;02;04;015;Ardon;116;2;118;39015
27;39;02;09;016;Arinthod;1094;34;1128;39016
27;39;02;03;017;Arlay;1206;37;1243;39017
27;39;02;09;018;Aromas;658;18;676;39018
27;39;01;01;019;Les Arsures;218;10;228;39019
27;39;02;15;020;Arsure-Arsurette;100;4;104;39020
27;39;02;13;021;La Chailleuse;594;14;608;39021
27;39;01;17;022;Asnans-Beauvoisin;739;12;751;39022
27;39;01;02;024;Audelange;272;6;278;39024
27;39;02;13;025;Augea;269;7;276;39025
27;39;01;10;026;Augerans;181;1;182;39026
27;39;02;13;027;Augisey;191;6;197;39027
27;39;01;03;028;Aumont;475;7;482;39028
27;39;01;17;029;Aumur;370;9;379;39029
27;39;01;02;030;Authume;820;21;841;39030
27;39;01;02;031;Auxange;201;3;204;39031
27;39;03;14;032;Avignon-lès-Saint-Claude;364;17;381;39032
27;39;01;17;034;Balaiseaux;315;8;323;39034
27;39;02;13;035;Balanod;351;9;360;39035
27;39;01;10;037;Bans;195;4;199;39037
27;39;02;15;038;Barésia-sur-l'Ain;146;2;148;39038
27;39;01;10;039;La Barre;239;5;244;39039
27;39;01;03;040;Barretaine;177;2;179;39040
27;39;02;12;041;Baume-les-Messieurs;160;6;166;39041
27;39;01;02;042;Baverans;492;21;513;39042
27;39;02;13;043;Beaufort-Orbagna;1398;20;1418;39043
27;39;02;09;045;Beffia;81;3;84;39045
27;39;03;16;046;Bellecombe;71;4;75;39046
27;39;03;11;047;Bellefontaine;527;16;543;39047
27;39;01;10;048;Belmont;251;8;259;39048
27;39;01;03;049;Bersaillin;408;14;422;39049
27;39;01;12;050;Besain;158;10;168;39050
27;39;01;02;051;Biarne;409;5;414;39051
27;39;02;15;052;Bief-des-Maisons;68;0;68;39052
27;39;02;15;053;Bief-du-Fourg;208;4;212;39053
27;39;01;03;054;Biefmorin;110;1;111;39054
27;39;02;15;055;Billecul;47;1;48;39055
27;39;02;03;056;Bletterans;1500;28;1528;39056
27;39;02;12;057;Blois-sur-Seille;101;1;102;39057
27;39;02;12;058;Blye;174;5;179;39058
27;39;03;11;059;Bois-d'Amont;1642;42;1684;39059
27;39;02;03;060;Bois-de-Gand;55;1;56;39060
27;39;02;15;061;Boissia;109;5;114;39061
27;39;02;09;062;La Boissière;70;0;70;39062
27;39;02;15;063;Bonlieu;267;6;273;39063
27;39;02;12;065;Bonnefontaine;112;0;112;39065
27;39;02;08;066;Bornay;179;6;185;39066
27;39;03;16;068;Les Bouchoux;308;9;317;39068
27;39;02;04;070;Bourg-de-Sirod;94;2;96;39070
27;39;01;01;072;Bracon;268;7;275;39072
27;39;01;03;073;Brainans;170;6;176;39073
27;39;01;02;074;Brans;206;8;214;39074
27;39;01;10;076;La Bretenière;220;1;221;39076
27;39;01;17;077;Bretenières;43;1;44;39077
27;39;01;02;078;Brevans;682;14;696;39078
27;39;02;12;079;Briod;204;9;213;39079
27;39;02;13;080;Broissia;62;2;64;39080
27;39;01;12;081;Buvilly;388;8;396;39081
27;39;02;15;083;Censeau;319;6;325;39083
27;39;01;01;084;Cernans;143;4;147;39084
27;39;02;15;085;Cerniébaud;89;1;90;39085
27;39;02;09;086;Cernon;237;2;239;39086
27;39;02;13;088;Cesancey;392;11;403;39088
27;39;01;17;090;Chaînée-des-Coupis;184;4;188;39090
27;39;02;15;091;Les Chalesmes;91;1;92;39091
27;39;02;09;092;Chambéria;182;1;183;39092
27;39;01;10;093;Chamblay;424;10;434;39093
27;39;01;12;094;Chamole;163;7;170;39094
27;39;01;10;095;Champagne-sur-Loue;123;5;128;39095
27;39;01;02;096;Champagney;469;8;477;39096
27;39;02;04;097;Champagnole;8014;407;8421;39097
27;39;01;17;099;Champdivers;438;7;445;39099
27;39;02;03;100;Champrougier;102;3;105;39100
27;39;01;05;101;Champvans;1442;33;1475;39101
27;39;03;09;102;Chancia;228;4;232;39102
27;39;01;01;103;La Chapelle-sur-Furieuse;308;1;309;39103
27;39;02;03;104;Chapelle-Voland;604;9;613;39104
27;39;02;04;105;Chapois;219;9;228;39105
27;39;03;09;106;Charchilla;289;6;295;39106
27;39;02;15;107;Charcier;139;3;142;39107
27;39;02;15;108;Charency;55;3;58;39108
27;39;02;15;109;Charézier;178;2;180;39109
27;39;02;03;110;La Charme;66;0;66;39110
27;39;02;09;111;Charnod;39;0;39;39111
27;39;02;03;112;La Chassagne;110;1;111;39112
27;39;02;12;114;Château-Chalon;141;7;148;39114
27;39;01;01;116;La Châtelaine;149;2;151;39116
27;39;01;10;117;Chatelay;109;6;115;39117
27;39;03;09;118;Châtel-de-Joux;53;0;53;39118
27;39;01;03;119;Le Chateley;86;3;89;39119
27;39;02;04;120;Châtelneuf;130;8;138;39120
27;39;01;02;121;Châtenois;406;7;413;39121
27;39;02;12;122;Châtillon;108;5;113;39122
27;39;02;03;124;Chaumergy;472;15;487;39124
27;39;03;15;126;La Chaumusse;395;11;406;39126
27;39;01;12;127;Chaussenans;106;1;107;39127
27;39;01;17;128;Chaussin;1575;24;1599;39128
27;39;02;15;129;Chaux-des-Crotenay;396;14;410;39129
27;39;03;14;130;Nanchez;805;22;827;39130
27;39;03;15;131;La Chaux-du-Dombief;571;13;584;39131
27;39;02;03;132;La Chaux-en-Bresse;34;0;34;39132
27;39;01;01;133;Chaux-Champagny;70;2;72;39133
27;39;02;09;134;Chavéria;227;8;235;39134
27;39;02;03;136;Chemenot;37;1;38;39136
27;39;02;09;137;Saint-Hymetière-sur-Valouse;440;15;455;39137
27;39;01;17;138;Chemin;343;10;353;39138
27;39;01;17;139;Chêne-Bernard;73;0;73;39139
27;39;02;03;140;Chêne-Sec;39;0;39;39140
27;39;01;02;141;Chevigny;281;6;287;39141
27;39;02;13;142;Chevreaux;129;1;130;39142
27;39;02;15;143;Chevrotaine;34;0;34;39143
27;39;02;07;145;Chille;295;19;314;39145
27;39;02;08;146;Chilly-le-Vignoble;627;25;652;39146
27;39;01;01;147;Chilly-sur-Salins;100;4;104;39147
27;39;01;10;149;Chissey-sur-Loue;310;9;319;39149
27;39;01;06;150;Choisey;1023;30;1053;39150
27;39;03;16;151;Choux;124;6;130;39151
27;39;02;04;153;Cize;795;31;826;39153
27;39;02;15;154;Clairvaux-les-Lacs;1435;43;1478;39154
27;39;01;01;155;Clucy;77;0;77;39155
27;39;02;15;156;Cogna;245;7;252;39156
27;39;03;16;157;Coiserette;53;3;56;39157
27;39;01;03;159;Colonne;262;2;264;39159
27;39;02;03;160;Commenailles;896;17;913;39160
27;39;02;07;162;Condamine;260;5;265;39162
27;39;02;09;163;Condes;114;3;117;39163
27;39;02;12;164;Conliège;664;27;691;39164
27;39;02;15;165;Conte;55;0;55;39165
27;39;02;09;166;Cornod;216;4;220;39166
27;39;02;03;167;Cosges;360;5;365;39167
27;39;02;09;168;Courbette;46;0;46;39168
27;39;02;08;169;Courbouzon;592;15;607;39169
27;39;02;07;170;Courlans;923;28;951;39170
27;39;02;07;171;Courlaoux;1144;31;1175;39171
27;39;01;10;172;Courtefontaine;254;14;268;39172
27;39;02;13;173;Cousance;1300;25;1325;39173
27;39;03;16;174;Coyrière;65;0;65;39174
27;39;03;09;175;Coyron;72;7;79;39175
27;39;01;10;176;Cramans;526;8;534;39176
27;39;02;12;177;Hauteroche;969;24;993;39177
27;39;02;15;178;Crans;73;1;74;39178
27;39;03;09;179;Crenans;237;5;242;39179
27;39;02;13;180;Cressia;253;120;373;39180
27;39;01;06;182;Crissey;677;25;702;39182
27;39;02;04;183;Crotenay;630;80;710;39183
27;39;03;09;184;Les Crozets;194;5;199;39184
27;39;02;13;185;Cuisia;390;12;402;39185
27;39;02;15;187;Cuvier;270;7;277;39187
27;39;01;02;188;Dammartin-Marpain;345;4;349;39188
27;39;01;06;189;Damparis;2629;79;2708;39189
27;39;01;10;190;Dampierre;1293;28;1321;39190
27;39;01;03;191;Darbonnay;85;5;90;39191
27;39;02;15;192;Denezières;72;1;73;39192
27;39;01;17;193;Le Deschaux;1012;17;1029;39193
27;39;02;03;194;Desnes;481;6;487;39194
27;39;02;03;196;Les Deux-Fays;114;2;116;39196
27;39;02;13;197;Digna;359;11;370;39197
27;39;01;98;198;Dole;23711;893;24604;39198
27;39;02;12;199;Domblans;1232;30;1262;39199
27;39;02;09;200;Dompierre-sur-Mont;219;7;226;39200
27;39;02;15;201;Doucier;281;39;320;39201
27;39;01;01;202;Dournon;139;1;140;39202
27;39;02;15;203;Doye;104;2;106;39203
27;39;02;09;204;Dramelay;29;3;32;39204
27;39;01;02;205;Eclans-Nenon;382;8;390;39205
27;39;01;10;206;Ecleux;228;10;238;39206
27;39;02;09;207;Ecrille;78;3;81;39207
27;39;02;15;208;Entre-deux-Monts;136;8;144;39208
27;39;02;13;209;Val-d'Epy;325;7;332;39209
27;39;02;04;210;Equevillon;582;14;596;39210
27;39;01;17;211;Les Essards-Taignevaux;256;3;259;39211
27;39;02;15;214;Esserval-Tartre;122;3;125;39214
27;39;03;09;216;Etival;310;11;321;39216
27;39;02;07;217;L'Etoile;565;14;579;39217
27;39;01;10;218;Etrepigney;427;6;433;39218
27;39;01;10;219;Evans;657;12;669;39219
27;39;01;02;220;Falletans;401;9;410;39220
27;39;02;15;221;La Favière;31;1;32;39221
27;39;01;12;222;Fay-en-Montagne;82;7;89;39222
27;39;01;01;223;La Ferté;197;2;199;39223
27;39;01;12;225;Le Fied;195;6;201;39225
27;39;02;15;227;Foncine-le-Bas;189;7;196;39227
27;39;02;15;228;Foncine-le-Haut;1081;28;1109;39228
27;39;02;03;229;Fontainebrux;203;10;213;39229
27;39;02;15;230;Fontenu;75;3;78;39230
27;39;03;15;232;Fort-du-Plasne;442;11;453;39232
27;39;01;05;233;Foucherans;2266;40;2306;39233
27;39;02;03;234;Foulenay;79;0;79;39234
27;39;01;10;235;Fraisans;1192;14;1206;39235
27;39;02;03;236;Francheville;59;1;60;39236
27;39;02;15;237;Fraroz;51;4;55;39237
27;39;01;02;238;Frasne-les-Meulières;110;7;117;39238
27;39;02;15;239;La Frasnée;39;2;41;39239
27;39;02;15;240;Le Frasnois;167;5;172;39240
27;39;02;08;241;Frébuans;375;9;384;39241
27;39;02;12;244;Frontenay;159;5;164;39244
27;39;01;17;245;Gatey;360;9;369;39245
27;39;01;02;246;Gendrey;425;13;438;39246
27;39;02;09;247;Genod;72;2;74;39247
27;39;01;01;248;Geraise;44;0;44;39248
27;39;01;10;249;Germigney;76;4;80;39249
27;39;02;08;250;Geruge;172;7;179;39250
27;39;02;08;251;Gevingey;452;95;547;39251
27;39;01;06;252;Gevry;706;10;716;39252
27;39;02;13;253;Gigny;276;8;284;39253
27;39;02;15;254;Gillois;137;6;143;39254
27;39;02;13;255;Gizia;232;4;236;39255
27;39;03;15;258;Grande-Rivière Château;626;19;645;39258
27;39;01;10;259;Grange-de-Vaivre;32;1;33;39259
27;39;02;13;261;Graye-et-Charnay;141;2;143;39261
27;39;01;02;262;Gredisans;135;1;136;39262
27;39;01;03;263;Grozon;396;14;410;39263
27;39;02;15;265;Hautecour;197;4;201;39265
27;39;01;17;266;Les Hays;344;2;346;39266
27;39;01;01;267;Ivory;103;1;104;39267
27;39;01;01;268;Ivrey;58;1;59;39268
27;39;03;09;269;Jeurre;269;1;270;39269
27;39;01;02;270;Jouhe;546;62;608;39270
27;39;03;15;271;Lac-des-Rouges-Truites;394;17;411;39271
27;39;02;12;272;Ladoye-sur-Seille;49;3;52;39272
27;39;02;13;273;Montlainsia;241;7;248;39273
27;39;03;16;274;Lajoux;285;13;298;39274
27;39;03;16;275;Lamoura;647;17;664;39275
27;39;02;04;277;Le Larderet;60;1;61;39277
27;39;02;15;278;Largillay-Marsonnay;143;2;145;39278
27;39;02;03;279;Larnaud;606;13;619;39279
27;39;03;16;280;Larrivoire;101;2;103;39280
27;39;02;04;281;Le Latet;85;2;87;39281
27;39;02;15;282;La Latette;80;2;82;39282
27;39;03;16;283;Lavancia-Epercy;629;18;647;39283
27;39;01;02;284;Lavangeot;142;2;144;39284
27;39;01;02;285;Lavans-lès-Dole;328;8;336;39285
27;39;03;16;286;Lavans-lès-Saint-Claude;2352;108;2460;39286
27;39;02;12;288;Lavigny;385;5;390;39288
27;39;03;09;289;Lect;350;7;357;39289
27;39;02;09;290;Valzin en Petite Montagne;476;17;493;39290
27;39;01;01;291;Lemuy;240;5;245;39291
27;39;02;04;292;Lent;154;4;158;39292
27;39;03;14;293;Leschères;207;4;211;39293
27;39;02;13;295;Loisia;167;1;168;39295
27;39;02;03;296;Lombard;215;5;220;39296
27;39;03;11;297;Longchaumois;1143;32;1175;39297
27;39;02;15;298;Longcochon;60;3;63;39298
27;39;01;17;299;Longwy-sur-le-Doubs;491;10;501;39299
27;39;02;99;300;Lons-le-Saunier;17189;810;17999;39300
27;39;02;04;301;Loulle;171;4;175;39301
27;39;01;02;302;Louvatange;94;4;98;39302
27;39;02;12;304;Le Louverot;222;9;231;39304
27;39;01;10;305;La Loye;562;10;572;39305
27;39;02;08;306;Macornay;955;36;991;39306
27;39;03;09;307;Maisod;332;10;342;39307
27;39;01;02;308;Malange;318;7;325;39308
27;39;02;03;310;Mantry;470;13;483;39310
27;39;02;09;312;Marigna-sur-Valouse;111;4;115;39312
27;39;02;15;313;Marigny;213;1;214;39313
27;39;02;09;314;Marnézia;80;4;84;39314
27;39;01;01;315;Marnoz;396;22;418;39315
27;39;02;12;317;La Marre;352;15;367;39317
27;39;03;09;318;Martigna;192;13;205;39318
27;39;01;01;319;Mathenay;144;1;145;39319
27;39;02;13;320;Maynal;334;1;335;39320
27;39;02;12;321;Menétru-le-Vignoble;157;2;159;39321
27;39;02;15;322;Menétrux-en-Joux;53;2;55;39322
27;39;01;02;323;Menotey;312;14;326;39323
27;39;02;09;324;Mérona;7;0;7;39324
27;39;01;01;325;Mesnay;577;15;592;39325
27;39;02;15;326;Mesnois;177;4;181;39326
27;39;02;08;327;Messia-sur-Sorne;847;13;860;39327
27;39;03;09;328;Meussia;421;7;428;39328
27;39;02;15;329;Mièges;172;3;175;39329
27;39;01;03;330;Miéry;152;5;157;39330
27;39;02;15;331;Mignovillard;828;26;854;39331
27;39;03;09;333;Moirans-en-Montagne;2120;113;2233;39333
27;39;02;08;334;Moiron;127;5;132;39334
27;39;01;02;335;Moissey;567;11;578;39335
27;39;01;12;336;Molain;110;4;114;39336
27;39;01;01;337;Molamboz;88;3;91;39337
27;39;01;17;338;Molay;506;6;512;39338
27;39;03;16;339;Chassal-Molinges;1123;28;1151;39339
27;39;01;03;342;Monay;123;1;124;39342
27;39;02;13;343;Monnetay;15;1;16;39343
27;39;02;04;344;Monnet-la-Ville;335;14;349;39344
27;39;01;05;345;Monnières;405;15;420;39345
27;39;02;13;346;Montagna-le-Reconduit;114;5;119;39346
27;39;02;12;348;Montaigu;417;47;464;39348
27;39;02;12;349;Montain;490;23;513;39349
27;39;01;10;350;Montbarrey;310;4;314;39350
27;39;03;09;351;Montcusel;147;7;154;39351
27;39;01;10;352;Monteplain;132;2;134;39352
27;39;02;13;353;Montfleur;166;9;175;39353
27;39;01;03;354;Montholier;367;3;370;39354
27;39;01;01;355;Montigny-lès-Arsures;238;8;246;39355
27;39;02;04;356;Montigny-sur-l'Ain;207;8;215;39356
27;39;01;01;359;Montmarlon;32;1;33;39359
27;39;01;02;360;Montmirey-la-Ville;171;2;173;39360
27;39;01;02;361;Montmirey-le-Château;195;5;200;39361
27;39;02;07;362;Montmorot;3082;331;3413;39362
27;39;02;13;363;Montrevel;84;1;85;39363
27;39;02;04;364;Montrond;491;14;505;39364
27;39;01;10;365;Mont-sous-Vaudrey;1275;22;1297;39365
27;39;02;04;366;Mont-sur-Monnet;242;6;248;39366
27;39;03;11;367;Morbier;2263;82;2345;39367
27;39;03;11;368;Hauts de Bienne;5275;270;5545;39368
27;39;01;10;370;Mouchard;1070;313;1383;39370
27;39;02;15;372;Mournans-Charbonny;87;9;96;39372
27;39;03;16;373;Les Moussières;160;4;164;39373
27;39;02;09;375;Moutonne;129;0;129;39375
27;39;02;04;376;Moutoux;74;2;76;39376
27;39;01;02;377;Mutigney;173;8;181;39377
27;39;02;13;378;Les Trois-Châteaux;765;15;780;39378
27;39;02;03;379;Nance;525;11;536;39379
27;39;02;09;380;Nancuise;46;2;48;39380
27;39;02;04;381;Les Nans;96;3;99;39381
27;39;01;17;385;Neublans-Abergement;541;5;546;39385
27;39;01;03;386;Neuvilley;89;0;89;39386
27;39;01;10;387;Nevy-lès-Dole;291;6;297;39387
27;39;02;12;388;Nevy-sur-Seille;196;8;204;39388
27;39;02;04;389;Ney;589;14;603;39389
27;39;02;12;390;Nogna;296;12;308;39390
27;39;02;15;391;Nozeroy;408;12;420;39391
27;39;01;02;392;Offlanges;194;3;197;39392
27;39;02;15;393;Onglières;63;2;65;39393
27;39;02;09;394;Onoz;71;4;75;39394
27;39;01;10;396;Orchamps;1134;16;1150;39396
27;39;02;09;397;Orgelet;1606;45;1651;39397
27;39;01;02;398;Ougney;395;3;398;39398
27;39;01;10;399;Ounans;349;8;357;39399
27;39;01;10;400;Our;144;2;146;39400
27;39;01;03;401;Oussières;238;5;243;39401
27;39;01;02;402;Pagney;319;7;326;39402
27;39;01;10;403;Pagnoz;220;5;225;39403
27;39;02;12;404;Pannessières;488;10;498;39404
27;39;01;06;405;Parcey;999;21;1020;39405
27;39;02;04;406;Le Pasquier;262;3;265;39406
27;39;02;03;407;Passenans;335;6;341;39407
27;39;02;15;408;Patornay;149;6;155;39408
27;39;01;02;409;Peintre;133;1;134;39409
27;39;02;12;411;Perrigny;1515;46;1561;39411
27;39;01;17;412;Peseux;320;2;322;39412
27;39;03;16;413;La Pesse;334;7;341;39413
27;39;01;17;415;Petit-Noir;1095;10;1105;39415
27;39;01;12;418;Picarreau;98;2;100;39418
27;39;02;04;419;Pillemoine;62;1;63;39419
27;39;02;09;420;Pimorin;209;3;212;39420
27;39;02;12;421;Le Pin;238;15;253;39421
27;39;02;12;422;Plainoiseau;528;13;541;39422
27;39;02;09;423;Plaisia;106;9;115;39423
27;39;02;15;424;Les Planches-en-Montagne;161;3;164;39424
27;39;01;01;425;Les Planches-près-Arbois;89;1;90;39425
27;39;01;03;426;Plasne;212;10;222;39426
27;39;02;15;427;Plénise;62;0;62;39427
27;39;02;15;428;Plénisette;23;3;26;39428
27;39;01;17;429;Pleure;440;3;443;39429
27;39;01;10;430;Plumont;105;2;107;39430
27;39;02;12;431;Poids-de-Fiole;335;4;339;39431
27;39;01;02;432;Pointre;127;1;128;39432
27;39;01;12;434;Poligny;4003;362;4365;39434
27;39;02;15;435;Pont-de-Poitte;630;22;652;39435
27;39;01;01;436;Pont-d'Héry;230;8;238;39436
27;39;02;04;437;Pont-du-Navoy;274;5;279;39437
27;39;01;10;439;Port-Lesney;524;12;536;39439
27;39;03;11;441;Prémanon;1200;31;1231;39441
27;39;02;09;443;Présilly;123;5;128;39443
27;39;01;01;444;Pretin;61;2;63;39444
27;39;02;12;445;Publy;283;15;298;39445
27;39;01;01;446;Pupillin;244;3;247;39446
27;39;02;03;447;Quintigny;253;6;259;39447
27;39;01;17;448;Rahon;477;15;492;39448
27;39;01;02;449;Rainans;266;10;276;39449
27;39;01;10;451;Ranchot;504;4;508;39451
27;39;01;10;452;Rans;532;7;539;39452
27;39;03;14;453;Ravilloles;453;12;465;39453
27;39;02;03;454;Recanoz;91;2;93;39454
27;39;02;09;455;Reithouse;55;1;56;39455
27;39;02;03;456;Relans;342;4;346;39456
27;39;02;03;457;Les Repôts;54;0;54;39457
27;39;02;12;458;Revigny;243;12;255;39458
27;39;03;14;460;La Rixouse;193;8;201;39460
27;39;02;15;461;Rix;82;0;82;39461
27;39;01;02;462;Rochefort-sur-Nenon;677;5;682;39462
27;39;03;16;463;Rogna;230;6;236;39463
27;39;01;02;464;Romain;210;6;216;39464
27;39;01;02;465;Romange;201;2;203;39465
27;39;02;13;466;Rosay;123;0;123;39466
27;39;02;13;467;Rotalier;156;6;162;39467
27;39;02;09;468;Rothonay;138;4;142;39468
27;39;01;02;469;Rouffange;113;2;115;39469
27;39;03;11;470;Les Rousses;3648;82;3730;39470
27;39;02;03;471;Ruffey-sur-Seille;747;17;764;39471
27;39;02;03;472;Rye;213;4;217;39472
27;39;02;15;473;Saffloz;90;2;92;39473
27;39;02;13;474;Sainte-Agnès;355;10;365;39474
27;39;02;13;475;Saint-Amour;2392;100;2492;39475
27;39;01;17;476;Saint-Aubin;1814;43;1857;39476
27;39;01;17;477;Saint-Baraing;260;5;265;39477
27;39;03;14;478;Saint-Claude;8985;240;9225;39478
27;39;01;01;479;Saint-Cyr-Montmalin;241;6;247;39479
27;39;02;07;480;Saint-Didier;260;15;275;39480
27;39;02;04;481;Saint-Germain-en-Montagne;389;9;398;39481
27;39;02;13;485;Val Suran;787;13;800;39485
27;39;02;03;486;Saint-Lamain;115;4;119;39486
27;39;03;15;487;Saint-Laurent-en-Grandvaux;1812;36;1848;39487
27;39;01;03;489;Saint-Lothain;461;11;472;39489
27;39;01;17;490;Saint-Loup;249;7;256;39490
27;39;03;16;491;Coteaux du Lizon;2260;94;2354;39491
27;39;02;12;492;Saint-Maur;236;3;239;39492
27;39;02;15;493;Saint-Maurice-Crillat;235;2;237;39493
27;39;03;15;494;Saint-Pierre;359;21;380;39494
27;39;01;01;495;Saint-Thiébaud;66;0;66;39495
27;39;01;01;497;Saizenay;93;2;95;39497
27;39;01;10;498;Salans;602;12;614;39498
27;39;01;02;499;Saligney;194;3;197;39499
27;39;01;01;500;Salins-les-Bains;2551;149;2700;39500
27;39;01;05;501;Sampans;1200;12;1212;39501
27;39;01;10;502;Santans;281;7;288;39502
27;39;02;04;503;Sapois;385;15;400;39503
27;39;02;09;504;Sarrogna;224;9;233;39504
27;39;02;15;505;Saugeot;61;3;64;39505
27;39;01;17;507;Séligney;79;1;80;39507
27;39;02;03;508;Sellières;719;10;729;39508
27;39;03;16;510;Septmoncel les Molunes;800;24;824;39510
27;39;02;03;511;Sergenaux;63;3;66;39511
27;39;02;03;512;Sergenon;49;1;50;39512
27;39;01;02;513;Sermange;236;1;237;39513
27;39;01;02;514;Serre-les-Moulières;189;11;200;39514
27;39;02;04;517;Sirod;517;20;537;39517
27;39;02;15;518;Songeson;70;1;71;39518
27;39;02;15;519;Soucia;177;6;183;39519
27;39;01;10;520;Souvans;478;5;483;39520
27;39;02;04;522;Supt;103;2;105;39522
27;39;02;04;523;Syam;189;8;197;39523
27;39;01;17;525;Tassenières;395;7;402;39525
27;39;01;17;526;Tavaux;3957;97;4054;39526
27;39;01;02;527;Taxenne;118;1;119;39527
27;39;01;02;528;Thervay;384;7;391;39528
27;39;01;01;529;Thésy;65;1;66;39529
27;39;02;09;530;Thoirette-Coisia;855;24;879;39530
27;39;02;15;531;Thoiria;185;5;190;39531
27;39;02;13;532;Thoissia;39;1;40;39532
27;39;02;03;533;Toulouse-le-Château;217;6;223;39533
27;39;02;09;534;La Tour-du-Meix;245;4;249;39534
27;39;01;03;535;Tourmont;462;16;478;39535
27;39;02;08;537;Trenal;456;12;468;39537
27;39;02;15;538;Uxelles;59;1;60;39538
27;39;01;01;539;Vadans;286;7;293;39539
27;39;02;04;540;Valempoulières;191;11;202;39540
27;39;02;04;543;Vannoz;216;8;224;39543
27;39;02;04;545;Le Vaudioux;173;7;180;39545
27;39;01;10;546;Vaudrey;354;13;367;39546
27;39;03;16;547;Vaux-lès-Saint-Claude;682;18;700;39547
27;39;01;12;548;Vaux-sur-Poligny;74;5;79;39548
27;39;02;12;550;Verges;193;5;198;39550
27;39;02;13;551;Véria;116;3;119;39551
27;39;02;08;552;Vernantois;303;11;314;39552
27;39;02;12;553;Le Vernois;292;10;302;39553
27;39;02;04;554;Vers-en-Montagne;230;5;235;39554
27;39;02;03;555;Vers-sous-Sellières;247;2;249;39555
27;39;02;15;556;Vertamboz;95;3;98;39556
27;39;02;09;557;Vescles;187;9;196;39557
27;39;02;12;558;Vevy;288;12;300;39558
27;39;01;10;559;La Vieille-Loye;395;4;399;39559
27;39;03;16;560;Villard-Saint-Sauveur;615;20;635;39560
27;39;03;09;561;Villards-d'Héria;391;6;397;39561
27;39;01;10;565;Villeneuve-d'Aval;85;1;86;39565
27;39;02;07;567;Villeneuve-sous-Pymont;301;9;310;39567
27;39;01;03;568;Villerserine;42;3;45;39568
27;39;01;10;569;Villers-Farlay;678;10;688;39569
27;39;01;03;570;Villers-les-Bois;215;1;216;39570
27;39;01;17;571;Villers-Robert;232;2;234;39571
27;39;01;01;572;Villette-lès-Arbois;392;7;399;39572
27;39;01;06;573;Villette-lès-Dole;775;13;788;39573
27;39;02;03;574;Villevieux;712;20;732;39574
27;39;02;03;575;Le Villey;88;0;88;39575
27;39;02;13;576;Val-Sonnette;928;34;962;39576
27;39;02;03;577;Vincent-Froideville;399;2;401;39577
27;39;03;16;579;Viry;904;42;946;39579
27;39;01;02;581;Vitreux;282;4;286;39581
27;39;02;12;582;Voiteur;770;23;793;39582
27;39;02;09;583;Vosbles-Valfin;184;6;190;39583
27;39;01;02;584;Vriange;163;2;165;39584
27;39;03;16;585;Vulvoz;22;0;22;39585
27;39;01;01;586;Aresches;30;0;30;39586
75;40;02;01;001;Aire-sur-l'Adour;6189;555;6744;40001
75;40;01;04;002;Amou;1569;23;1592;40002
75;40;01;05;003;Angoumé;274;9;283;40003
75;40;01;09;004;Angresse;2129;49;2178;40004
75;40;02;02;005;Arboucave;202;3;205;40005
75;40;02;13;006;Arengosse;698;7;705;40006
75;40;01;04;007;Argelos;166;2;168;40007
75;40;02;08;008;Argelouse;97;2;99;40008
75;40;01;04;011;Arsague;334;3;337;40011
75;40;02;01;012;Artassenx;259;4;263;40012
75;40;02;01;013;Arthez-d'Armagnac;101;5;106;40013
75;40;02;08;014;Arue;358;4;362;40014
75;40;02;08;015;Arx;48;1;49;40015
75;40;02;02;016;Aubagnan;253;3;256;40016
75;40;02;02;017;Audignon;397;1;398;40017
75;40;01;13;018;Audon;384;6;390;40018
75;40;02;03;019;Aureilhan;1068;28;1096;40019
75;40;02;02;020;Aurice;620;23;643;40020
75;40;01;09;021;Azur;883;20;903;40021
75;40;02;01;022;Bahus-Soubiran;396;14;410;40022
75;40;01;04;023;Baigts;350;8;358;40023
75;40;02;02;024;Banos;264;4;268;40024
75;40;02;01;025;Bascons;831;31;862;40025
75;40;02;02;026;Bas-Mauco;359;10;369;40026
75;40;01;04;027;Bassercles;154;2;156;40027
75;40;01;04;028;Bastennes;253;9;262;40028
75;40;02;02;029;Bats;313;3;316;40029
75;40;02;08;030;Baudignan;50;0;50;40030
75;40;01;13;031;Bégaar;1185;12;1197;40031
75;40;02;07;032;Belhade;207;1;208;40032
75;40;02;08;033;Bélis;160;5;165;40033
75;40;01;12;034;Bélus;604;13;617;40034
75;40;01;06;035;Bénesse-lès-Dax;574;11;585;40035
75;40;01;14;036;Bénesse-Maremne;3683;70;3753;40036
75;40;02;11;037;Benquet;1832;46;1878;40037
75;40;01;04;038;Bergouey;105;4;109;40038
75;40;02;08;039;Betbezer-d'Armagnac;151;0;151;40039
75;40;01;13;040;Beylongue;358;2;360;40040
75;40;01;04;041;Beyries;128;2;130;40041
75;40;01;15;042;Biarrotte;328;7;335;40042
75;40;02;03;043;Bias;763;13;776;40043
75;40;01;15;044;Biaudos;919;33;952;40044
75;40;02;07;046;Biscarrosse;13947;345;14292;40046
75;40;01;04;047;Bonnegarde;268;5;273;40047
75;40;02;01;049;Bordères-et-Lamensans;394;6;400;40049
75;40;02;10;050;Bostens;211;2;213;40050
75;40;02;11;051;Bougue;820;25;845;40051
75;40;02;01;052;Bourdalat;224;4;228;40052
75;40;02;08;053;Bourriot-Bergonce;306;4;310;40053
75;40;01;04;054;Brassempouy;263;6;269;40054
75;40;02;11;055;Bretagne-de-Marsan;1612;29;1641;40055
75;40;02;08;056;Brocas;780;22;802;40056
75;40;02;01;057;Buanes;252;6;258;40057
75;40;02;08;058;Cachen;227;11;238;40058
75;40;01;12;059;Cagnotte;763;20;783;40059
75;40;02;08;060;Callen;142;4;146;40060
75;40;02;11;061;Campagne;999;26;1025;40061
75;40;02;10;062;Campet-et-Lamolère;510;7;517;40062
75;40;01;06;063;Candresse;812;27;839;40063
75;40;02;08;064;Canenx-et-Réaut;166;2;168;40064
75;40;01;14;065;Capbreton;9037;314;9351;40065
75;40;01;13;066;Carcarès-Sainte-Croix;528;4;532;40066
75;40;01;13;067;Carcen-Ponson;632;5;637;40067
75;40;01;04;068;Cassen;585;17;602;40068
75;40;01;04;069;Castaignos-Souslens;409;5;414;40069
75;40;02;01;070;Castandet;398;17;415;40070
75;40;01;04;071;Castelnau-Chalosse;601;43;644;40071
75;40;02;02;072;Castelnau-Tursan;186;2;188;40072
75;40;02;02;073;Castelner;115;2;117;40073
75;40;01;04;074;Castel-Sarrazin;556;20;576;40074
75;40;01;03;075;Castets;2463;27;2490;40075
75;40;02;02;076;Cauna;443;7;450;40076
75;40;01;12;077;Cauneille;799;17;816;40077
75;40;01;04;078;Caupenne;397;8;405;40078
75;40;02;02;079;Cazalis;137;5;142;40079
75;40;02;01;080;Cazères-sur-l'Adour;1115;32;1147;40080
75;40;02;08;081;Cère;411;6;417;40081
75;40;02;01;082;Classun;258;8;266;40082
75;40;02;02;083;Clèdes;123;7;130;40083
75;40;01;04;084;Clermont;754;35;789;40084
75;40;02;08;085;Commensacq;426;12;438;40085
75;40;02;02;086;Coudures;508;9;517;40086
75;40;02;08;087;Créon-d'Armagnac;361;7;368;40087
75;40;01;98;088;Dax;20843;841;21684;40088
75;40;01;04;089;Doazit;855;27;882;40089
75;40;01;04;090;Donzacq;464;10;474;40090
75;40;02;01;091;Duhort-Bachen;654;19;673;40091
75;40;02;02;092;Dumes;229;6;235;40092
75;40;02;08;093;Escalans;254;3;257;40093
75;40;02;08;094;Escource;744;11;755;40094
75;40;01;12;095;Estibeaux;701;18;719;40095
75;40;02;08;096;Estigarde;104;2;106;40096
75;40;02;01;097;Eugénie-les-Bains;447;10;457;40097
75;40;02;02;098;Eyres-Moncube;355;13;368;40098
75;40;02;02;099;Fargues;321;3;324;40099
75;40;02;01;100;Le Frêche;410;2;412;40100
75;40;01;12;101;Gaas;480;18;498;40101
75;40;02;08;102;Gabarret;1289;246;1535;40102
75;40;02;10;103;Gaillères;627;16;643;40103
75;40;01;04;104;Gamarde-les-Bains;1405;34;1439;40104
75;40;02;08;105;Garein;437;11;448;40105
75;40;01;04;106;Garrey;210;6;216;40106
75;40;02;07;108;Gastes;862;14;876;40108
75;40;01;04;109;Gaujacq;431;10;441;40109
75;40;02;02;110;Geaune;723;14;737;40110
75;40;02;10;111;Geloux;701;16;717;40111
75;40;01;04;112;Gibret;101;1;102;40112
75;40;01;04;113;Goos;517;9;526;40113
75;40;01;05;114;Gourbera;363;13;376;40114
75;40;01;04;115;Gousse;289;10;299;40115
75;40;01;13;116;Gouts;274;3;277;40116
75;40;02;01;117;Grenade-sur-l'Adour;2440;82;2522;40117
75;40;01;12;118;Habas;1466;25;1491;40118
75;40;02;02;119;Hagetmau;4651;113;4764;40119
75;40;01;12;120;Hastingues;592;17;609;40120
75;40;01;04;121;Hauriet;277;5;282;40121
75;40;02;02;122;Haut-Mauco;970;30;1000;40122
75;40;01;05;123;Herm;1150;33;1183;40123
75;40;02;08;124;Herré;141;2;143;40124
75;40;01;06;125;Heugas;1352;38;1390;40125
75;40;01;04;126;Hinx;1875;42;1917;40126
75;40;02;01;127;Hontanx;618;4;622;40127
75;40;02;02;128;Horsarrieu;694;20;714;40128
75;40;01;14;129;Josse;869;27;896;40129
75;40;02;02;130;Labastide-Chalosse;157;0;157;40130
75;40;02;08;131;Labastide-d'Armagnac;691;5;696;40131
75;40;01;12;132;Labatut;1420;25;1445;40132
75;40;01;14;133;Labenne;6887;115;7002;40133
75;40;02;08;134;Labouheyre;2736;44;2780;40134
75;40;02;08;135;Labrit;866;8;874;40135
75;40;02;02;136;Lacajunte;157;4;161;40136
75;40;02;01;137;Lacquy;283;10;293;40137
75;40;02;02;138;Lacrabe;281;6;287;40138
75;40;02;11;139;Laglorieuse;552;15;567;40139
75;40;02;08;140;Lagrange;189;3;192;40140
75;40;01;04;141;Lahosse;296;4;300;40141
75;40;01;13;142;Laluque;1049;21;1070;40142
75;40;01;13;143;Lamothe;305;4;309;40143
75;40;01;04;144;Larbey;244;9;253;40144
75;40;02;01;145;Larrivière-Saint-Savin;615;23;638;40145
75;40;02;01;146;Latrille;162;3;165;40146
75;40;01;04;147;Laurède;371;3;374;40147
75;40;02;02;148;Lauret;83;3;86;40148
75;40;02;08;149;Lencouacq;376;5;381;40149
75;40;01;03;150;Léon;1918;52;1970;40150
75;40;01;13;151;Lesgor;431;12;443;40151
75;40;02;13;152;Lesperon;1033;25;1058;40152
75;40;01;13;153;Le Leuy;238;6;244;40153
75;40;01;03;154;Lévignacq;310;6;316;40154
75;40;01;03;155;Linxe;1502;39;1541;40155
75;40;02;07;156;Liposthey;556;5;561;40156
75;40;01;03;157;Lit-et-Mixe;1657;39;1696;40157
75;40;02;08;158;Losse;276;3;279;40158
75;40;01;04;159;Louer;310;7;317;40159
75;40;01;04;160;Lourquen;180;6;186;40160
75;40;02;08;161;Lubbon;86;1;87;40161
75;40;02;10;162;Lucbardez-et-Bargues;581;13;594;40162
75;40;02;07;163;LÃ¼e;567;9;576;40163
75;40;02;08;164;Retjons;356;1;357;40164
75;40;02;08;165;Luglon;386;11;397;40165
75;40;02;01;166;Lussagnet;75;1;76;40166
75;40;02;08;167;Luxey;657;10;667;40167
75;40;01;09;168;Magescq;2322;35;2357;40168
75;40;02;08;169;Maillas;125;3;128;40169
75;40;02;08;170;Maillères;235;3;238;40170
75;40;02;07;171;Mano;114;3;117;40171
75;40;02;02;172;Mant;266;4;270;40172
75;40;01;04;173;Marpaps;139;5;144;40173
75;40;02;02;174;Mauries;86;1;87;40174
75;40;02;01;175;Maurrin;440;6;446;40175
75;40;02;08;176;Mauvezin-d'Armagnac;89;1;90;40176
75;40;01;04;177;Maylis;315;17;332;40177
75;40;02;11;178;Mazerolles;628;28;656;40178
75;40;01;05;179;Mées;1820;47;1867;40179
75;40;01;13;180;Meilhan;1147;31;1178;40180
75;40;01;09;181;Messanges;968;31;999;40181
75;40;02;03;182;Mézos;828;11;839;40182
75;40;01;12;183;Mimbaste;978;32;1010;40183
75;40;02;03;184;Mimizan;7255;165;7420;40184
75;40;02;02;185;Miramont-Sensacq;357;8;365;40185
75;40;01;12;186;Misson;810;17;827;40186
75;40;01;09;187;Moliets-et-Maa;1185;16;1201;40187
75;40;02;02;188;Momuy;468;12;480;40188
75;40;02;02;189;Monget;83;3;86;40189
75;40;02;02;190;Monségur;385;11;396;40190
75;40;02;02;191;Montaut;620;13;633;40191
75;40;02;99;192;Mont-de-Marsan;29807;1413;31220;40192
75;40;02;01;193;Montégut;75;2;77;40193
75;40;01;04;194;Montfort-en-Chalosse;1183;30;1213;40194
75;40;02;02;195;Montgaillard;620;13;633;40195
75;40;02;02;196;Montsoué;574;11;585;40196
75;40;02;13;197;Morcenx-la-Nouvelle;4987;132;5119;40197
75;40;02;02;198;Morganx;173;8;181;40198
75;40;01;12;199;Mouscardès;270;3;273;40199
75;40;02;07;200;Moustey;674;10;684;40200
75;40;01;04;201;Mugron;1343;103;1446;40201
75;40;01;06;202;Narrosse;3230;74;3304;40202
75;40;01;04;203;Nassiet;325;13;338;40203
75;40;01;04;204;Nerbis;265;4;269;40204
75;40;01;04;205;Nousse;247;8;255;40205
75;40;01;12;206;Oeyregave;325;13;338;40206
75;40;01;06;207;Oeyreluy;1507;207;1714;40207
75;40;01;04;208;Onard;366;6;372;40208
75;40;01;15;209;Ondres;5520;121;5641;40209
75;40;02;13;210;Onesse-Laharie;1025;19;1044;40210
75;40;01;12;211;Orist;742;18;760;40211
75;40;01;12;212;Orthevielle;1002;16;1018;40212
75;40;01;14;213;Orx;635;10;645;40213
75;40;01;12;214;Ossages;501;5;506;40214
75;40;02;13;215;Ousse-Suzan;285;8;293;40215
75;40;01;04;216;Ozourt;201;2;203;40216
75;40;02;07;217;Parentis-en-Born;6684;216;6900;40217
75;40;02;08;218;Parleboscq;505;4;509;40218
75;40;02;02;219;Payros-Cazautets;107;2;109;40219
75;40;02;02;220;Pécorade;139;6;145;40220
75;40;02;01;221;Perquie;338;13;351;40221
75;40;01;12;222;Pey;701;22;723;40222
75;40;02;02;223;Peyre;233;8;241;40223
75;40;01;12;224;Peyrehorade;3648;180;3828;40224
75;40;02;02;225;Philondenx;200;6;206;40225
75;40;02;02;226;Pimbo;205;3;208;40226
75;40;02;07;227;Pissos;1449;20;1469;40227
75;40;01;04;228;Pomarez;1569;27;1596;40228
75;40;02;03;229;Pontenx-les-Forges;1648;32;1680;40229
75;40;01;13;230;Pontonx-sur-l'Adour;2868;97;2965;40230
75;40;01;12;231;Port-de-Lanne;1154;31;1185;40231
75;40;02;02;232;Poudenx;222;10;232;40232
75;40;01;12;233;Pouillon;3071;81;3152;40233
75;40;02;10;234;Pouydesseaux;906;28;934;40234
75;40;01;04;235;Poyanne;691;11;702;40235
75;40;01;04;236;Poyartin;782;20;802;40236
75;40;01;04;237;Préchacq-les-Bains;764;6;770;40237
75;40;02;01;238;Pujo-le-Plan;622;19;641;40238
75;40;02;02;239;Puyol-Cazalet;105;3;108;40239
75;40;02;01;240;Renung;517;19;536;40240
75;40;02;08;242;Rimbez-et-Baudiets;104;0;104;40242
75;40;01;13;243;Rion-des-Landes;3023;42;3065;40243
75;40;01;05;244;Rivière-Saas-et-Gourby;1257;29;1286;40244
75;40;02;08;245;Roquefort;1898;49;1947;40245
75;40;02;08;246;Sabres;1165;150;1315;40246
75;40;02;01;247;Saint-Agnet;179;6;185;40247
75;40;01;15;248;Saint-André-de-Seignanx;1889;28;1917;40248
75;40;01;04;249;Saint-Aubin;501;13;514;40249
75;40;02;10;250;Saint-Avit;694;22;716;40250
75;40;01;15;251;Saint-Barthélemy;419;14;433;40251
75;40;02;02;252;Sainte-Colombe;636;16;652;40252
75;40;02;02;253;Saint-Cricq-Chalosse;645;12;657;40253
75;40;01;12;254;Saint-Cricq-du-Gave;428;11;439;40254
75;40;02;01;255;Saint-Cricq-Villeneuve;474;11;485;40255
75;40;01;12;256;Saint-Etienne-d'Orthe;711;17;728;40256
75;40;02;07;257;Sainte-Eulalie-en-Born;1281;21;1302;40257
75;40;02;01;258;Sainte-Foy;252;3;255;40258
75;40;02;01;259;Saint-Gein;431;13;444;40259
75;40;01;04;260;Saint-Geours-d'Auribat;420;8;428;40260
75;40;01;09;261;Saint-Geours-de-Maremne;2752;49;2801;40261
75;40;02;08;262;Saint-Gor;312;6;318;40262
75;40;01;04;263;Saint-Jean-de-Lier;413;8;421;40263
75;40;01;14;264;Saint-Jean-de-Marsacq;1699;24;1723;40264
75;40;02;08;265;Saint-Julien-d'Armagnac;110;0;110;40265
75;40;01;03;266;Saint-Julien-en-Born;1683;34;1717;40266
75;40;02;08;267;Saint-Justin;1001;13;1014;40267
75;40;01;15;268;Saint-Laurent-de-Gosse;685;22;707;40268
75;40;01;12;269;Saint-Lon-les-Mines;1229;38;1267;40269
75;40;02;01;270;Saint-Loubouer;442;14;456;40270
75;40;01;14;271;Sainte-Marie-de-Gosse;1200;25;1225;40271
75;40;01;14;272;Saint-Martin-de-Hinx;1625;39;1664;40272
75;40;01;15;273;Saint-Martin-de-Seignanx;5776;131;5907;40273
75;40;02;10;274;Saint-Martin-d'Oney;1383;40;1423;40274
75;40;02;01;275;Saint-Maurice-sur-Adour;606;19;625;40275
75;40;01;03;276;Saint-Michel-Escalus;311;8;319;40276
75;40;01;06;277;Saint-Pandelon;711;49;760;40277
75;40;02;03;278;Saint-Paul-en-Born;970;16;986;40278
75;40;01;05;279;Saint-Paul-lès-Dax;13381;481;13862;40279
75;40;02;11;280;Saint-Perdon;1725;32;1757;40280
75;40;02;11;281;Saint-Pierre-du-Mont;9689;360;10049;40281
75;40;02;02;282;Saint-Sever;4890;96;4986;40282
75;40;01;05;283;Saint-Vincent-de-Paul;3307;225;3532;40283
75;40;01;14;284;Saint-Vincent-de-Tyrosse;7734;252;7986;40284
75;40;01;13;285;Saint-Yaguen;626;14;640;40285
75;40;02;02;286;Samadet;1132;22;1154;40286
75;40;02;07;287;Sanguinet;4431;66;4497;40287
75;40;02;08;288;Sarbazan;1158;22;1180;40288
75;40;02;02;289;Sarraziet;248;1;249;40289
75;40;02;01;290;Sarron;108;3;111;40290
75;40;01;14;291;Saubion;1734;32;1766;40291
75;40;01;14;292;Saubrigues;1495;72;1567;40292
75;40;01;09;293;Saubusse;1107;23;1130;40293
75;40;01;06;294;Saugnac-et-Cambran;1560;32;1592;40294
75;40;02;07;295;Saugnacq-et-Muret;1081;18;1099;40295
75;40;01;09;296;Seignosse;3876;95;3971;40296
75;40;02;08;297;Le Sen;232;3;235;40297
75;40;02;02;298;Serres-Gaston;397;14;411;40298
75;40;02;02;299;Serreslous-et-Arribans;192;11;203;40299
75;40;01;06;300;Seyresse;964;34;998;40300
75;40;01;05;301;Siest;139;2;141;40301
75;40;02;08;303;Solférino;328;2;330;40303
75;40;01;09;304;Soorts-Hossegor;3480;86;3566;40304
75;40;02;02;305;Sorbets;196;8;204;40305
75;40;01;12;306;Sorde-l'Abbaye;623;13;636;40306
75;40;02;08;307;Sore;1153;23;1176;40307
75;40;01;04;308;Sort-en-Chalosse;906;27;933;40308
75;40;01;13;309;Souprosse;1125;19;1144;40309
75;40;01;09;310;Soustons;8235;199;8434;40310
75;40;01;03;311;Taller;628;13;641;40311
75;40;01;15;312;Tarnos;12634;299;12933;40312
75;40;01;13;313;Tartas;3225;45;3270;40313
75;40;01;05;314;Tercis-les-Bains;1259;40;1299;40314
75;40;01;05;315;Téthieu;773;11;784;40315
75;40;01;12;316;Tilh;836;19;855;40316
75;40;01;09;317;Tosse;3219;79;3298;40317
75;40;01;04;318;Toulouzette;329;6;335;40318
75;40;02;08;319;Trensacq;242;4;246;40319
75;40;02;10;320;Uchacq-et-Parentis;598;20;618;40320
75;40;02;02;321;Urgons;246;9;255;40321
75;40;01;03;322;Uza;201;2;203;40322
75;40;02;08;323;Vert;254;5;259;40323
75;40;01;04;324;Vicq-d'Auribat;261;10;271;40324
75;40;02;01;325;Vielle-Tursan;271;12;283;40325
75;40;01;03;326;Vielle-Saint-Girons;1420;34;1454;40326
75;40;02;08;327;Vielle-Soubiran;224;5;229;40327
75;40;01;09;328;Vieux-Boucau-les-Bains;1614;22;1636;40328
75;40;02;01;329;Le Vignau;484;6;490;40329
75;40;01;13;330;Villenave;316;6;322;40330
75;40;02;01;331;Villeneuve-de-Marsan;2436;46;2482;40331
75;40;02;07;332;Ychoux;2304;55;2359;40332
75;40;02;13;333;Ygos-Saint-Saturnin;1337;26;1363;40333
75;40;01;06;334;Yzosse;381;13;394;40334
24;41;02;06;001;Ambloy;191;5;196;41001
24;41;03;11;002;Angé;818;23;841;41002
24;41;02;14;003;Areines;597;213;810;41003
24;41;02;06;004;Artins;265;5;270;41004
24;41;01;01;006;Autainville;446;8;454;41006
24;41;02;06;007;Authon;735;13;748;41007
24;41;01;01;008;Avaray;737;16;753;41008
24;41;01;08;009;Averdon;688;15;703;41009
24;41;02;14;010;Azé;1009;29;1038;41010
24;41;02;09;012;Baillou;209;12;221;41012
24;41;01;05;013;Bauzy;275;5;280;41013
24;41;02;09;014;Beauchêne;162;2;164;41014
24;41;03;12;016;Billy;1033;10;1043;41016
24;41;01;01;017;Binas;659;17;676;41017
24;41;01;99;018;Blois;45898;1520;47418;41018
24;41;01;01;019;Boisseau;95;2;97;41019
24;41;02;09;020;Bonneveau;459;6;465;41020
24;41;02;09;022;Bouffry;130;1;131;41022
24;41;02;09;024;Boursay;175;7;182;41024
24;41;01;05;025;Bracieux;1309;18;1327;41025
24;41;02;09;026;Brévainville;174;4;178;41026
24;41;01;01;027;Briou;145;2;147;41027
24;41;02;09;028;Busloup;468;9;477;41028
24;41;01;04;029;Candé-sur-Beuvron;1505;25;1530;41029
24;41;02;09;030;Cellé;228;3;231;41030
24;41;01;15;031;Cellettes;2652;70;2722;41031
24;41;01;04;032;Chailles;2674;79;2753;41032
24;41;01;05;034;Chambord;92;1;93;41034
24;41;01;08;035;Champigny-en-Beauce;618;15;633;41035
24;41;03;13;036;Chaon;453;7;460;41036
24;41;02;09;037;La Chapelle-Enchérie;208;4;212;41037
24;41;03;12;038;La Chapelle-Montmartin;419;11;430;41038
24;41;01;01;039;La Chapelle-Saint-Martin-en-Plaine;699;20;719;41039
24;41;01;08;040;La Chapelle-Vendômoise;799;27;826;41040
24;41;02;09;041;La Chapelle-Vicomtesse;162;3;165;41041
24;41;03;11;042;Châteauvieux;535;4;539;41042
24;41;03;11;043;Châtillon-sur-Cher;1691;32;1723;41043
24;41;03;12;044;Châtres-sur-Cher;1106;10;1116;41044
24;41;01;04;045;Chaumont-sur-Loire;1077;10;1087;41045
24;41;03;13;046;Chaumont-sur-Tharonne;1073;15;1088;41046
24;41;01;03;047;La Chaussée-Saint-Victor;4524;116;4640;41047
24;41;02;09;048;Chauvigny-du-Perche;226;4;230;41048
24;41;03;11;049;Chémery;942;13;955;41049
24;41;01;15;050;Cheverny;923;39;962;41050
24;41;03;07;051;Chissay-en-Touraine;1080;27;1107;41051
24;41;01;15;052;Chitenay;1101;34;1135;41052
24;41;02;09;053;Choue;533;5;538;41053
24;41;03;07;054;Choussy;337;5;342;41054
24;41;01;08;055;Valloire-sur-Cisse;2393;54;2447;41055
24;41;01;01;057;Conan;170;0;170;41057
24;41;01;01;058;Concriers;184;5;189;41058
24;41;03;89;059;Le Controis-en-Sologne;6723;157;6880;41059
24;41;02;09;060;Cormenon;689;12;701;41060
24;41;01;15;061;Cormeray;1550;26;1576;41061
24;41;03;07;062;Couddes;551;7;558;41062
24;41;03;11;063;Couffy;490;8;498;41063
24;41;02;06;065;Coulommiers-la-Tour;566;16;582;41065
24;41;01;01;066;Courbouzon;435;10;445;41066
24;41;01;15;067;Cour-Cheverny;2802;77;2879;41067
24;41;03;05;068;Courmemin;501;9;510;41068
24;41;01;01;069;Cour-sur-Loire;253;6;259;41069
24;41;02;06;070;Vallée-de-Ronsard;519;9;528;41070
24;41;01;05;071;Crouy-sur-Cosson;543;12;555;41071
24;41;02;06;072;Crucheray;398;17;415;41072
24;41;02;09;073;Danzé;681;17;698;41073
24;41;03;05;074;Dhuizon;1227;14;1241;41074
24;41;02;09;075;Droué;1009;8;1017;41075
24;41;01;01;077;Epiais;130;6;136;41077
24;41;02;09;078;Epuisay;824;17;841;41078
24;41;02;06;079;Les Essarts;103;0;103;41079
24;41;03;07;080;Faverolles-sur-Cher;1388;30;1418;41080
24;41;02;06;081;Faye;227;5;232;41081
24;41;03;05;083;La Ferté-Beauharnais;555;4;559;41083
24;41;03;13;084;La Ferté-Imbault;969;27;996;41084
24;41;01;05;085;La Ferté-Saint-Cyr;1055;14;1069;41085
24;41;01;05;086;Fontaines-en-Sologne;640;9;649;41086
24;41;02;09;087;Fontaine-les-Coteaux;330;5;335;41087
24;41;02;09;088;Fontaine-Raoul;234;6;240;41088
24;41;02;09;089;La Fontenelle;202;2;204;41089
24;41;02;09;090;Fortan;258;6;264;41090
24;41;01;08;091;Fossé;1309;19;1328;41091
24;41;01;08;093;Françay;271;9;280;41093
24;41;03;07;094;Fresnes;1145;37;1182;41094
24;41;02;09;095;Fréteval;1069;22;1091;41095
24;41;02;09;096;Le Gault-du-Perche;342;3;345;41096
24;41;03;12;097;Gièvres;2376;30;2406;41097
24;41;02;06;098;Gombergean;174;4;178;41098
24;41;03;12;099;Gy-en-Sologne;496;13;509;41099
24;41;02;06;100;Les Hayes;170;8;178;41100
24;41;01;08;101;Herbault;1181;36;1217;41101
24;41;02;06;102;Houssay;383;3;386;41102
24;41;02;06;103;Huisseau-en-Beauce;416;11;427;41103
24;41;01;05;104;Huisseau-sur-Cosson;2337;52;2389;41104
24;41;01;01;105;Josnes;862;19;881;41105
24;41;03;13;106;Lamotte-Beuvron;4667;61;4728;41106
24;41;02;06;107;Lancé;472;6;478;41107
24;41;01;08;108;Lancôme;123;3;126;41108
24;41;01;08;109;Landes-le-Gaulois;742;21;763;41109
24;41;03;12;110;Langon-sur-Cher;824;19;843;41110
24;41;03;12;112;Lassay-sur-Croisne;245;9;254;41112
24;41;02;06;113;Lavardin;179;8;187;41113
24;41;01;01;114;Lestiou;288;7;295;41114
24;41;02;09;115;Lignières;392;6;398;41115
24;41;02;09;116;Lisle;198;3;201;41116
24;41;03;10;118;Loreux;200;4;204;41118
24;41;01;01;119;Lorges;348;6;354;41119
24;41;02;06;120;Lunay;1253;35;1288;41120
24;41;01;01;121;La Madeleine-Villefrouin;31;0;31;41121
24;41;03;12;122;Maray;236;2;238;41122
24;41;01;01;123;Marchenoir;673;11;684;41123
24;41;02;06;124;Marcilly-en-Beauce;337;20;357;41124
24;41;03;13;125;Marcilly-en-Gault;725;15;740;41125
24;41;03;11;126;Mareuil-sur-Cher;1158;21;1179;41126
24;41;03;05;127;La Marolle-en-Sologne;336;6;342;41127
24;41;01;08;128;Marolles;715;17;732;41128
24;41;01;05;129;Maslives;716;13;729;41129
24;41;01;01;130;Maves;666;12;678;41130
24;41;02;14;131;Mazangé;833;28;861;41131
24;41;03;11;132;Méhers;322;6;328;41132
24;41;01;03;134;Menars;630;22;652;41134
24;41;03;12;135;Mennetou-sur-Cher;875;9;884;41135
24;41;01;01;136;Mer;6171;105;6276;41136
24;41;01;08;137;Mesland;571;24;595;41137
24;41;02;14;138;Meslay;312;9;321;41138
24;41;03;11;139;Meusnes;1091;11;1102;41139
24;41;03;10;140;Millançay;739;18;757;41140
24;41;02;09;141;Moisy;374;2;376;41141
24;41;01;08;142;Valencisse;2353;93;2446;41142
24;41;02;09;143;Mondoubleau;1313;53;1366;41143
24;41;01;08;144;Monteaux;735;23;758;41144
24;41;01;04;145;Monthou-sur-Bièvre;799;21;820;41145
24;41;03;07;146;Monthou-sur-Cher;959;15;974;41146
24;41;01;04;147;Les Montils;1920;43;1963;41147
24;41;01;05;148;Montlivault;1326;35;1361;41148
24;41;02;06;149;Montoire-sur-le-Loir;3721;196;3917;41149
24;41;01;05;150;Mont-près-Chambord;3311;90;3401;41150
24;41;03;07;151;Montrichard Val de Cher;3719;50;3769;41151
24;41;03;05;152;Montrieux-en-Sologne;637;13;650;41152
24;41;02;06;153;Montrouveau;153;3;156;41153
24;41;02;09;154;Morée;1083;27;1110;41154
24;41;01;01;155;Muides-sur-Loire;1235;30;1265;41155
24;41;01;01;156;Mulsans;527;14;541;41156
24;41;03;12;157;Mur-de-Sologne;1518;17;1535;41157
24;41;02;06;158;Naveil;2404;59;2463;41158
24;41;03;05;159;Neung-sur-Beuvron;1242;17;1259;41159
24;41;01;05;160;Neuvy;322;4;326;41160
24;41;03;13;161;Nouan-le-Fuzelier;2323;47;2370;41161
24;41;02;06;163;Nourray;117;2;119;41163
24;41;03;11;164;Noyers-sur-Cher;2721;32;2753;41164
24;41;03;07;166;Oisly;377;5;382;41166
24;41;01;08;167;Veuzain-sur-Loire;3452;102;3554;41167
24;41;03;12;168;Orçay;235;4;239;41168
24;41;01;01;171;Oucques La Nouvelle;1734;29;1763;41171
24;41;02;09;172;Ouzouer-le-Doyen;225;1;226;41172
24;41;01;01;173;Beauce la Romaine;3488;68;3556;41173
24;41;02;06;174;Périgny;178;7;185;41174
24;41;02;09;175;Pezou;1116;18;1134;41175
24;41;03;13;176;Pierrefitte-sur-Sauldre;754;18;772;41176
24;41;02;09;177;Le Plessis-Dorin;160;0;160;41177
24;41;01;01;178;Le Plessis-l'Echelle;63;2;65;41178
24;41;02;09;179;Le Poislay;186;1;187;41179
24;41;03;07;180;Pontlevoy;1523;176;1699;41180
24;41;03;11;181;Pouillé;800;21;821;41181
24;41;02;06;182;Pray;285;9;294;41182
24;41;02;06;184;Prunay-Cassereau;604;7;611;41184
24;41;03;12;185;Pruniers-en-Sologne;2319;55;2374;41185
24;41;02;09;186;Rahart;309;5;314;41186
24;41;02;09;187;Renay;175;4;179;41187
24;41;01;01;188;Rhodon;118;3;121;41188
24;41;01;04;189;Rilly-sur-Loire;476;6;482;41189
24;41;02;06;190;Rocé;216;7;223;41190
24;41;01;01;191;Roches;68;3;71;41191
24;41;02;06;192;Les Roches-l'Evêque;267;3;270;41192
24;41;02;09;193;Romilly;133;3;136;41193
24;41;03;10;194;Romorantin-Lanthenay;17924;471;18395;41194
24;41;03;11;195;Rougeou;152;2;154;41195
24;41;02;09;196;Ruan-sur-Egvonne;85;3;88;41196
24;41;03;11;198;Saint-Aignan;2852;90;2942;41198
24;41;02;06;199;Saint-Amand-Longpré;1204;28;1232;41199
24;41;02;14;200;Sainte-Anne;471;29;500;41200
24;41;02;06;201;Saint-Arnoult;322;3;325;41201
24;41;01;08;203;Saint-Bohaire;497;10;507;41203
24;41;01;05;204;Saint-Claude-de-Diray;1781;41;1822;41204
24;41;01;08;205;Saint-Cyr-du-Gault;175;2;177;41205
24;41;01;03;206;Saint-Denis-sur-Loire;863;26;889;41206
24;41;01;05;207;Saint-Dyé-sur-Loire;1133;20;1153;41207
24;41;01;08;208;Saint-Etienne-des-Guérets;115;4;119;41208
24;41;02;09;209;Saint-Firmin-des-Prés;814;41;855;41209
24;41;03;07;211;Saint-Georges-sur-Cher;2731;38;2769;41211
24;41;01;15;212;Saint-Gervais-la-Forêt;3174;96;3270;41212
24;41;02;06;213;Saint-Gourgon;104;5;109;41213
24;41;02;09;214;Saint-Hilaire-la-Gravelle;685;12;697;41214
24;41;02;06;215;Saint-Jacques-des-Guérets;96;2;98;41215
24;41;02;09;216;Saint-Jean-Froidmentel;560;8;568;41216
24;41;03;07;217;Saint-Julien-de-Chédon;753;15;768;41217
24;41;03;12;218;Saint-Julien-sur-Cher;764;12;776;41218
24;41;01;01;219;Saint-Laurent-des-Bois;310;3;313;41219
24;41;01;05;220;Saint-Laurent-Nouan;4337;85;4422;41220
24;41;01;01;221;Saint-Léonard-en-Beauce;646;17;663;41221
24;41;03;12;222;Saint-Loup;372;7;379;41222
24;41;01;08;223;Saint-Lubin-en-Vergonnois;760;10;770;41223
24;41;02;09;224;Saint-Marc-du-Cor;180;1;181;41224
24;41;02;06;225;Saint-Martin-des-Bois;568;11;579;41225
24;41;02;14;226;Saint-Ouen;3087;92;3179;41226
24;41;02;06;228;Saint-Rimay;292;3;295;41228
24;41;03;11;229;Saint-Romain-sur-Cher;1461;33;1494;41229
24;41;01;08;230;Saint-Sulpice-de-Pommeray;1840;55;1895;41230
24;41;03;13;231;Saint-Viâtre;1180;30;1210;41231
24;41;03;13;232;Salbris;4953;98;5051;41232
24;41;01;04;233;Sambin;900;15;915;41233
24;41;01;08;234;Santenay;288;9;297;41234
24;41;02;09;235;Sargé-sur-Braye;1026;22;1048;41235
24;41;02;06;236;Sasnières;97;3;100;41236
24;41;03;07;237;Sassay;1040;19;1059;41237
24;41;02;09;238;Savigny-sur-Braye;1976;28;2004;41238
24;41;03;11;239;Seigy;1017;23;1040;41239
24;41;03;13;241;Selles-Saint-Denis;1342;29;1371;41241
24;41;03;12;242;Selles-sur-Cher;4573;65;4638;41242
24;41;02;06;243;Selommes;814;13;827;41243
24;41;01;01;245;Séris;382;4;386;41245
24;41;01;04;246;Seur;482;18;500;41246
24;41;03;11;247;Soings-en-Sologne;1620;22;1642;41247
24;41;02;09;248;CouÃ«tron-au-Perche;1042;23;1065;41248
24;41;03;13;249;Souesmes;1047;14;1061;41249
24;41;02;09;250;Sougé;480;7;487;41250
24;41;03;13;251;Souvigny-en-Sologne;535;8;543;41251
24;41;01;01;252;Suèvres;1595;37;1632;41252
24;41;01;01;253;Talcy;260;5;265;41253
24;41;02;09;254;Le Temple;186;7;193;41254
24;41;02;06;255;Ternay;331;6;337;41255
24;41;03;12;256;Theillay;1246;19;1265;41256
24;41;03;11;258;Thésée;1157;23;1180;41258
24;41;02;06;259;Thoré-la-Rochette;843;33;876;41259
24;41;01;05;260;Thoury;418;6;424;41260
24;41;02;06;261;Tourailles;134;3;137;41261
24;41;01;05;262;Tour-en-Sologne;1115;16;1131;41262
24;41;02;06;265;Troo;285;10;295;41265
24;41;01;04;266;Valaire;84;3;87;41266
24;41;03;07;267;Vallières-les-Grandes;940;18;958;41267
24;41;03;10;268;Veilleins;161;4;165;41268
24;41;02;14;269;Vendôme;15856;642;16498;41269
24;41;03;10;271;Vernou-en-Sologne;631;6;637;41271
24;41;01;01;273;Vievy-le-Rayé;457;7;464;41273
24;41;02;06;274;Villavard;127;0;127;41274
24;41;02;09;275;La Ville-aux-Clercs;1257;23;1280;41275
24;41;01;03;276;Villebarou;2463;80;2543;41276
24;41;02;09;277;Villebout;125;0;125;41277
24;41;02;06;278;Villechauve;260;8;268;41278
24;41;02;06;279;Villedieu-le-Château;397;5;402;41279
24;41;03;12;280;Villefranche-sur-Cher;2657;66;2723;41280
24;41;01;08;281;VillefrancÅ“ur;422;9;431;41281
24;41;03;10;282;Villeherviers;442;9;451;41282
24;41;02;06;283;Villemardy;273;4;277;41283
24;41;01;01;284;Villeneuve-Frouville;63;2;65;41284
24;41;03;05;285;Villeny;484;4;488;41285
24;41;02;06;286;Villeporcher;150;5;155;41286
24;41;02;06;287;Villerable;507;12;519;41287
24;41;01;03;288;Villerbon;810;16;826;41288
24;41;01;01;289;Villermain;391;8;399;41289
24;41;02;06;290;Villeromain;236;0;236;41290
24;41;02;06;291;Villetrun;321;4;325;41291
24;41;01;01;292;Villexanton;201;1;202;41292
24;41;02;06;293;Villiersfaux;241;5;246;41293
24;41;02;14;294;Villiers-sur-Loir;1120;58;1178;41294
24;41;01;15;295;Vineuil;8091;212;8303;41295
24;41;03;13;296;Vouzon;1466;34;1500;41296
24;41;03;13;297;Yvoy-le-Marron;760;8;768;41297
84;42;01;20;001;AboÃ«n;452;7;459;42001
84;42;01;02;002;Ailleux;172;2;174;42002
84;42;02;09;003;Ambierle;1903;47;1950;42003
84;42;03;01;005;Andrézieux-Bouthéon;9963;150;10113;42005
84;42;01;20;006;Apinac;406;8;414;42006
84;42;02;03;007;Arcinges;215;5;220;42007
84;42;02;09;008;Arcon;109;1;110;42008
84;42;01;02;009;Arthun;528;5;533;42009
84;42;01;01;010;Aveizieux;1665;22;1687;42010
84;42;02;04;011;Balbigny;2840;56;2896;42011
84;42;01;07;012;Bard;674;23;697;42012
84;42;01;01;013;Bellegarde-en-Forez;1993;50;2043;42013
84;42;02;03;014;Belleroche;314;8;322;42014
84;42;02;03;015;Belmont-de-la-Loire;1477;26;1503;42015
84;42;02;03;016;La Bénisson-Dieu;424;10;434;42016
84;42;03;08;017;Le Bessat;455;6;461;42017
84;42;03;08;018;Bessey;460;11;471;42018
84;42;01;02;019;BoÃ«n-sur-Lignon;3120;72;3192;42019
84;42;01;01;020;Boisset-lès-Montrond;1170;21;1191;42020
84;42;01;07;021;Boisset-Saint-Priest;1252;10;1262;42021
84;42;01;20;022;Bonson;4093;58;4151;42022
84;42;03;08;023;Bourg-Argental;2937;56;2993;42023
84;42;02;03;025;Boyer;198;4;202;42025
84;42;02;03;026;Briennon;1719;39;1758;42026
84;42;02;02;027;Bully;403;7;410;42027
84;42;03;08;028;Burdignes;376;9;385;42028
84;42;02;04;029;Bussières;1520;48;1568;42029
84;42;01;02;030;Bussy-Albieux;536;3;539;42030
84;42;03;06;031;Caloire;306;7;313;42031
84;42;03;21;032;Cellieu;1704;24;1728;42032
84;42;02;03;033;Le Cergne;622;24;646;42033
84;42;01;02;034;Cervières;108;7;115;42034
84;42;01;02;035;Cezay;210;9;219;42035
84;42;03;21;036;Chagnon;496;17;513;42036
84;42;01;07;037;Chalain-d'Uzore;592;23;615;42037
84;42;01;07;038;Chalain-le-Comtal;709;14;723;42038
84;42;01;02;039;Chalmazel-Jeansagnière;454;5;459;42039
84;42;01;02;040;La Chamba;47;2;49;42040
84;42;01;05;041;Chambéon;618;5;623;42041
84;42;01;20;042;Chambles;1036;20;1056;42042
84;42;01;01;043;ChambÅ“uf;1791;37;1828;42043
84;42;03;15;044;Le Chambon-Feugerolles;11948;80;12028;42044
84;42;01;02;045;La Chambonie;39;1;40;42045
84;42;01;02;046;Champdieu;1935;44;1979;42046
84;42;02;09;047;Champoly;327;2;329;42047
84;42;02;03;048;Chandon;1479;30;1509;42048
84;42;02;09;049;Changy;654;21;675;42049
84;42;01;07;050;La Chapelle-en-Lafaye;130;3;133;42050
84;42;03;08;051;La Chapelle-Villars;532;14;546;42051
84;42;02;03;052;Charlieu;3695;94;3789;42052
84;42;03;10;053;Châteauneuf;1630;21;1651;42053
84;42;01;02;054;Châtelneuf;346;8;354;42054
84;42;01;05;055;Châtelus;140;8;148;42055
84;42;03;08;056;Chavanay;2897;50;2947;42056
84;42;01;07;058;Chazelles-sur-Lavieu;258;6;264;42058
84;42;01;05;059;Chazelles-sur-Lyon;5423;99;5522;42059
84;42;01;07;060;Chenereilles;527;6;533;42060
84;42;02;09;061;Cherier;569;15;584;42061
84;42;01;05;062;Chevrières;1164;25;1189;42062
84;42;02;04;063;Chirassimont;399;9;408;42063
84;42;03;08;064;Chuyer;761;30;791;42064
84;42;01;05;065;Civens;1411;54;1465;42065
84;42;01;05;066;Cleppé;512;12;524;42066
84;42;03;08;067;Colombier;298;3;301;42067
84;42;02;03;068;Combre;426;11;437;42068
84;42;02;04;069;Commelle-Vernay;3005;93;3098;42069
84;42;02;04;070;Cordelle;916;21;937;42070
84;42;02;04;071;Le Coteau;6880;179;7059;42071
84;42;01;02;072;La Côte-en-Couzan;65;1;66;42072
84;42;01;05;073;Cottance;734;18;752;42073
84;42;02;03;074;Coutouvre;1082;26;1108;42074
84;42;01;01;075;Craintilleux;1363;14;1377;42075
84;42;02;09;076;Cremeaux;907;22;929;42076
84;42;02;04;077;Croizet-sur-Gand;307;6;313;42077
84;42;02;09;078;Le Crozet;257;11;268;42078
84;42;02;03;079;Cuinzier;711;12;723;42079
84;42;01;01;081;Cuzieu;1544;20;1564;42081
84;42;03;10;083;Dargoire;532;4;536;42083
84;42;01;02;084;Débats-Rivière-d'Orpra;159;4;163;42084
84;42;03;08;085;Doizieux;835;18;853;42085
84;42;02;03;086;Ecoche;523;13;536;42086
84;42;01;07;087;Ecotay-l'Olme;1224;53;1277;42087
84;42;01;05;088;Epercieux-Saint-Paul;748;17;765;42088
84;42;01;02;089;Essertines-en-Châtelneuf;666;29;695;42089
84;42;01;05;090;Essertines-en-Donzy;495;12;507;42090
84;42;01;20;091;Estivareilles;683;15;698;42091
84;42;03;21;092;L'Etrat;2643;105;2748;42092
84;42;03;10;093;Farnay;1379;20;1399;42093
84;42;01;05;094;Feurs;8302;146;8448;42094
84;42;03;06;095;Firminy;16901;188;17089;42095
84;42;03;21;096;Fontanès;681;11;692;42096
84;42;03;21;097;La Fouillouse;4666;64;4730;42097
84;42;02;04;098;Fourneaux;582;14;596;42098
84;42;03;06;099;Fraisses;3733;53;3786;42099
84;42;01;05;100;La Gimond;278;11;289;42100
84;42;03;08;101;Graix;143;1;144;42101
84;42;01;05;102;Grammond;890;22;912;42102
84;42;03;10;103;La Grand-Croix;5172;41;5213;42103
84;42;02;03;104;La Gresle;861;20;881;42104
84;42;01;07;105;Grézieux-le-Fromental;254;2;256;42105
84;42;02;02;106;Grézolles;251;8;259;42106
84;42;01;07;107;Gumières;320;9;329;42107
84;42;01;07;108;L'Hôpital-le-Grand;1106;13;1119;42108
84;42;01;02;109;L'Hôpital-sous-Rochefort;109;1;110;42109
84;42;03;13;110;L'Horme;4746;42;4788;42110
84;42;02;03;112;Jarnosse;419;8;427;42112
84;42;01;05;113;Jas;233;6;239;42113
84;42;03;08;115;Jonzieux;1224;15;1239;42115
84;42;02;09;116;Juré;247;7;254;42116
84;42;01;07;117;Lavieu;115;8;123;42117
84;42;02;04;118;Lay;749;20;769;42118
84;42;01;02;119;Leigneux;366;11;377;42119
84;42;02;09;120;Lentigny;1777;40;1817;42120
84;42;01;07;121;Lérigneux;156;2;158;42121
84;42;01;07;122;Lézigneux;1715;79;1794;42122
84;42;03;10;123;Lorette;4716;31;4747;42123
84;42;03;08;124;Lupé;296;7;303;42124
84;42;02;02;125;Luré;141;2;143;42125
84;42;01;07;126;Luriecq;1284;30;1314;42126
84;42;02;11;127;Mably;7653;118;7771;42127
84;42;02;04;128;Machézal;391;8;399;42128
84;42;03;08;129;Maclas;1819;68;1887;42129
84;42;01;07;130;Magneux-Haute-Rive;569;10;579;42130
84;42;02;03;131;Maizilly;332;9;341;42131
84;42;03;08;132;Malleval;566;16;582;42132
84;42;03;21;133;Marcenod;695;19;714;42133
84;42;01;02;134;Marcilly-le-Châtel;1391;47;1438;42134
84;42;01;05;135;Marclopt;530;27;557;42135
84;42;01;02;136;Marcoux;765;32;797;42136
84;42;01;07;137;Margerie-Chantagret;797;15;812;42137
84;42;01;05;138;Maringes;668;12;680;42138
84;42;03;08;139;Marlhes;1329;66;1395;42139
84;42;01;07;140;Marols;443;8;451;42140
84;42;02;03;141;Mars;570;11;581;42141
84;42;01;20;142;Merle-Leignec;320;4;324;42142
84;42;01;05;143;Mizérieux;490;5;495;42143
84;42;02;03;145;Montagny;1083;19;1102;42145
84;42;01;07;146;Montarcher;66;3;69;42146
84;42;01;07;147;Montbrison;15915;623;16538;42147
84;42;01;05;148;Montchal;504;9;513;42148
84;42;01;01;149;Montrond-les-Bains;5342;79;5421;42149
84;42;01;02;150;Montverdun;1393;30;1423;42150
84;42;01;07;151;Mornand-en-Forez;413;80;493;42151
84;42;02;03;152;Nandax;546;315;861;42152
84;42;02;04;153;Neaux;481;12;493;42153
84;42;02;04;154;Néronde;460;51;511;42154
84;42;01;05;155;Nervieux;1007;23;1030;42155
84;42;02;04;156;Neulise;1372;18;1390;42156
84;42;02;09;157;Noailly;794;14;808;42157
84;42;02;09;158;Les NoÃ«s;210;3;213;42158
84;42;01;02;159;Noirétable;1571;106;1677;42159
84;42;02;02;160;Nollieux;190;6;196;42160
84;42;02;04;161;Notre-Dame-de-Boisset;573;19;592;42161
84;42;02;09;162;Ouches;1154;19;1173;42162
84;42;02;09;163;La Pacaudière;1057;20;1077;42163
84;42;01;02;164;Palogneux;71;0;71;42164
84;42;01;05;165;Panissières;2892;86;2978;42165
84;42;02;04;166;Parigny;624;16;640;42166
84;42;03;08;167;Pavezin;376;10;386;42167
84;42;03;08;168;Pélussin;3738;100;3838;42168
84;42;01;20;169;Périgneux;1580;27;1607;42169
84;42;02;04;170;Perreux;2110;180;2290;42170
84;42;02;04;171;Pinay;288;7;295;42171
84;42;03;08;172;Planfoy;1059;24;1083;42172
84;42;02;02;173;Pommiers-en-Forez;359;10;369;42173
84;42;01;05;174;Poncins;1150;25;1175;42174
84;42;01;05;175;Pouilly-lès-Feurs;1202;35;1237;42175
84;42;02;09;176;Pouilly-les-Nonains;2172;46;2218;42176
84;42;02;03;177;Pouilly-sous-Charlieu;2532;53;2585;42177
84;42;02;03;178;Pradines;833;10;843;42178
84;42;01;02;179;Pralong;858;28;886;42179
84;42;01;07;180;Précieux;1035;99;1134;42180
84;42;02;03;181;Régny;1512;30;1542;42181
84;42;02;09;182;Renaison;3198;106;3304;42182
84;42;03;15;183;La Ricamarie;7872;48;7920;42183
84;42;02;12;184;Riorges;10848;280;11128;42184
84;42;01;01;185;Rivas;698;20;718;42185
84;42;03;10;186;Rive-de-Gier;14978;121;15099;42186
84;42;02;98;187;Roanne;33809;738;34547;42187
84;42;01;07;188;Roche;254;4;258;42188
84;42;03;16;189;Roche-la-Molière;9884;92;9976;42189
84;42;03;08;191;Roisey;980;33;1013;42191
84;42;01;20;192;Rozier-Côtes-d'Aurec;433;7;440;42192
84;42;01;05;193;Rozier-en-Donzy;1427;39;1466;42193
84;42;02;09;194;Sail-les-Bains;201;2;203;42194
84;42;01;02;195;Sail-sous-Couzan;972;23;995;42195
84;42;02;04;196;Sainte-Agathe-en-Donzy;120;4;124;42196
84;42;01;02;197;Sainte-Agathe-la-Bouteresse;1045;32;1077;42197
84;42;02;09;198;Saint-Alban-les-Eaux;934;23;957;42198
84;42;02;09;199;Saint-André-d'Apchon;1927;63;1990;42199
84;42;01;01;200;Saint-André-le-Puy;1527;26;1553;42200
84;42;03;08;201;Saint-Appolinard;689;31;720;42201
84;42;01;05;202;Saint-Barthélemy-Lestra;688;15;703;42202
84;42;02;09;203;Saint-Bonnet-des-Quarts;301;12;313;42203
84;42;01;20;204;Saint-Bonnet-le-Château;1510;47;1557;42204
84;42;01;02;205;Saint-Bonnet-le-Courreau;688;15;703;42205
84;42;01;01;206;Saint-Bonnet-les-Oules;1669;41;1710;42206
84;42;03;13;207;Saint-Chamond;34841;412;35253;42207
84;42;03;21;208;Saint-Christo-en-Jarez;1903;42;1945;42208
84;42;02;04;209;Sainte-Colombe-sur-Gand;396;11;407;42209
84;42;03;08;210;Sainte-Croix-en-Jarez;477;7;484;42210
84;42;01;20;211;Saint-Cyprien;2447;35;2482;42211
84;42;02;04;212;Saint-Cyr-de-Favières;961;28;989;42212
84;42;02;04;213;Saint-Cyr-de-Valorges;311;12;323;42213
84;42;01;05;214;Saint-Cyr-les-Vignes;1041;29;1070;42214
84;42;02;03;215;Saint-Denis-de-Cabanne;1260;25;1285;42215
84;42;01;05;216;Saint-Denis-sur-Coise;673;19;692;42216
84;42;01;02;217;Saint-Didier-sur-Rochefort;421;7;428;42217
84;42;03;99;218;Saint-Etienne;173821;1971;175792;42218
84;42;01;02;219;Saint-Etienne-le-Molard;1025;26;1051;42219
84;42;02;09;220;Saint-Forgeux-Lespinasse;621;19;640;42220
84;42;01;02;221;Sainte-Foy-Saint-Sulpice;514;15;529;42221
84;42;01;01;222;Saint-Galmier;5826;146;5972;42222
84;42;03;16;223;Saint-Genest-Lerpt;6123;70;6193;42223
84;42;03;08;224;Saint-Genest-Malifaux;2918;144;3062;42224
84;42;03;10;225;Genilac;3894;76;3970;42225
84;42;02;02;226;Saint-Georges-de-Baroille;431;3;434;42226
84;42;01;02;227;Saint-Georges-en-Couzan;412;10;422;42227
84;42;01;07;228;Saint-Georges-Haute-Ville;1467;26;1493;42228
84;42;02;03;229;Saint-Germain-la-Montagne;230;6;236;42229
84;42;02;02;230;Saint-Germain-Laval;1608;31;1639;42230
84;42;02;09;231;Saint-Germain-Lespinasse;1238;75;1313;42231
84;42;02;09;232;Saint-Haon-le-Châtel;637;11;648;42232
84;42;02;09;233;Saint-Haon-le-Vieux;954;24;978;42233
84;42;03;21;234;Saint-Héand;3637;55;3692;42234
84;42;01;20;235;Saint-Hilaire-Cusson-la-Valmitte;337;5;342;42235
84;42;02;03;236;Saint-Hilaire-sous-Charlieu;529;10;539;42236
84;42;03;18;237;Saint-Jean-Bonnefonds;6615;69;6684;42237
84;42;01;02;238;Saint-Jean-la-Vêtre;320;11;331;42238
84;42;02;09;239;Saint-Jean-Saint-Maurice-sur-Loire;1153;24;1177;42239
84;42;01;07;240;Saint-Jean-Soleymieux;859;19;878;42240
84;42;02;04;241;Saint-Jodard;390;5;395;42241
84;42;03;10;242;Saint-Joseph;1928;29;1957;42242
84;42;02;02;243;Saint-Julien-d'Oddes;283;5;288;42243
84;42;01;02;245;Vêtre-sur-Anzon;585;6;591;42245
84;42;03;08;246;Saint-Julien-Molin-Molette;1143;18;1161;42246
84;42;01;02;247;Saint-Just-en-Bas;282;8;290;42247
84;42;02;09;248;Saint-Just-en-Chevalet;1130;38;1168;42248
84;42;02;04;249;Saint-Just-la-Pendue;1656;35;1691;42249
84;42;01;05;251;Saint-Laurent-la-Conche;581;13;594;42251
84;42;01;02;252;Saint-Laurent-Rochefort;252;2;254;42252
84;42;02;12;253;Saint-Léger-sur-Roanne;1157;40;1197;42253
84;42;02;04;254;Saint-Marcel-de-Félines;799;17;816;42254
84;42;02;09;255;Saint-Marcel-d'Urfé;283;7;290;42255
84;42;01;20;256;Saint-Marcellin-en-Forez;5001;50;5051;42256
84;42;02;09;257;Saint-Martin-d'Estréaux;836;16;852;42257
84;42;03;10;259;Saint-Martin-la-Plaine;3815;75;3890;42259
84;42;02;02;260;Saint-Martin-la-Sauveté;890;59;949;42260
84;42;01;05;261;Saint-Martin-Lestra;906;20;926;42261
84;42;01;20;262;Saint-Maurice-en-Gourgois;1817;21;1838;42262
84;42;01;05;264;Saint-Médard-en-Forez;980;24;1004;42264
84;42;03;08;265;Saint-Michel-sur-Rhône;856;25;881;42265
84;42;01;20;266;Saint-Nizier-de-Fornas;663;13;676;42266
84;42;02;03;267;Saint-Nizier-sous-Charlieu;1696;47;1743;42267
84;42;02;02;268;Vézelin-sur-Loire;796;9;805;42268
84;42;01;07;269;Saint-Paul-d'Uzore;174;10;184;42269
84;42;03;06;270;Saint-Paul-en-Cornillon;1357;31;1388;42270
84;42;03;10;271;Saint-Paul-en-Jarez;4817;59;4876;42271
84;42;03;08;272;Saint-Pierre-de-BÅ“uf;1704;38;1742;42272
84;42;02;03;273;Saint-Pierre-la-Noaille;381;8;389;42273
84;42;02;02;274;Saint-Polgues;257;8;265;42274
84;42;03;18;275;Saint-Priest-en-Jarez;6106;95;6201;42275
84;42;02;09;276;Saint-Priest-la-Prugne;430;6;436;42276
84;42;02;04;277;Saint-Priest-la-Roche;341;1;342;42277
84;42;01;02;278;Saint-Priest-la-Vêtre;144;1;145;42278
84;42;01;20;279;Saint-Just-Saint-Rambert;15229;280;15509;42279
84;42;03;08;280;Saint-Régis-du-Coin;402;11;413;42280
84;42;02;09;281;Saint-Rirand;134;2;136;42281
84;42;02;09;282;Saint-Romain-d'Urfé;239;5;244;42282
84;42;03;21;283;Saint-Romain-en-Jarez;1218;28;1246;42283
84;42;02;09;284;Saint-Romain-la-Motte;1417;59;1476;42284
84;42;01;07;285;Saint-Romain-le-Puy;4090;64;4154;42285
84;42;03;08;286;Saint-Romain-les-Atheux;949;15;964;42286
84;42;03;08;287;Saint-Sauveur-en-Rue;1088;21;1109;42287
84;42;01;02;288;Saint-Sixte;706;12;718;42288
84;42;02;04;289;Saint-Symphorien-de-Lay;1899;36;1935;42289
84;42;01;07;290;Saint-Thomas-la-Garde;588;22;610;42290
84;42;02;03;293;Saint-Victor-sur-Rhins;1191;20;1211;42293
84;42;02;04;294;Saint-Vincent-de-Boisset;974;28;1002;42294
84;42;01;02;295;Les Salles;556;7;563;42295
84;42;01;05;296;Salt-en-Donzy;547;16;563;42296
84;42;01;05;297;Salvizinet;595;30;625;42297
84;42;01;02;298;Sauvain;377;5;382;42298
84;42;01;07;299;Savigneux;3430;74;3504;42299
84;42;02;03;300;Sevelinges;643;13;656;42300
84;42;01;07;301;Soleymieux;689;8;697;42301
84;42;03;21;302;Sorbiers;7874;167;8041;42302
84;42;02;02;303;Souternon;276;6;282;42303
84;42;01;20;304;Sury-le-Comtal;6653;270;6923;42304
84;42;03;21;305;La Talaudière;6977;99;7076;42305
84;42;03;08;306;Tarentaise;483;6;489;42306
84;42;03;10;307;Tartaras;902;32;934;42307
84;42;03;08;308;La Terrasse-sur-Dorlay;776;8;784;42308
84;42;03;08;310;Thélis-la-Combe;149;2;151;42310
84;42;03;21;311;La Tour-en-Jarez;1471;37;1508;42311
84;42;01;20;312;La Tourette;606;17;623;42312
84;42;01;02;313;Trelins;665;8;673;42313
84;42;02;09;314;La Tuilière;291;8;299;42314
84;42;01;01;315;Unias;423;14;437;42315
84;42;03;06;316;Unieux;8418;80;8498;42316
84;42;02;09;317;Urbise;124;6;130;42317
84;42;01;20;318;Usson-en-Forez;1487;23;1510;42318
84;42;01;05;319;Valeille;705;11;716;42319
84;42;03;21;320;Valfleury;707;10;717;42320
84;42;01;02;321;La Valla-sur-Rochefort;102;1;103;42321
84;42;03;08;322;La Valla-en-Gier;1075;26;1101;42322
84;42;01;01;323;Veauche;8973;105;9078;42323
84;42;01;01;324;Veauchette;1192;17;1209;42324
84;42;02;04;325;Vendranges;376;5;381;42325
84;42;03;08;326;Véranne;877;28;905;42326
84;42;03;08;327;Vérin;664;14;678;42327
84;42;01;07;328;Verrières-en-Forez;712;75;787;42328
84;42;03;08;329;La Versanne;377;5;382;42329
84;42;03;17;330;Villars;7942;159;8101;42330
84;42;02;09;331;Villemontais;1022;31;1053;42331
84;42;02;12;332;Villerest;5030;142;5172;42332
84;42;02;03;333;Villers;589;13;602;42333
84;42;02;04;334;Violay;1250;17;1267;42334
84;42;01;05;335;Viricelles;442;20;462;42335
84;42;01;05;336;Virigneux;637;20;657;42336
84;42;02;09;337;Vivans;224;5;229;42337
84;42;02;03;338;Vougy;1488;61;1549;42338
84;42;02;09;339;Chausseterre;218;5;223;42339
84;43;01;17;001;Agnat;178;4;182;43001
84;43;02;13;002;Aiguilhe;1473;63;1536;43002
84;43;02;11;003;Allègre;874;18;892;43003
84;43;02;08;004;Alleyrac;119;7;126;43004
84;43;02;18;005;Alleyras;156;3;159;43005
84;43;01;10;006;Ally;129;2;131;43006
84;43;03;19;007;Araules;602;17;619;43007
84;43;02;18;008;Arlempdes;143;6;149;43008
84;43;01;10;009;Arlet;23;0;23;43009
84;43;02;15;010;Arsac-en-Velay;1193;29;1222;43010
84;43;01;10;011;Aubazat;178;5;183;43011
84;43;03;01;012;Aurec-sur-Loire;6142;83;6225;43012
84;43;01;10;013;Vissac-Auteyrac;306;10;316;43013
84;43;01;17;014;Autrac;56;2;58;43014
84;43;01;07;015;Auvers;50;0;50;43015
84;43;01;17;016;Auzon;898;22;920;43016
84;43;01;17;017;Azérat;282;5;287;43017
84;43;02;18;018;Bains;1376;126;1502;43018
84;43;02;18;019;Barges;108;2;110;43019
84;43;03;02;020;Bas-en-Basset;4377;86;4463;43020
84;43;02;06;021;Beaulieu;1040;20;1060;43021
84;43;01;04;022;Beaumont;276;12;288;43022
84;43;02;11;023;Beaune-sur-Arzon;210;2;212;43023
84;43;03;19;024;Beaux;851;13;864;43024
84;43;03;02;025;Beauzac;2969;67;3036;43025
84;43;02;16;026;Bellevue-la-Montagne;445;12;457;43026
84;43;01;11;027;Berbezit;45;0;45;43027
84;43;03;19;028;Bessamorel;472;15;487;43028
84;43;01;07;029;La Besseyre-Saint-Mary;97;1;98;43029
84;43;02;16;030;Blanzac;401;10;411;43030
84;43;01;10;031;Blassac;135;5;140;43031
84;43;02;14;032;Blavozy;1687;51;1738;43032
84;43;01;17;033;Blesle;636;8;644;43033
84;43;03;02;034;Boisset;355;1;356;43034
84;43;01;11;035;Bonneval;68;3;71;43035
84;43;02;16;036;Borne;409;6;415;43036
84;43;02;18;037;Le Bouchet-Saint-Nicolas;280;7;287;43037
84;43;01;04;038;Bournoncle-Saint-Pierre;998;27;1025;43038
84;43;02;18;039;Le Brignon;609;13;622;43039
84;43;01;04;040;Brioude;6609;325;6934;43040
84;43;02;14;041;Brives-Charensac;4185;224;4409;43041
84;43;02;18;042;Cayres;710;17;727;43042
84;43;02;16;043;Céaux-d'Allègre;470;8;478;43043
84;43;01;10;044;Cerzat;209;4;213;43044
84;43;02;12;045;Ceyssac;426;13;439;43045
84;43;02;13;046;Chadrac;2464;68;2532;43046
84;43;02;08;047;Chadron;332;8;340;43047
84;43;01;11;048;La Chaise-Dieu;616;36;652;43048
84;43;02;06;049;Chamalières-sur-Loire;487;9;496;43049
84;43;01;17;050;Chambezon;124;0;124;43050
84;43;03;08;051;Le Chambon-sur-Lignon;2431;40;2471;43051
84;43;01;17;052;Champagnac-le-Vieux;193;2;195;43052
84;43;02;08;053;Champclause;205;4;209;43053
84;43;01;07;054;Chanaleilles;176;9;185;43054
84;43;01;04;055;Chaniat;165;4;169;43055
84;43;01;07;056;Chanteuges;428;13;441;43056
84;43;02;11;057;La Chapelle-Bertin;46;2;48;43057
84;43;03;09;058;La Chapelle-d'Aurec;1054;29;1083;43058
84;43;01;11;059;La Chapelle-Geneste;109;1;110;43059
84;43;01;07;060;Charraix;69;4;73;43060
84;43;02;13;061;Chaspinhac;868;23;891;43061
84;43;02;16;062;Chaspuzac;806;15;821;43062
84;43;01;10;063;Chassagnes;156;2;158;43063
84;43;01;17;064;Chassignolles;64;4;68;43064
84;43;01;10;065;Chastel;123;4;127;43065
84;43;02;08;066;Chaudeyrolles;118;4;122;43066
84;43;01;10;067;Chavaniac-Lafayette;268;6;274;43067
84;43;01;07;068;Chazelles;33;2;35;43068
84;43;03;03;069;Chenereilles;319;7;326;43069
84;43;01;10;070;Chilhac;171;2;173;43070
84;43;02;11;071;Chomelix;472;6;478;43071
84;43;01;10;072;La Chomette;153;5;158;43072
84;43;01;11;073;Cistrières;134;3;137;43073
84;43;01;04;074;Cohade;884;25;909;43074
84;43;01;10;075;Collat;73;3;76;43075
84;43;01;11;076;Connangles;137;1;138;43076
84;43;02;18;077;Costaros;538;16;554;43077
84;43;02;15;078;Coubon;3258;89;3347;43078
84;43;01;10;079;Couteuges;301;11;312;43079
84;43;02;11;080;Craponne-sur-Arzon;1951;41;1992;43080
84;43;01;10;082;Cronce;71;2;73;43082
84;43;01;07;083;Cubelles;150;4;154;43083
84;43;02;18;084;Cussac-sur-Loire;1678;35;1713;43084
84;43;01;07;085;Desges;56;5;61;43085
84;43;01;10;086;Domeyrat;179;9;188;43086
84;43;03;03;087;Dunières;2668;65;2733;43087
84;43;01;17;088;Espalem;322;9;331;43088
84;43;02;12;089;Espaly-Saint-Marcel;3497;170;3667;43089
84;43;01;07;090;Esplantas-Vazeilles;127;4;131;43090
84;43;02;08;091;Les Estables;324;14;338;43091
84;43;02;08;092;Fay-sur-Lignon;355;7;362;43092
84;43;01;11;093;Félines;325;7;332;43093
84;43;01;10;094;Ferrussac;82;2;84;43094
84;43;02;16;095;Fix-Saint-Geneys;134;4;138;43095
84;43;01;04;096;Fontannes;902;228;1130;43096
84;43;02;08;097;Freycenet-la-Cuche;105;1;106;43097
84;43;02;08;098;Freycenet-la-Tour;109;5;114;43098
84;43;01;17;099;Frugerès-les-Mines;552;6;558;43099
84;43;01;10;100;Frugières-le-Pin;174;2;176;43100
84;43;02;08;101;Goudet;57;6;63;43101
84;43;03;19;102;Grazac;1103;17;1120;43102
84;43;01;17;103;Grenier-Montgon;113;2;115;43103
84;43;01;07;104;Grèzes;197;6;203;43104
84;43;01;10;105;Javaugues;178;7;185;43105
84;43;01;10;106;Jax;145;3;148;43106
84;43;01;10;107;Josat;86;0;86;43107
84;43;02;11;108;Jullianges;439;10;449;43108
84;43;02;18;109;Lafarre;77;3;80;43109
84;43;01;04;110;Lamothe;844;14;858;43110
84;43;02;18;111;Landos;878;22;900;43111
84;43;01;07;112;Langeac;3489;77;3566;43112
84;43;02;08;113;Lantriac;1923;54;1977;43113
84;43;03;19;114;Lapte;1729;38;1767;43114
84;43;02;08;115;Laussonne;1009;18;1027;43115
84;43;01;11;116;Laval-sur-Doulon;63;3;66;43116
84;43;01;04;117;Lavaudieu;247;7;254;43117
84;43;01;10;118;Lavoûte-Chilhac;272;4;276;43118
84;43;02;06;119;Lavoûte-sur-Loire;832;17;849;43119
84;43;01;17;120;Lempdes-sur-Allagnon;1325;26;1351;43120
84;43;01;17;121;Léotoing;216;5;221;43121
84;43;02;16;122;Lissac;289;5;294;43122
84;43;01;17;123;Lorlanges;393;16;409;43123
84;43;02;16;124;Loudes;931;18;949;43124
84;43;01;10;125;Lubilhac;81;1;82;43125
84;43;02;06;126;Malrevers;761;15;776;43126
84;43;03;02;127;Malvalette;846;15;861;43127
84;43;01;11;128;Malvières;134;2;136;43128
84;43;03;03;129;Le Mas-de-Tence;156;7;163;43129
84;43;03;08;130;Mazet-Saint-Voy;1110;29;1139;43130
84;43;01;10;131;Mazerat-Aurouze;196;2;198;43131
84;43;01;10;132;Mazeyrat-d'Allier;1445;42;1487;43132
84;43;01;10;133;MercÅ“ur;139;1;140;43133
84;43;02;06;134;Mézères;150;4;154;43134
84;43;02;08;135;Le Monastier-sur-Gazeille;1768;31;1799;43135
84;43;01;07;136;Monistrol-d'Allier;211;1;212;43136
84;43;03;09;137;Monistrol-sur-Loire;8875;425;9300;43137
84;43;02;11;138;Monlet;412;12;424;43138
84;43;01;10;139;Montclard;54;0;54;43139
84;43;02;13;140;Le Monteil;685;24;709;43140
84;43;03;03;141;Montfaucon-en-Velay;1149;24;1173;43141
84;43;03;03;142;Montregard;586;10;596;43142
84;43;02;08;143;Montusclat;128;0;128;43143
84;43;02;08;144;Moudeyres;98;3;101;43144
84;43;02;18;145;Ouides;57;0;57;43145
84;43;01;04;147;Paulhac;638;21;659;43147
84;43;01;10;148;Paulhaguet;868;18;886;43148
84;43;01;07;149;Pébrac;116;4;120;43149
84;43;02;06;150;Le Pertuis;468;13;481;43150
84;43;01;07;151;Pinols;190;5;195;43151
84;43;02;13;152;Polignac;2810;84;2894;43152
84;43;03;01;153;Pont-Salomon;1902;30;1932;43153
84;43;02;18;154;Pradelles;546;16;562;43154
84;43;01;07;155;Prades;62;1;63;43155
84;43;02;08;156;Présailles;115;6;121;43156
84;43;02;99;157;Le Puy-en-Velay;19215;881;20096;43157
84;43;02;06;158;Queyrières;333;12;345;43158
84;43;03;03;159;Raucoules;940;24;964;43159
84;43;02;18;160;Rauret;194;3;197;43160
84;43;03;02;162;Retournac;2990;58;3048;43162
84;43;03;03;163;Riotord;1179;18;1197;43163
84;43;02;11;164;Roche-en-Régnier;486;2;488;43164
84;43;02;06;165;Rosières;1531;30;1561;43165
84;43;03;02;166;Saint-André-de-Chalencon;375;16;391;43166
84;43;01;07;167;Saint-Arcons-d'Allier;191;4;195;43167
84;43;02;18;168;Saint-Arcons-de-Barges;116;1;117;43168
84;43;01;10;169;Saint-Austremoine;50;0;50;43169
84;43;01;10;170;Saint-Beauzire;450;6;456;43170
84;43;01;07;171;Saint-Bérain;85;3;88;43171
84;43;03;03;172;Saint-Bonnet-le-Froid;213;2;215;43172
84;43;01;07;173;Saint-Christophe-d'Allier;92;2;94;43173
84;43;02;18;174;Saint-Christophe-sur-Dolaison;953;13;966;43174
84;43;01;10;175;Saint-Cirgues;164;6;170;43175
84;43;03;05;177;Saint-Didier-en-Velay;3451;52;3503;43177
84;43;01;10;178;Saint-Didier-sur-Doulon;194;8;202;43178
84;43;02;18;180;Saint-Etienne-du-Vigan;98;5;103;43180
84;43;02;06;181;Saint-Etienne-Lardeyrol;758;20;778;43181
84;43;01;17;182;Saint-Etienne-sur-Blesle;53;0;53;43182
84;43;01;10;183;Sainte-Eugénie-de-Villeneuve;113;2;115;43183
84;43;03;01;184;Saint-Ferréol-d'Auroure;2473;31;2504;43184
84;43;01;17;185;Sainte-Florine;3200;77;3277;43185
84;43;02;08;186;Saint-Front;402;4;406;43186
84;43;02;16;187;Saint-Geneys-près-Saint-Paulien;319;4;323;43187
84;43;01;10;188;Saint-Georges-d'Aurac;473;8;481;43188
84;43;02;11;189;Saint-Georges-Lagricol;518;13;531;43189
84;43;02;14;190;Saint-Germain-Laprade;3666;83;3749;43190
84;43;01;04;191;Saint-Géron;249;4;253;43191
84;43;02;18;192;Saint-Haon;283;11;294;43192
84;43;01;17;193;Saint-Hilaire;160;1;161;43193
84;43;02;06;194;Saint-Hostien;716;22;738;43194
84;43;01;10;195;Saint-Ilpize;186;5;191;43195
84;43;02;11;196;Saint-Jean-d'Aubrigoux;174;2;176;43196
84;43;02;16;197;Saint-Jean-de-Nay;351;5;356;43197
84;43;02;18;198;Saint-Jean-Lachalm;295;8;303;43198
84;43;03;03;199;Saint-Jeures;968;26;994;43199
84;43;02;06;200;Saint-Julien-Chapteuil;1997;43;2040;43200
84;43;02;11;201;Saint-Julien-d'Ance;245;8;253;43201
84;43;01;07;202;Saint-Julien-des-Chazes;71;1;72;43202
84;43;03;19;203;Saint-Julien-du-Pinet;482;13;495;43203
84;43;03;03;204;Saint-Julien-Molhesabate;174;1;175;43204
84;43;03;01;205;Saint-Just-Malmont;4225;60;4285;43205
84;43;01;10;206;Saint-Just-près-Brioude;411;16;427;43206
84;43;01;04;207;Saint-Laurent-Chabreuges;246;11;257;43207
84;43;01;10;208;Sainte-Marguerite;43;2;45;43208
84;43;02;08;210;Saint-Martin-de-Fugères;230;7;237;43210
84;43;03;09;211;Saint-Maurice-de-Lignon;2634;72;2706;43211
84;43;03;11;212;Saint-Pal-de-Chalencon;1009;16;1025;43212
84;43;03;05;213;Saint-Pal-de-Mons;2293;52;2345;43213
84;43;01;11;214;Saint-Pal-de-Senouire;110;3;113;43214
84;43;02;18;215;Saint-Paul-de-Tartas;186;5;191;43215
84;43;02;16;216;Saint-Paulien;2435;56;2491;43216
84;43;02;11;217;Saint-Pierre-du-Champ;542;11;553;43217
84;43;02;06;218;Saint-Pierre-Eynac;1187;27;1214;43218
84;43;01;10;219;Saint-Préjet-Armandon;113;4;117;43219
84;43;01;07;220;Saint-Préjet-d'Allier;174;4;178;43220
84;43;02;16;221;Saint-Privat-d'Allier;397;13;410;43221
84;43;01;10;222;Saint-Privat-du-Dragon;162;1;163;43222
84;43;03;03;223;Saint-Romain-Lachalm;1106;24;1130;43223
84;43;03;05;224;Sainte-Sigolène;5989;101;6090;43224
84;43;01;07;225;Saint-Vénérand;52;0;52;43225
84;43;01;17;226;Saint-Vert;107;4;111;43226
84;43;03;05;227;Saint-Victor-Malescours;822;16;838;43227
84;43;02;11;228;Saint-Victor-sur-Arlanc;90;2;92;43228
84;43;02;16;229;Saint-Vidal;610;9;619;43229
84;43;02;06;230;Saint-Vincent;1028;19;1047;43230
84;43;02;08;231;Salettes;136;4;140;43231
84;43;01;10;232;Salzuit;361;5;366;43232
84;43;02;16;233;Sanssac-l'Eglise;1088;41;1129;43233
84;43;01;07;234;Saugues;1697;124;1821;43234
84;43;03;05;236;La Séauve-sur-Semène;1480;20;1500;43236
84;43;01;11;237;Sembadel;227;6;233;43237
84;43;02;18;238;Séneujols;299;7;306;43238
84;43;01;07;239;Siaugues-Sainte-Marie;800;15;815;43239
84;43;03;02;240;Solignac-sous-Roche;263;7;270;43240
84;43;02;18;241;Solignac-sur-Loire;1272;32;1304;43241
84;43;01;07;242;Tailhac;72;3;75;43242
84;43;03;03;244;Tence;3074;45;3119;43244
84;43;01;07;245;Thoras;222;8;230;43245
84;43;03;02;246;Tiranges;464;17;481;43246
84;43;01;17;247;Torsiac;67;1;68;43247
84;43;03;02;249;Valprivas;520;11;531;43249
84;43;01;10;250;Vals-le-Chastel;43;3;46;43250
84;43;02;12;251;Vals-près-le-Puy;3420;121;3541;43251
84;43;02;11;252;Varennes-Saint-Honorat;24;2;26;43252
84;43;02;08;253;Les Vastres;195;9;204;43253
84;43;02;16;254;Vazeilles-Limandre;267;4;271;43254
84;43;01;07;256;Venteuges;343;6;349;43256
84;43;02;16;257;Vergezac;517;7;524;43257
84;43;01;17;258;Vergongheon;1815;50;1865;43258
84;43;02;16;259;Vernassal;362;11;373;43259
84;43;02;16;260;Le Vernet;23;0;23;43260
84;43;01;17;261;Vézézoux;617;6;623;43261
84;43;01;04;262;Vieille-Brioude;1167;37;1204;43262
84;43;02;18;263;Vielprat;67;0;67;43263
84;43;01;10;264;Villeneuve-d'Allier;285;15;300;43264
84;43;03;09;265;Les Villettes;1442;46;1488;43265
84;43;02;06;267;Vorey;1454;15;1469;43267
84;43;03;19;268;Yssingeaux;7278;425;7703;43268
52;44;05;08;001;Abbaretz;2067;40;2107;44001
52;44;02;07;002;Aigrefeuille-sur-Maine;4014;138;4152;44002
52;44;05;01;003;Ancenis-Saint-Géréon;11037;398;11435;44003
52;44;03;89;005;Chaumes-en-Retz;6895;106;7001;44005
52;44;03;09;006;Assérac;1847;42;1889;44006
52;44;05;19;007;Avessac;2458;55;2513;44007
52;44;02;29;009;Basse-Goulaine;9136;241;9377;44009
52;44;03;02;010;Batz-sur-Mer;2824;72;2896;44010
52;44;03;20;012;La Bernerie-en-Retz;3049;44;3093;44012
52;44;03;27;013;Besné;3183;41;3224;44013
52;44;02;28;014;Le Bignon;3907;71;3978;44014
52;44;05;03;015;Blain;9954;174;10128;44015
52;44;02;30;016;La Boissière-du-Doré;1054;18;1072;44016
52;44;02;21;018;Bouaye;8008;139;8147;44018
52;44;03;03;019;Bouée;1019;14;1033;44019
52;44;02;21;020;Bouguenais;19903;305;20208;44020
52;44;03;10;021;Villeneuve-en-Retz;4962;88;5050;44021
52;44;02;07;022;Boussay;2682;49;2731;44022
52;44;05;03;023;Bouvron;3068;45;3113;44023
52;44;02;21;024;Brains;2849;59;2908;44024
52;44;03;03;025;Campbon;3959;67;4026;44025
52;44;02;04;026;Carquefou;20365;466;20831;44026
52;44;05;18;027;Casson;2421;28;2449;44027
52;44;05;18;028;Le Cellier;3974;106;4080;44028
52;44;02;30;029;Divatte-sur-Loire;6975;122;7097;44029
52;44;03;09;030;La Chapelle-des-Marais;4338;91;4429;44030
52;44;05;06;031;La Chapelle-Glain;798;8;806;44031
52;44;02;30;032;La Chapelle-Heulin;3357;49;3406;44032
52;44;03;03;033;La Chapelle-Launay;3145;45;3190;44033
52;44;02;05;035;La Chapelle-sur-Erdre;19551;406;19957;44035
52;44;05;06;036;Châteaubriant;12031;497;12528;44036
52;44;02;31;037;Château-Thébaud;3164;175;3339;44037
52;44;03;20;038;Chauvé;2930;46;2976;44038
52;44;02;10;039;Cheix-en-Retz;1120;8;1128;44039
52;44;02;28;041;La Chevrolière;5782;88;5870;44041
52;44;02;07;043;Clisson;7435;241;7676;44043
52;44;05;08;044;Conquereuil;1095;28;1123;44044
52;44;02;03;045;Cordemais;3754;47;3801;44045
52;44;03;23;046;Corsept;2640;55;2695;44046
52;44;02;24;047;CouÃ«ron;22309;275;22584;44047
52;44;05;01;048;Couffé;2548;51;2599;44048
52;44;03;02;049;Le Croisic;4118;56;4174;44049
52;44;03;19;050;Crossac;2983;26;3009;44050
52;44;05;08;051;Derval;3505;428;3933;44051
52;44;03;27;052;Donges;8152;94;8246;44052
52;44;03;19;053;Drefféac;2270;37;2307;44053
52;44;05;06;054;Erbray;3043;72;3115;44054
52;44;03;02;055;La Baule-Escoublac;16255;542;16797;44055
52;44;05;05;056;Fay-de-Bretagne;3676;62;3738;44056
52;44;05;19;057;Fégréac;2349;61;2410;44057
52;44;05;06;058;Fercé;472;11;483;44058
52;44;03;23;061;Frossay;3216;57;3273;44061
52;44;05;03;062;Le Gâvre;1821;41;1862;44062
52;44;02;07;063;Gétigné;3719;88;3807;44063
52;44;02;07;064;Gorges;4851;360;5211;44064
52;44;05;06;065;Grand-Auverné;769;21;790;44065
52;44;05;05;066;Grandchamps-des-Fontaines;6439;117;6556;44066
52;44;05;08;067;Guémené-Penfao;5233;82;5315;44067
52;44;03;19;068;Guenrouet;3374;55;3429;44068
52;44;03;09;069;Guérande;16112;575;16687;44069
52;44;02;31;070;La Haie-Fouassière;4691;111;4802;44070
52;44;02;29;071;Haute-Goulaine;5893;157;6050;44071
52;44;03;09;072;Herbignac;7046;127;7173;44072
52;44;05;18;073;Héric;6288;114;6402;44073
52;44;02;24;074;Indre;4040;45;4085;44074
52;44;05;06;075;Issé;1807;39;1846;44075
52;44;05;08;076;Jans;1391;21;1412;44076
52;44;05;18;077;Joué-sur-Erdre;2561;33;2594;44077
52;44;05;06;078;Juigné-des-Moutiers;332;3;335;44078
52;44;02;30;079;Le Landreau;3083;296;3379;44079
52;44;03;03;080;Lavau-sur-Loire;772;26;798;44080
52;44;02;28;081;Legé;4565;112;4677;44081
52;44;05;18;082;Ligné;5302;106;5408;44082
52;44;02;28;083;La Limouzinière;2467;30;2497;44083
52;44;02;30;084;Le Loroux-Bottereau;8397;135;8532;44084
52;44;05;06;085;Louisfert;986;40;1026;44085
52;44;05;08;086;Lusanger;1055;21;1076;44086
52;44;02;10;087;Machecoul-Saint-Même;7581;236;7817;44087
52;44;02;07;088;Maisdon-sur-Sèvre;3007;43;3050;44088
52;44;03;03;089;Malville;3531;55;3586;44089
52;44;02;10;090;La Marne;1621;17;1638;44090
52;44;05;08;091;Marsac-sur-Don;1519;15;1534;44091
52;44;05;08;092;Massérac;692;13;705;44092
52;44;02;04;094;Mauves-sur-Loire;3244;65;3309;44094
52;44;05;06;095;La Meilleraye-de-Bretagne;1547;24;1571;44095
52;44;05;01;096;Mésanger;4749;80;4829;44096
52;44;03;09;097;Mesquer;2039;45;2084;44097
52;44;03;19;098;Missillac;5398;68;5466;44098
52;44;05;06;099;Moisdon-la-Rivière;1968;60;2028;44099
52;44;02;07;100;Monnières;2290;60;2350;44100
52;44;02;23;101;La Montagne;6290;140;6430;44101
52;44;02;28;102;Montbert;3191;55;3246;44102
52;44;03;27;103;Montoir-de-Bretagne;7180;79;7259;44103
52;44;05;01;104;Montrelais;840;11;851;44104
52;44;05;08;105;Mouais;372;7;379;44105
52;44;03;20;106;Les Moutiers-en-Retz;1765;21;1786;44106
52;44;05;18;107;Mouzeil;1911;25;1936;44107
52;44;02;30;108;Mouzillon;2865;54;2919;44108
52;44;02;96;109;Nantes;318808;5167;323975;44109
52;44;05;18;110;Nort-sur-Erdre;9082;194;9276;44110
52;44;05;18;111;Notre-Dame-des-Landes;2260;25;2285;44111
52;44;05;06;112;Noyal-sur-Brutz;591;11;602;44112
52;44;05;08;113;Nozay;4195;89;4284;44113
52;44;02;25;114;Orvault;27209;699;27908;44114
52;44;05;01;115;Oudon;3872;66;3938;44115
52;44;03;23;116;PaimbÅ“uf;3023;111;3134;44116
52;44;02;30;117;Le Pallet;3257;51;3308;44117
52;44;05;01;118;Pannecé;1409;24;1433;44118
52;44;02;10;119;Paulx;1985;27;2012;44119
52;44;02;23;120;Le Pellerin;5200;208;5408;44120
52;44;05;06;121;Petit-Auverné;426;4;430;44121
52;44;05;18;122;Petit-Mars;3755;53;3808;44122
52;44;05;08;123;Pierric;990;17;1007;44123
52;44;05;01;124;Le Pin;750;15;765;44124
52;44;03;09;125;Piriac-sur-Mer;2220;50;2270;44125
52;44;03;20;126;La Plaine-sur-Mer;4379;86;4465;44126
52;44;02;07;127;La Planche;2739;32;2771;44127
52;44;05;19;128;Plessé;5266;105;5371;44128
52;44;03;19;129;Pontchâteau;10901;260;11161;44129
52;44;02;28;130;Pont-Saint-Martin;6470;87;6557;44130
52;44;03;20;131;Pornic;15859;438;16297;44131
52;44;03;02;132;Pornichet;11141;299;11440;44132
52;44;02;10;133;Port-Saint-Père;2928;44;2972;44133
52;44;05;01;134;Pouillé-les-Côteaux;1071;22;1093;44134
52;44;03;02;135;Le Pouliguen;4015;93;4108;44135
52;44;03;20;136;Préfailles;1237;27;1264;44136
52;44;03;03;137;Prinquiau;3474;67;3541;44137
52;44;05;08;138;Puceul;1159;17;1176;44138
52;44;03;03;139;Quilly;1386;10;1396;44139
52;44;02;30;140;La Regrippière;1525;25;1550;44140
52;44;02;30;141;La Remaudière;1290;13;1303;44141
52;44;02;07;142;Remouillé;1958;34;1992;44142
52;44;02;97;143;Rezé;42919;791;43710;44143
52;44;05;18;144;Riaillé;2358;58;2416;44144
52;44;02;10;145;Rouans;3069;38;3107;44145
52;44;05;06;146;Rougé;2185;42;2227;44146
52;44;05;06;148;Ruffigné;701;8;709;44148
52;44;05;08;149;Saffré;3952;49;4001;44149
52;44;02;21;150;Saint-Aignan-Grandlieu;3954;60;4014;44150
52;44;03;02;151;Saint-André-des-Eaux;6744;179;6923;44151
52;44;03;19;152;Sainte-Anne-sur-Brivet;2933;53;2986;44152
52;44;05;06;153;Saint-Aubin-des-Châteaux;1763;52;1815;44153
52;44;03;23;154;Saint-Brevin-les-Pins;14287;318;14605;44154
52;44;02;28;155;Saint-Colomban;3417;75;3492;44155
52;44;02;28;156;Corcoué-sur-Logne;3022;39;3061;44156
52;44;02;10;157;Saint-Etienne-de-Mer-Morte;1727;22;1749;44157
52;44;02;03;158;Saint-Etienne-de-Montluc;7515;193;7708;44158
52;44;02;31;159;Saint-Fiacre-sur-Maine;1236;23;1259;44159
52;44;03;19;161;Saint-Gildas-des-Bois;3769;69;3838;44161
52;44;02;98;162;Saint-Herblain;47415;720;48135;44162
52;44;05;01;163;Vair-sur-Loire;4764;106;4870;44163
52;44;03;10;164;Saint-Hilaire-de-Chaléons;2322;45;2367;44164
52;44;02;07;165;Saint-Hilaire-de-Clisson;2320;47;2367;44165
52;44;02;23;166;Saint-Jean-de-Boiseau;5987;114;6101;44166
52;44;03;09;168;Saint-Joachim;4087;63;4150;44168
52;44;02;30;169;Saint-Julien-de-Concelles;7392;106;7498;44169
52;44;05;06;170;Saint-Julien-de-Vouvantes;967;22;989;44170
52;44;02;21;171;Saint-Léger-les-Vignes;1939;33;1972;44171
52;44;02;04;172;Sainte-Luce-sur-Loire;15319;269;15588;44172
52;44;02;07;173;Saint-Lumine-de-Clisson;2126;47;2173;44173
52;44;02;28;174;Saint-Lumine-de-Coutais;2229;39;2268;44174
52;44;03;09;175;Saint-Lyphard;4817;94;4911;44175
52;44;03;27;176;Saint-Malo-de-Guersac;3193;54;3247;44176
52;44;02;10;178;Saint-Mars-de-Coutais;2571;42;2613;44178
52;44;05;18;179;Saint-Mars-du-Désert;5118;85;5203;44179
52;44;05;01;180;Vallons-de-l'Erdre;6480;125;6605;44180
52;44;03;20;182;Saint-Michel-Chef-Chef;5233;89;5322;44182
52;44;03;09;183;Saint-Molf;2716;59;2775;44183
52;44;03;99;184;Saint-Nazaire;71394;1745;73139;44184
52;44;05;19;185;Saint-Nicolas-de-Redon;3245;66;3311;44185
52;44;02;10;186;Sainte-Pazanne;6980;132;7112;44186
52;44;03;23;187;Saint-Père-en-Retz;4576;147;4723;44187
52;44;02;28;188;Saint-Philbert-de-Grand-Lieu;9076;194;9270;44188
52;44;03;19;189;Sainte-Reine-de-Bretagne;2397;34;2431;44189
52;44;02;29;190;Saint-Sébastien-sur-Loire;27493;676;28169;44190
52;44;03;23;192;Saint-Viaud;2631;44;2675;44192
52;44;05;08;193;Saint-Vincent-des-Landes;1533;26;1559;44193
52;44;02;24;194;Sautron;8478;166;8644;44194
52;44;03;03;195;Savenay;9064;186;9250;44195
52;44;03;19;196;Sévérac;1631;25;1656;44196
52;44;05;08;197;Sion-les-Mines;1630;34;1664;44197
52;44;02;31;198;Les Sorinières;8765;132;8897;44198
52;44;05;06;199;Soudan;2003;56;2059;44199
52;44;05;06;200;Soulvache;343;7;350;44200
52;44;05;05;201;Sucé-sur-Erdre;7221;202;7423;44201
52;44;05;18;202;Teillé;1804;25;1829;44202
52;44;02;03;203;Le Temple-de-Bretagne;2028;17;2045;44203
52;44;02;04;204;Thouaré-sur-Loire;10482;179;10661;44204
52;44;05;18;205;Les Touches;2494;29;2523;44205
52;44;02;28;206;Touvois;1867;25;1892;44206
52;44;05;18;207;Trans-sur-Erdre;1094;10;1104;44207
52;44;05;08;208;Treffieux;930;11;941;44208
52;44;05;05;209;Treillières;9617;246;9863;44209
52;44;03;27;210;Trignac;7983;81;8064;44210
52;44;03;09;211;La Turballe;4734;95;4829;44211
52;44;02;30;212;Vallet;9460;179;9639;44212
52;44;05;01;213;Loireauxence;7480;127;7607;44213
52;44;05;08;214;Vay;2051;29;2080;44214
52;44;02;31;215;Vertou;25541;599;26140;44215
52;44;02;07;216;Vieillevigne;4010;75;4085;44216
52;44;05;05;217;Vigneux-de-Bretagne;6175;130;6305;44217
52;44;05;06;218;Villepot;682;14;696;44218
52;44;02;10;220;Vue;1615;25;1640;44220
52;44;05;08;221;La Chevallerais;1536;19;1555;44221
52;44;05;01;222;La Roche-Blanche;1225;21;1246;44222
52;44;02;28;223;Geneston;3677;48;3725;44223
52;44;05;08;224;La Grigonnais;1711;21;1732;44224
24;45;01;07;001;Adon;202;5;207;45001
24;45;01;08;002;Aillant-sur-Milleron;383;5;388;45002
24;45;01;02;004;Amilly;13233;590;13823;45004
24;45;03;17;005;Andonville;258;6;264;45005
24;45;02;05;006;Ardon;1092;28;1120;45006
24;45;02;10;008;Artenay;1951;30;1981;45008
24;45;03;17;009;Aschères-le-Marché;1136;30;1166;45009
24;45;03;09;010;Ascoux;1104;39;1143;45010
24;45;03;17;011;Attray;208;4;212;45011
24;45;03;17;012;Audeville;184;3;187;45012
24;45;03;09;013;Augerville-la-Rivière;227;8;235;45013
24;45;03;09;014;Aulnay-la-Rivière;500;13;513;45014
24;45;03;17;015;Autruy-sur-Juine;699;13;712;45015
24;45;01;07;016;Autry-le-Châtel;967;28;995;45016
24;45;01;08;017;Auvilliers-en-Gâtinais;339;3;342;45017
24;45;03;09;018;Auxy;971;18;989;45018
24;45;02;01;019;Baccon;654;27;681;45019
24;45;02;10;020;Le Bardon;987;18;1005;45020
24;45;03;09;021;Barville-en-Gâtinais;313;6;319;45021
24;45;03;09;022;Batilly-en-Gâtinais;449;4;453;45022
24;45;01;07;023;Batilly-en-Puisaye;114;2;116;45023
24;45;02;01;024;Baule;2065;39;2104;45024
24;45;03;17;025;Bazoches-les-Gallerandes;1548;21;1569;45025
24;45;01;04;026;Bazoches-sur-le-Betz;969;15;984;45026
24;45;01;08;027;Beauchamps-sur-Huillard;393;8;401;45027
24;45;02;01;028;Beaugency;7339;186;7525;45028
24;45;01;07;029;Beaulieu-sur-Loire;1789;21;1810;45029
24;45;03;09;030;Beaune-la-Rolande;2021;129;2150;45030
24;45;01;08;031;Bellegarde;1455;88;1543;45031
24;45;01;04;032;Le Bignon-Mirabeau;317;8;325;45032
24;45;03;09;033;BoÃ«sses;373;20;393;45033
24;45;02;18;034;Boigny-sur-Bionne;2094;50;2144;45034
24;45;03;09;035;Boiscommun;1132;23;1155;45035
24;45;01;07;036;Boismorand;840;29;869;45036
24;45;03;17;037;Boisseaux;505;10;515;45037
24;45;03;09;038;Bondaroy;413;12;425;45038
24;45;02;21;039;Bonnée;710;16;726;45039
24;45;01;07;040;Bonny-sur-Loire;1867;26;1893;45040
24;45;03;09;041;Bordeaux-en-Gâtinais;109;3;112;45041
24;45;02;21;042;Les Bordes;1920;46;1966;45042
24;45;02;18;043;Bou;1002;24;1026;45043
24;45;02;17;044;Bougy-lez-Neuville;161;7;168;45044
24;45;03;09;045;Bouilly-en-Gâtinais;314;12;326;45045
24;45;02;10;046;Boulay-les-Barres;1053;18;1071;45046
24;45;03;09;047;Bouzonville-aux-Bois;417;13;430;45047
24;45;02;03;049;Bouzy-la-Forêt;1218;31;1249;45049
24;45;03;09;050;Boynes;1324;38;1362;45050
24;45;02;21;051;Bray-Saint-Aignan;1741;34;1775;45051
24;45;01;07;052;Breteau;97;0;97;45052
24;45;01;07;053;Briare;5213;96;5309;45053
24;45;03;09;054;Briarres-sur-Essonne;546;10;556;45054
24;45;02;10;055;Bricy;554;15;569;45055
24;45;03;09;056;Bromeilles;322;6;328;45056
24;45;02;10;058;Bucy-le-Roi;176;7;183;45058
24;45;02;10;059;Bucy-Saint-Liphard;193;1;194;45059
24;45;01;07;060;La Bussière;786;18;804;45060
24;45;01;02;061;Cepoy;2419;53;2472;45061
24;45;02;10;062;Cercottes;1491;24;1515;45062
24;45;02;21;063;Cerdon;932;19;951;45063
24;45;01;07;064;Cernoy-en-Berry;450;10;460;45064
24;45;03;17;065;Césarville-Dossainville;240;3;243;45065
24;45;01;08;066;Chailly-en-Gâtinais;679;11;690;45066
24;45;02;10;067;Chaingy;3881;110;3991;45067
24;45;01;02;068;Châlette-sur-Loing;12688;262;12950;45068
24;45;03;09;069;Chambon-la-Forêt;952;14;966;45069
24;45;01;07;070;Champoulet;62;0;62;45070
24;45;02;06;072;Chanteau;1574;22;1596;45072
24;45;01;04;073;Chantecoq;483;8;491;45073
24;45;02;10;074;La Chapelle-Onzerain;115;2;117;45074
24;45;02;19;075;La Chapelle-Saint-Mesmin;10180;218;10398;45075
24;45;01;04;076;La Chapelle-Saint-Sépulcre;232;7;239;45076
24;45;01;08;077;La Chapelle-sur-Aveyron;626;6;632;45077
24;45;01;08;078;Chapelon;253;2;255;45078
24;45;01;08;079;Le Charme;156;0;156;45079
24;45;03;17;080;Charmont-en-Beauce;350;14;364;45080
24;45;02;10;081;Charsonville;613;16;629;45081
24;45;02;03;082;Châteauneuf-sur-Loire;8212;118;8330;45082
24;45;01;04;083;Château-Renard;2118;34;2152;45083
24;45;01;08;084;Châtenoy;445;9;454;45084
24;45;01;08;085;Châtillon-Coligny;1874;26;1900;45085
24;45;03;17;086;Châtillon-le-Roi;278;8;286;45086
24;45;01;07;087;Châtillon-sur-Loire;3108;52;3160;45087
24;45;03;17;088;Chaussy;293;10;303;45088
24;45;02;18;089;Chécy;8652;175;8827;45089
24;45;01;04;091;Chevannes;319;13;332;45091
24;45;01;11;092;Chevillon-sur-Huillard;1463;36;1499;45092
24;45;02;10;093;Chevilly;2658;39;2697;45093
24;45;01;04;094;Chevry-sous-le-Bignon;223;2;225;45094
24;45;03;09;095;Chilleurs-aux-Bois;2061;41;2102;45095
24;45;01;07;096;Les Choux;525;8;533;45096
24;45;01;04;097;Chuelles;1215;13;1228;45097
24;45;02;01;098;Cléry-Saint-André;3425;67;3492;45098
24;45;02;10;099;Coinces;516;9;525;45099
24;45;02;18;100;Combleux;494;21;515;45100
24;45;02;03;101;Combreux;274;6;280;45101
24;45;01;02;102;Conflans-sur-Loing;356;10;366;45102
24;45;01;04;103;Corbeilles;1551;18;1569;45103
24;45;01;02;104;Corquilleroy;2815;56;2871;45104
24;45;01;08;105;Cortrat;75;2;77;45105
24;45;01;08;107;Coudroy;318;0;318;45107
24;45;01;21;108;Coullons;2294;36;2330;45108
24;45;02;10;109;Coulmiers;541;11;552;45109
24;45;03;09;110;Courcelles-le-Roi;311;2;313;45110
24;45;03;09;111;Courcy-aux-Loges;451;3;454;45111
24;45;01;08;112;La Cour-Marigny;342;11;353;45112
24;45;01;04;113;Courtemaux;260;5;265;45113
24;45;01;04;114;Courtempierre;236;6;242;45114
24;45;01;04;115;Courtenay;3907;65;3972;45115
24;45;02;01;116;Cravant;956;24;980;45116
24;45;03;17;118;Crottes-en-Pithiverais;338;6;344;45118
24;45;03;17;119;Dadonville;2430;66;2496;45119
24;45;01;07;120;Dammarie-en-Puisaye;173;2;175;45120
24;45;01;08;121;Dammarie-sur-Loing;475;9;484;45121
24;45;02;21;122;Dampierre-en-Burly;1452;37;1489;45122
24;45;02;03;123;Darvoy;1864;31;1895;45123
24;45;03;09;124;Desmonts;175;3;178;45124
24;45;03;09;125;Dimancheville;113;3;116;45125
24;45;02;03;126;Donnery;2864;39;2903;45126
24;45;01;04;127;Dordives;3280;36;3316;45127
24;45;01;04;129;Douchy-Montcorbon;1358;28;1386;45129
24;45;02;01;130;Dry;1397;34;1431;45130
24;45;03;09;131;Echilleuses;389;10;399;45131
24;45;03;09;132;Egry;353;5;358;45132
24;45;03;17;133;Engenville;562;17;579;45133
24;45;02;10;134;Epieds-en-Beauce;1430;27;1457;45134
24;45;03;17;135;Erceville;311;5;316;45135
24;45;01;04;136;Ervauville;535;5;540;45136
24;45;03;09;137;Escrennes;726;17;743;45137
24;45;01;07;138;Escrignelles;51;0;51;45138
24;45;03;09;139;Estouy;493;17;510;45139
24;45;01;07;141;Faverelles;157;1;158;45141
24;45;02;03;142;Fay-aux-Loges;3754;67;3821;45142
24;45;01;07;143;Feins-en-Gâtinais;33;1;34;45143
24;45;02;20;144;Férolles;1142;85;1227;45144
24;45;01;04;145;Ferrières-en-Gâtinais;3702;81;3783;45145
24;45;02;05;146;La Ferté-Saint-Aubin;7404;160;7564;45146
24;45;02;06;147;Fleury-les-Aubrais;21010;266;21276;45147
24;45;01;04;148;Fontenay-sur-Loing;1726;13;1739;45148
24;45;01;04;149;Foucherolles;273;2;275;45149
24;45;01;08;150;Fréville-du-Gâtinais;181;4;185;45150
24;45;03;09;151;Gaubertin;253;8;261;45151
24;45;02;10;152;Gémigny;211;4;215;45152
24;45;02;21;153;Germigny-des-Prés;728;24;752;45153
24;45;02;10;154;Gidy;2057;34;2091;45154
24;45;01;07;155;Gien;13566;408;13974;45155
24;45;01;04;156;Girolles;603;17;620;45156
24;45;03;09;157;Givraines;414;6;420;45157
24;45;01;04;158;Gondreville;322;10;332;45158
24;45;03;09;159;Grangermont;193;3;196;45159
24;45;03;17;160;Greneville-en-Beauce;704;8;712;45160
24;45;01;04;161;Griselles;797;19;816;45161
24;45;03;17;162;Guigneville;524;14;538;45162
24;45;02;21;164;Guilly;645;16;661;45164
24;45;01;04;165;Gy-les-Nonains;612;9;621;45165
24;45;02;10;166;Huêtre;284;8;292;45166
24;45;02;10;167;Huisseau-sur-Mauves;1704;29;1733;45167
24;45;02;03;168;Ingrannes;556;4;560;45168
24;45;02;19;169;Ingré;9482;236;9718;45169
24;45;03;17;170;Intville-la-Guétard;165;2;167;45170
24;45;02;21;171;Isdes;548;14;562;45171
24;45;02;03;173;Jargeau;4676;49;4725;45173
24;45;03;17;174;Jouy-en-Pithiverais;265;6;271;45174
24;45;02;01;175;Jouy-le-Potier;1440;33;1473;45175
24;45;03;09;176;Juranville;430;4;434;45176
24;45;03;09;177;Laas;236;4;240;45177
24;45;01;08;178;Ladon;1386;22;1408;45178
24;45;02;01;179;Lailly-en-Val;3103;47;3150;45179
24;45;01;07;180;Langesse;82;0;82;45180
24;45;03;17;181;Léouville;88;2;90;45181
24;45;02;05;182;Ligny-le-Ribault;1230;27;1257;45182
24;45;02;10;183;Lion-en-Beauce;139;1;140;45183
24;45;02;21;184;Lion-en-Sullias;398;6;404;45184
24;45;01;11;185;Lombreuil;299;10;309;45185
24;45;03;09;186;Lorcy;579;13;592;45186
24;45;01;08;187;Lorris;2973;62;3035;45187
24;45;02;06;188;Loury;2492;61;2553;45188
24;45;01;04;189;Louzouer;250;6;256;45189
24;45;03;09;191;Le Malesherbois;8073;166;8239;45191
24;45;02;05;193;Marcilly-en-Villette;2138;47;2185;45193
24;45;02;18;194;Mardié;2866;56;2922;45194
24;45;03;09;195;Mareau-aux-Bois;562;14;576;45195
24;45;02;01;196;Mareau-aux-Prés;1508;25;1533;45196
24;45;02;06;197;Marigny-les-Usages;1692;37;1729;45197
24;45;03;09;198;Marsainvilliers;300;9;309;45198
24;45;01;04;199;Melleroy;502;4;506;45199
24;45;02;05;200;Ménestreau-en-Villette;1423;40;1463;45200
24;45;01;04;201;Mérinville;179;3;182;45201
24;45;02;01;202;Messas;1004;15;1019;45202
24;45;02;10;203;Meung-sur-Loire;6540;95;6635;45203
24;45;02;01;204;Mézières-lez-Cléry;815;20;835;45204
24;45;01;08;205;Mézières-en-Gâtinais;262;5;267;45205
24;45;01;04;206;Mignères;321;4;325;45206
24;45;01;04;207;Mignerette;405;9;414;45207
24;45;01;11;208;Montargis;14976;545;15521;45208
24;45;03;09;209;Montbarrois;305;5;310;45209
24;45;01;08;210;Montbouy;736;18;754;45210
24;45;01;08;212;Montcresson;1269;26;1295;45212
24;45;01;08;213;Montereau;627;15;642;45213
24;45;02;17;214;Montigny;239;4;243;45214
24;45;03;09;215;Montliard;242;3;245;45215
24;45;01;11;216;Mormant-sur-Vernisson;132;2;134;45216
24;45;03;17;217;Morville-en-Beauce;167;5;172;45217
24;45;01;07;218;Le Moulinet-sur-Solin;115;1;116;45218
24;45;01;08;219;Moulon;196;1;197;45219
24;45;03;09;220;Nancray-sur-Rimarde;576;17;593;45220
24;45;01;04;222;Nargis;1480;38;1518;45222
24;45;01;08;223;Nesploy;355;7;362;45223
24;45;02;17;224;Neuville-aux-Bois;4947;77;5024;45224
24;45;03;09;225;La Neuville-sur-Essonne;357;13;370;45225
24;45;02;21;226;Neuvy-en-Sullias;1359;27;1386;45226
24;45;01;07;227;Nevoy;1167;23;1190;45227
24;45;03;09;228;Nibelle;1195;11;1206;45228
24;45;01;08;229;Nogent-sur-Vernisson;2589;38;2627;45229
24;45;01;08;230;Noyers;737;5;742;45230
24;45;03;17;231;Oison;132;9;141;45231
24;45;02;12;232;Olivet;22386;481;22867;45232
24;45;03;09;233;Ondreville-sur-Essonne;402;3;405;45233
24;45;02;99;234;Orléans;116269;2363;118632;45234
24;45;02;15;235;Ormes;4147;79;4226;45235
24;45;03;09;237;Orville;124;1;125;45237
24;45;01;07;238;Ousson-sur-Loire;711;12;723;45238
24;45;01;08;239;Oussoy-en-Gâtinais;413;6;419;45239
24;45;03;17;240;Outarville;1312;23;1335;45240
24;45;02;20;241;Ouvrouer-les-Champs;547;11;558;45241
24;45;01;08;242;Ouzouer-des-Champs;266;5;271;45242
24;45;01;08;243;Ouzouer-sous-Bellegarde;313;6;319;45243
24;45;02;21;244;Ouzouer-sur-Loire;2641;82;2723;45244
24;45;01;07;245;Ouzouer-sur-Trézée;1117;20;1137;45245
24;45;03;17;246;Pannecières;138;1;139;45246
24;45;01;11;247;Pannes;3688;66;3754;45247
24;45;02;10;248;Patay;2244;37;2281;45248
24;45;01;02;249;Paucourt;908;24;932;45249
24;45;01;04;250;Pers-en-Gâtinais;252;2;254;45250
24;45;01;07;251;Pierrefitte-ès-Bois;316;4;320;45251
24;45;03;17;252;Pithiviers;9023;144;9167;45252
24;45;03;17;253;Pithiviers-le-Vieil;1769;41;1810;45253
24;45;01;21;254;Poilly-lez-Gien;2396;62;2458;45254
24;45;01;04;255;Préfontaines;442;9;451;45255
24;45;01;08;256;Presnoy;244;6;250;45256
24;45;01;08;257;Pressigny-les-Pins;501;7;508;45257
24;45;03;09;258;Puiseaux;3424;58;3482;45258
24;45;01;08;259;Quiers-sur-Bézonde;1133;22;1155;45259
24;45;03;09;260;Ramoulu;250;7;257;45260
24;45;02;06;261;Rebréchien;1311;16;1327;45261
24;45;02;10;262;Rouvray-Sainte-Croix;140;2;142;45262
24;45;03;17;263;Rouvres-Saint-Jean;300;8;308;45263
24;45;02;10;264;Rozières-en-Beauce;185;5;190;45264
24;45;01;04;265;Rozoy-le-Vieil;410;5;415;45265
24;45;02;10;266;Ruan;204;1;205;45266
24;45;02;21;268;Saint-Aignan-le-Jaillard;611;8;619;45268
24;45;02;10;269;Saint-Ay;3561;71;3632;45269
24;45;02;21;270;Saint-Benoît-sur-Loire;2004;51;2055;45270
24;45;01;21;271;Saint-Brisson-sur-Loire;968;23;991;45271
24;45;02;05;272;Saint-Cyr-en-Val;3295;76;3371;45272
24;45;02;03;273;Saint-Denis-de-l'Hôtel;3021;40;3061;45273
24;45;02;20;274;Saint-Denis-en-Val;7589;191;7780;45274
24;45;01;04;275;Saint-Firmin-des-Bois;451;4;455;45275
24;45;01;07;276;Saint-Firmin-sur-Loire;508;5;513;45276
24;45;02;21;277;Saint-Florent;453;12;465;45277
24;45;01;08;278;Sainte-Geneviève-des-Bois;1065;68;1133;45278
24;45;01;04;279;Saint-Germain-des-Prés;1904;18;1922;45279
24;45;01;21;280;Saint-Gondon;1096;19;1115;45280
24;45;01;04;281;Saint-Hilaire-les-Andrésis;953;17;970;45281
24;45;02;12;282;Saint-Hilaire-Saint-Mesmin;3071;85;3156;45282
24;45;01;08;283;Saint-Hilaire-sur-Puiseaux;164;6;170;45283
24;45;02;18;284;Saint-Jean-de-Braye;21288;592;21880;45284
24;45;02;19;285;Saint-Jean-de-la-Ruelle;16411;267;16678;45285
24;45;02;20;286;Saint-Jean-le-Blanc;9070;233;9303;45286
24;45;03;09;288;Saint-Loup-des-Vignes;395;10;405;45288
24;45;02;17;289;Saint-Lyé-la-Forêt;1202;18;1220;45289
24;45;02;03;290;Saint-Martin-d'Abbat;1761;27;1788;45290
24;45;01;21;291;Saint-Martin-sur-Ocre;1235;47;1282;45291
24;45;01;08;292;Saint-Maurice-sur-Aveyron;856;12;868;45292
24;45;01;11;293;Saint-Maurice-sur-Fessard;1155;25;1180;45293
24;45;03;09;294;Saint-Michel;135;1;136;45294
24;45;02;10;296;Saint-Péravy-la-Colombe;752;15;767;45296
24;45;02;21;297;Saint-Père-sur-Loire;1031;16;1047;45297
24;45;02;12;298;Saint-Pryvé-Saint-Mesmin;6076;102;6178;45298
24;45;02;10;299;Saint-Sigismond;267;1;268;45299
24;45;02;20;300;Sandillon;4114;100;4214;45300
24;45;03;09;301;Santeau;405;3;408;45301
24;45;02;15;302;Saran;16357;206;16563;45302
24;45;01;04;303;Sceaux-du-Gâtinais;632;13;645;45303
24;45;02;03;305;Seichebrières;212;1;213;45305
24;45;01;04;306;La Selle-en-Hermoy;788;14;802;45306
24;45;01;04;307;La Selle-sur-le-Bied;1099;24;1123;45307
24;45;02;18;308;Semoy;3224;77;3301;45308
24;45;02;05;309;Sennely;713;6;719;45309
24;45;03;17;310;Sermaises;1684;25;1709;45310
24;45;02;20;311;Sigloy;665;17;682;45311
24;45;01;11;312;Solterre;475;8;483;45312
24;45;02;10;313;Sougy;814;13;827;45313
24;45;02;03;314;Sully-la-Chapelle;450;9;459;45314
24;45;02;21;315;Sully-sur-Loire;5213;66;5279;45315
24;45;02;03;316;Sury-aux-Bois;790;23;813;45316
24;45;02;01;317;Tavers;1357;37;1394;45317
24;45;03;17;320;Thignonville;413;11;424;45320
24;45;01;08;321;Thimory;712;19;731;45321
24;45;01;04;322;Thorailles;185;4;189;45322
24;45;01;07;323;Thou;222;4;226;45323
24;45;02;20;324;Tigy;2333;51;2384;45324
24;45;03;17;325;Tivernon;288;4;292;45325
24;45;02;10;326;Tournoisis;392;9;401;45326
24;45;02;06;327;Traînou;3448;83;3531;45327
24;45;01;04;328;Treilles-en-Gâtinais;295;5;300;45328
24;45;01;04;329;Triguères;1288;25;1313;45329
24;45;02;10;330;Trinay;217;4;221;45330
24;45;02;20;331;Vannes-sur-Cosson;614;9;623;45331
24;45;01;08;332;Varennes-Changy;1494;26;1520;45332
24;45;02;06;333;Vennecy;1953;39;1992;45333
24;45;01;08;334;Vieilles-Maisons-sur-Joudry;632;8;640;45334
24;45;02;20;335;Vienne-en-Val;1939;44;1983;45335
24;45;02;21;336;Viglain;868;13;881;45336
24;45;02;10;337;Villamblain;286;8;294;45337
24;45;01;11;338;Villemandeur;6782;367;7149;45338
24;45;01;08;339;Villemoutiers;484;8;492;45339
24;45;02;21;340;Villemurlin;575;6;581;45340
24;45;02;10;341;Villeneuve-sur-Conie;200;6;206;45341
24;45;02;17;342;Villereau;394;3;397;45342
24;45;01;04;343;Villevoques;208;6;214;45343
24;45;02;01;344;Villorceau;1100;21;1121;45344
24;45;01;11;345;Vimory;1128;34;1162;45345
24;45;02;03;346;Vitry-aux-Loges;2243;40;2283;45346
24;45;03;09;347;Vrigny;815;16;831;45347
24;45;03;09;348;Yèvre-la-Ville;698;17;715;45348
76;46;01;12;001;Albas;521;14;535;46001
76;46;02;10;002;Albiac;64;2;66;46002
76;46;03;10;003;Alvignac;691;24;715;46003
76;46;02;11;004;Anglars;221;6;227;46004
76;46;01;12;005;Anglars-Juillac;333;9;342;46005
76;46;03;09;006;Anglars-Nozac;383;4;387;46006
76;46;01;02;007;Arcambal;983;23;1006;46007
76;46;03;15;008;Les Arques;210;3;213;46008
76;46;02;11;009;Assier;633;18;651;46009
76;46;01;13;010;Aujols;370;10;380;46010
76;46;02;16;011;Autoire;356;9;365;46011
76;46;02;16;012;Aynac;553;12;565;46012
76;46;01;13;013;Bach;174;2;176;46013
76;46;02;08;015;Bagnac-sur-Célé;1467;38;1505;46015
76;46;03;14;016;Baladou;386;15;401;46016
76;46;02;16;017;Bannes;141;4;145;46017
76;46;03;10;018;Le Bastit;137;3;140;46018
76;46;01;13;020;Beauregard;232;12;244;46020
76;46;02;07;021;Béduer;705;26;731;46021
76;46;01;12;022;Bélaye;209;1;210;46022
76;46;01;13;023;Belfort-du-Quercy;517;6;523;46023
76;46;02;06;024;Belmont-Bretenoux;404;12;416;46024
76;46;01;13;026;Belmont-Sainte-Foi;115;3;118;46026
76;46;01;05;027;Berganty;118;2;120;46027
76;46;03;14;028;Bétaille;1064;29;1093;46028
76;46;02;06;029;Biars-sur-Cère;2044;57;2101;46029
76;46;03;10;030;Bio;340;13;353;46030
76;46;03;05;031;Blars;131;3;134;46031
76;46;01;04;032;Boissières;403;5;408;46032
76;46;01;15;033;Porte-du-Quercy;577;8;585;46033
76;46;02;11;034;Le Bourg;314;9;323;46034
76;46;02;07;035;Boussac;182;8;190;46035
76;46;02;11;036;Le Bouyssou;126;2;128;46036
76;46;01;05;037;Bouziès;92;1;93;46037
76;46;02;06;038;Bretenoux;1368;29;1397;46038
76;46;02;05;039;Brengues;221;5;226;46039
76;46;01;05;040;Cabrerets;225;8;233;46040
76;46;02;05;041;Cadrieu;157;8;165;46041
76;46;01;98;042;Cahors;19937;940;20877;46042
76;46;02;06;043;Cahus;206;1;207;46043
76;46;01;12;044;Caillac;597;22;619;46044
76;46;02;05;045;Cajarc;1119;32;1151;46045
76;46;01;04;046;Calamane;457;10;467;46046
76;46;03;17;047;Calès;169;6;175;46047
76;46;02;05;049;Calvignac;202;3;205;46049
76;46;01;12;050;Cambayrac;141;4;145;46050
76;46;02;07;051;Cambes;388;11;399;46051
76;46;02;07;052;Camboulit;257;5;262;46052
76;46;02;07;053;Camburat;424;13;437;46053
76;46;03;05;054;Caniac-du-Causse;386;2;388;46054
76;46;02;08;055;Capdenac;1112;25;1137;46055
76;46;02;05;056;Carayac;106;5;111;46056
76;46;02;11;057;Cardaillac;616;13;629;46057
76;46;03;14;058;Carennac;413;15;428;46058
76;46;03;10;059;Carlucet;223;10;233;46059
76;46;01;12;060;Carnac-Rouffiac;228;1;229;46060
76;46;01;15;061;Cassagnes;178;4;182;46061
76;46;01;12;062;Castelfranc;434;8;442;46062
76;46;01;13;063;Castelnau Montratier-Sainte Alauzie;1833;38;1871;46063
76;46;01;04;064;Catus;896;7;903;46064
76;46;03;14;065;Cavagnac;436;14;450;46065
76;46;03;09;066;Cazals;637;5;642;46066
76;46;01;05;068;Cénevières;170;3;173;46068
76;46;01;13;069;Cézac;165;2;167;46069
76;46;01;03;070;Cieurac;587;14;601;46070
76;46;03;04;072;Concorès;305;6;311;46072
76;46;01;13;073;Concots;420;17;437;46073
76;46;03;14;074;Condat;410;8;418;46074
76;46;02;07;075;Corn;237;5;242;46075
76;46;02;06;076;Cornac;344;9;353;46076
76;46;03;10;078;Couzou;97;2;99;46078
76;46;03;05;079;Cras;102;2;104;46079
76;46;01;04;080;Crayssac;778;14;792;46080
76;46;01;05;081;Crégols;73;3;76;46081
76;46;01;13;082;Cremps;360;9;369;46082
76;46;03;14;083;Cressensac-Sarrazac;1118;23;1141;46083
76;46;03;14;084;Creysse;314;8;322;46084
76;46;02;08;085;Cuzac;235;6;241;46085
76;46;03;14;086;Cuzance;632;13;645;46086
76;46;03;09;087;Dégagnac;657;17;674;46087
76;46;01;12;088;Douelle;822;22;844;46088
76;46;01;15;089;Duravel;955;7;962;46089
76;46;02;10;090;Durbans;148;2;150;46090
76;46;01;13;091;Escamps;210;4;214;46091
76;46;01;05;092;Esclauzels;221;3;224;46092
76;46;02;05;093;Espagnac-Sainte-Eulalie;88;2;90;46093
76;46;02;05;094;Espédaillac;268;5;273;46094
76;46;01;04;095;Espère;1041;25;1066;46095
76;46;02;11;096;Espeyroux;96;2;98;46096
76;46;02;06;097;Estal;108;6;114;46097
76;46;03;17;098;Fajoles;300;7;307;46098
76;46;02;07;100;Faycelles;684;28;712;46100
76;46;02;08;101;Felzins;461;7;468;46101
76;46;02;99;102;Figeac;9802;670;10472;46102
76;46;01;13;103;Saint-Paul-Flaugnac;1003;26;1029;46103
76;46;02;10;104;Flaujac-Gare;94;6;100;46104
76;46;01;03;105;Flaujac-Poujols;780;17;797;46105
76;46;03;14;106;Floirac;241;8;249;46106
76;46;01;15;107;Floressas;170;5;175;46107
76;46;02;07;108;Fons;409;19;428;46108
76;46;01;13;109;Fontanes;501;9;510;46109
76;46;02;07;111;Fourmagnac;167;4;171;46111
76;46;01;04;112;Francoulès;240;5;245;46112
76;46;03;04;113;Frayssinet;305;6;311;46113
76;46;03;15;114;Frayssinet-le-Gélat;361;7;368;46114
76;46;02;16;115;Frayssinhes;163;7;170;46115
76;46;02;05;116;Frontenac;70;6;76;46116
76;46;02;06;117;Gagnac-sur-Cère;670;43;713;46117
76;46;03;17;118;Gignac;675;15;690;46118
76;46;01;04;119;Gigouzac;292;0;292;46119
76;46;03;09;120;Gindou;336;4;340;46120
76;46;03;04;121;Ginouillac;146;3;149;46121
76;46;02;06;122;Gintrac;104;4;108;46122
76;46;02;06;123;Girac;365;7;372;46123
76;46;02;06;124;Glanes;301;12;313;46124
76;46;02;11;125;Gorses;327;10;337;46125
76;46;03;15;126;Goujounac;221;4;225;46126
76;46;03;09;127;Gourdon;3981;127;4108;46127
76;46;03;10;128;Gramat;3469;58;3527;46128
76;46;02;05;129;Gréalou;287;11;298;46129
76;46;01;15;130;Grézels;222;5;227;46130
76;46;02;05;131;Grèzes;169;5;174;46131
76;46;02;10;132;Issendolus;519;21;540;46132
76;46;02;11;133;Issepts;265;3;268;46133
76;46;01;15;134;Les Junies;274;6;280;46134
76;46;02;11;135;Labastide-du-Haut-Mont;50;1;51;46135
76;46;01;04;136;Labastide-du-Vert;270;7;277;46136
76;46;01;03;137;Labastide-Marnhac;1244;22;1266;46137
76;46;03;05;138;CÅ“ur de Causse;918;20;938;46138
76;46;02;11;139;Labathude;201;7;208;46139
76;46;01;13;140;Laburgade;363;15;378;46140
76;46;01;15;142;Lacapelle-Cabanac;169;2;171;46142
76;46;02;11;143;Lacapelle-Marival;1277;36;1313;46143
76;46;03;17;144;Lacave;255;13;268;46144
76;46;03;17;145;Lachapelle-Auzac;793;13;806;46145
76;46;02;16;146;Ladirat;94;1;95;46146
76;46;01;15;147;Lagardelle;126;0;126;46147
76;46;01;13;148;Lalbenque;1785;46;1831;46148
76;46;01;02;149;Lamagdelaine;695;21;716;46149
76;46;03;04;151;Lamothe-Cassel;117;3;120;46151
76;46;03;17;152;Lamothe-Fénelon;301;4;305;46152
76;46;03;17;153;Lanzac;580;16;596;46153
76;46;01;13;154;Laramière;350;13;363;46154
76;46;02;05;155;Larnagol;138;1;139;46155
76;46;01;02;156;Bellefont-La Rauze;1226;24;1250;46156
76;46;02;05;157;Larroque-Toirac;134;5;139;46157
76;46;02;16;159;Latouille-Lentillac;223;12;235;46159
76;46;02;11;160;Latronquière;424;15;439;46160
76;46;02;11;161;Lauresses;248;6;254;46161
76;46;03;05;162;Lauzès;201;6;207;46162
76;46;02;06;163;Laval-de-Cère;288;4;292;46163
76;46;03;09;164;Lavercantière;251;11;262;46164
76;46;03;10;165;Lavergne;462;11;473;46165
76;46;03;05;167;Lentillac-du-Causse;106;0;106;46167
76;46;02;08;168;Lentillac-Saint-Blaise;187;1;188;46168
76;46;03;09;169;Léobard;206;7;213;46169
76;46;02;16;170;Leyme;927;23;950;46170
76;46;01;15;171;Lherm;227;3;230;46171
76;46;01;13;172;Lhospitalet;500;16;516;46172
76;46;01;13;173;Limogne-en-Quercy;738;17;755;46173
76;46;02;08;174;Linac;233;8;241;46174
76;46;02;07;175;Lissac-et-Mouret;917;33;950;46175
76;46;02;11;176;Livernon;699;13;712;46176
76;46;02;16;177;Loubressac;512;20;532;46177
76;46;03;17;178;Loupiac;261;1;262;46178
76;46;01;13;179;Lugagnac;127;5;132;46179
76;46;02;08;180;Lunan;593;25;618;46180
76;46;03;05;181;Lunegarde;96;4;100;46181
76;46;01;12;182;Luzech;1789;26;1815;46182
76;46;02;05;183;Marcilhac-sur-Célé;203;2;205;46183
76;46;03;09;184;Marminiac;350;12;362;46184
76;46;03;14;185;Martel;1625;41;1666;46185
76;46;03;17;186;Masclat;362;7;369;46186
76;46;01;15;187;Mauroux;524;10;534;46187
76;46;01;04;188;Maxou;300;10;310;46188
76;46;02;16;189;Mayrinhac-Lentour;498;16;514;46189
76;46;01;04;190;Mechmont;129;3;132;46190
76;46;01;01;191;Mercuès;1140;20;1160;46191
76;46;03;17;192;Meyronne;269;8;277;46192
76;46;03;10;193;Miers;457;11;468;46193
76;46;03;09;194;Milhac;182;3;185;46194
76;46;02;16;195;Molières;357;9;366;46195
76;46;03;04;196;Montamel;99;1;100;46196
76;46;01;03;197;Le Montat;1062;125;1187;46197
76;46;02;05;198;Montbrun;110;1;111;46198
76;46;01;15;199;Montcabrier;348;6;354;46199
76;46;03;15;200;Montcléra;267;5;272;46200
76;46;01;12;201;Montcuq-en-Quercy-Blanc;1772;48;1820;46201
76;46;01;13;202;Montdoumerc;549;5;554;46202
76;46;02;11;203;Montet-et-Bouxal;212;6;218;46203
76;46;03;04;204;Montfaucon;600;9;609;46204
76;46;01;04;205;Montgesty;325;2;327;46205
76;46;01;12;206;Montlauzun;120;6;126;46206
76;46;02;08;207;Montredon;301;5;306;46207
76;46;03;14;208;Montvalent;287;11;298;46208
76;46;03;17;209;Nadaillac-de-Rouge;163;8;171;46209
76;46;03;05;210;Nadillac;68;1;69;46210
76;46;01;04;211;Nuzéjouls;353;2;355;46211
76;46;03;05;212;Orniac;70;3;73;46212
76;46;03;10;213;Padirac;154;10;164;46213
76;46;01;12;214;Parnac;385;9;394;46214
76;46;03;17;215;Payrac;618;17;635;46215
76;46;03;09;216;Payrignac;658;29;687;46216
76;46;01;13;217;Pern;437;11;448;46217
76;46;01;15;218;Pescadoires;187;3;190;46218
76;46;03;04;219;Peyrilles;346;13;359;46219
76;46;03;17;220;Pinsac;788;25;813;46220
76;46;02;07;221;Planioles;533;9;542;46221
76;46;03;15;222;Pomarède;192;3;195;46222
76;46;01;04;223;Pontcirq;175;1;176;46223
76;46;01;01;224;Pradines;3562;102;3664;46224
76;46;01;15;225;Prayssac;2384;76;2460;46225
76;46;02;08;226;Prendeignes;230;7;237;46226
76;46;01;13;227;Promilhanes;222;4;226;46227
76;46;02;06;228;Prudhomat;718;15;733;46228
76;46;02;06;229;Puybrun;1015;18;1033;46229
76;46;02;05;230;Puyjourdes;86;4;90;46230
76;46;01;15;231;Puy-l'Evêque;1940;29;1969;46231
76;46;03;14;232;Le Vignon-en-Quercy;1006;24;1030;46232
76;46;02;05;233;Quissac;109;1;110;46233
76;46;03;09;234;Rampoux;100;2;102;46234
76;46;02;10;235;Reilhac;172;4;176;46235
76;46;03;17;236;Reilhaguet;143;0;143;46236
76;46;02;11;237;Reyrevignes;372;10;382;46237
76;46;03;10;238;Rignac;279;9;288;46238
76;46;03;17;239;Le Roc;212;5;217;46239
76;46;03;10;240;Rocamadour;623;20;643;46240
76;46;03;09;241;Rouffilhac;190;4;194;46241
76;46;02;11;242;Rudelle;179;5;184;46242
76;46;02;11;243;Rueyres;191;1;192;46243
76;46;02;11;244;Sabadel-Latronquière;94;1;95;46244
76;46;03;05;245;Sabadel-Lauzès;77;1;78;46245
76;46;02;16;246;Saignes;74;1;75;46246
76;46;01;13;247;Saillac;154;5;159;46247
76;46;02;11;249;Saint-Bressou;120;5;125;46249
76;46;03;15;250;Saint-Caprais;81;2;83;46250
76;46;02;16;251;Saint-Céré;3414;160;3574;46251
76;46;03;05;252;Les Pechs du Vers;312;8;320;46252
76;46;03;04;253;Saint-Chamarand;181;2;183;46253
76;46;02;05;254;Saint-Chels;139;5;144;46254
76;46;02;11;255;Saint-Cirgues;334;13;347;46255
76;46;01;05;256;Saint-Cirq-Lapopie;200;2;202;46256
76;46;03;09;257;Saint-Cirq-Madelon;122;3;125;46257
76;46;03;09;258;Saint-Cirq-Souillaguet;163;1;164;46258
76;46;03;09;259;Saint-Clair;141;2;143;46259
76;46;02;11;260;Sainte-Colombe;221;9;230;46260
76;46;01;12;262;Lendou-en-Quercy;633;14;647;46262
76;46;01;12;263;Barguelonne-en-Quercy;696;17;713;46263
76;46;01;04;264;Saint-Denis-Catus;200;7;207;46264
76;46;03;14;265;Saint-Denis-lès-Martel;331;7;338;46265
76;46;02;08;266;Saint-Félix;538;8;546;46266
76;46;03;04;267;Saint-Germain-du-Bel-Air;569;12;581;46267
76;46;01;05;268;Saint Géry-Vers;893;20;913;46268
76;46;02;11;269;Saint-Hilaire;61;2;63;46269
76;46;02;05;270;Saint-Jean-de-Laur;242;3;245;46270
76;46;02;16;271;Saint-Jean-Lespinasse;404;17;421;46271
76;46;02;08;272;Saint-Jean-Mirabel;271;4;275;46272
76;46;02;16;273;Saint-Laurent-les-Tours;846;25;871;46273
76;46;01;05;276;Saint-Martin-Labouval;185;5;190;46276
76;46;01;15;277;Saint-Martin-le-Redon;205;4;209;46277
76;46;02;11;279;Saint-Maurice-en-Quercy;210;3;213;46279
76;46;01;04;280;Saint-Médard;178;5;183;46280
76;46;02;16;281;Saint-Médard-de-Presque;200;7;207;46281
76;46;02;11;282;Saint-Médard-Nicourby;94;0;94;46282
76;46;03;14;283;Saint-Michel-de-Bannières;316;8;324;46283
76;46;02;06;284;Saint-Michel-Loubéjou;405;8;413;46284
76;46;02;16;286;Saint-Paul-de-Vern;176;5;181;46286
76;46;02;08;288;Saint-Perdoux;213;10;223;46288
76;46;02;05;289;Saint-Pierre-Toirac;159;0;159;46289
76;46;03;09;290;Saint-Projet;341;8;349;46290
76;46;02;11;292;Saint-Simon;186;6;192;46292
76;46;03;17;293;Saint-Sozy;483;12;495;46293
76;46;02;05;294;Saint-Sulpice;146;3;149;46294
76;46;02;16;295;Saint-Vincent-du-Pendit;212;4;216;46295
76;46;01;12;296;Saint-Vincent-Rive-d'Olt;437;16;453;46296
76;46;03;09;297;Salviac;1207;25;1232;46297
76;46;02;05;299;Sauliac-sur-Célé;120;4;124;46299
76;46;01;12;301;Sauzet;520;5;525;46301
76;46;02;11;302;Sénaillac-Latronquière;135;2;137;46302
76;46;03;05;303;Sénaillac-Lauzès;128;3;131;46303
76;46;03;04;304;Séniergues;137;1;138;46304
76;46;01;15;305;Sérignac;306;2;308;46305
76;46;02;11;306;Sonac;86;3;89;46306
76;46;01;15;307;Soturac;640;6;646;46307
76;46;03;04;308;Soucirac;102;1;103;46308
76;46;03;17;309;Souillac;3201;318;3519;46309
76;46;03;05;310;Soulomès;126;2;128;46310
76;46;02;06;311;Sousceyrac-en-Quercy;1331;20;1351;46311
76;46;03;14;312;Strenquels;273;2;275;46312
76;46;02;06;313;Tauriac;442;9;451;46313
76;46;02;11;314;Terrou;174;40;214;46314
76;46;02;06;315;Teyssieu;167;3;170;46315
76;46;03;04;316;Thédirac;290;5;295;46316
76;46;03;10;317;Thégra;481;13;494;46317
76;46;02;11;318;Thémines;232;12;244;46318
76;46;02;11;319;Théminettes;168;5;173;46319
76;46;01;05;320;Tour-de-Faure;317;15;332;46320
76;46;01;15;321;Touzac;370;8;378;46321
76;46;01;03;322;Trespoux-Rassiels;809;31;840;46322
76;46;03;04;323;Ussel;99;2;101;46323
76;46;03;04;324;Uzech;214;4;218;46324
76;46;01;13;328;Varaire;335;12;347;46328
76;46;01;13;329;Vaylats;326;2;328;46329
76;46;03;14;330;Vayrac;1303;25;1328;46330
76;46;02;08;332;Viazac;334;5;339;46332
76;46;01;13;333;Vidaillac;179;4;183;46333
76;46;03;09;334;Le Vigan;1565;57;1622;46334
76;46;01;12;335;Villesèque;395;16;411;46335
76;46;01;15;336;Vire-sur-Lot;349;31;380;46336
76;46;03;17;337;Mayrac;259;7;266;46337
76;46;02;11;338;Bessonies;77;1;78;46338
76;46;02;16;339;Saint-Jean-Lagineste;369;8;377;46339
76;46;01;04;340;Saint-Pierre-Lafeuille;365;12;377;46340
75;47;01;97;001;Agen;32602;862;33464;47001
75;47;02;07;002;Agmé;105;4;109;47002
75;47;02;19;003;Agnac;421;9;430;47003
75;47;01;06;004;Aiguillon;4421;141;4562;47004
75;47;02;19;005;Allemans-du-Dropt;487;5;492;47005
75;47;03;12;006;Allez-et-Cazeneuve;593;13;606;47006
75;47;04;08;007;Allons;164;6;170;47007
75;47;04;11;008;Ambrus;110;4;114;47008
75;47;04;05;009;Andiran;229;8;237;47009
75;47;02;08;010;Antagnac;224;3;227;47010
75;47;03;09;011;Anthé;199;7;206;47011
75;47;04;08;012;Anzex;311;2;313;47012
75;47;02;08;013;Argenton;324;11;335;47013
75;47;02;19;014;Armillac;202;7;209;47014
75;47;01;17;015;Astaffort;2031;39;2070;47015
75;47;01;15;016;Aubiac;1154;25;1179;47016
75;47;03;16;017;Auradou;415;9;424;47017
75;47;02;07;018;Auriac-sur-Dropt;173;6;179;47018
75;47;01;01;019;Bajamont;989;21;1010;47019
75;47;02;07;020;Baleyssagues;184;8;192;47020
75;47;04;11;021;Barbaste;1511;81;1592;47021
75;47;01;06;022;Bazens;538;9;547;47022
75;47;03;10;023;Beaugas;354;5;359;47023
75;47;02;13;024;Beaupuy;1632;41;1673;47024
75;47;01;16;025;Beauville;550;6;556;47025
75;47;04;08;026;Beauziac;231;8;239;47026
75;47;03;21;027;Bias;2997;45;3042;47027
75;47;02;14;028;Birac-sur-Trec;850;18;868;47028
75;47;03;09;029;Blanquefort-sur-Briolance;495;13;508;47029
75;47;01;16;030;Blaymont;209;6;215;47030
75;47;01;02;031;Boé;5631;94;5725;47031
75;47;01;02;032;Bon-Encontre;6224;148;6372;47032
75;47;03;10;033;Boudy-de-Beauregard;412;3;415;47033
75;47;02;08;034;Bouglon;633;13;646;47034
75;47;02;19;035;Bourgougnague;328;80;408;47035
75;47;03;09;036;Bourlens;375;6;381;47036
75;47;03;10;037;Bournel;253;4;257;47037
75;47;01;06;038;Bourran;613;24;637;47038
75;47;04;08;039;Boussès;36;0;36;47039
75;47;01;15;040;Brax;2090;46;2136;47040
75;47;04;11;041;Bruch;747;15;762;47041
75;47;02;18;042;Brugnac;184;6;190;47042
75;47;04;11;043;Buzet-sur-BaÃ¯se;1260;14;1274;47043
75;47;03;19;044;Cahuzac;309;3;312;47044
75;47;04;05;045;Calignac;472;5;477;47045
75;47;02;08;046;Calonges;613;12;625;47046
75;47;02;07;047;Cambes;183;5;188;47047
75;47;03;10;048;Cancon;1339;19;1358;47048
75;47;03;12;049;Casseneuil;2433;48;2481;47049
75;47;01;16;050;Cassignas;129;2;131;47050
75;47;01;17;051;Castelculier;2393;48;2441;47051
75;47;04;08;052;Casteljaloux;4518;56;4574;47052
75;47;01;16;053;Castella;375;7;382;47053
75;47;02;18;054;Castelmoron-sur-Lot;1796;23;1819;47054
75;47;03;10;055;Castelnaud-de-Gratecambe;516;7;523;47055
75;47;02;07;056;Castelnau-sur-Gupie;894;32;926;47056
75;47;03;19;057;Castillonnès;1370;20;1390;47057
75;47;04;08;058;Caubeyres;257;1;258;47058
75;47;02;07;059;Caubon-Saint-Sauveur;261;4;265;47059
75;47;01;17;060;Caudecoste;1109;19;1128;47060
75;47;02;14;061;Caumont-sur-Garonne;774;7;781;47061
75;47;01;16;062;Cauzac;417;4;421;47062
75;47;03;19;063;Cavarc;162;2;164;47063
75;47;03;09;064;Cazideroque;238;7;245;47064
75;47;02;18;065;Clairac;2594;198;2792;47065
75;47;01;06;066;Clermont-Dessous;911;12;923;47066
75;47;01;17;067;Clermont-Soubiran;393;8;401;47067
75;47;02;13;068;Cocumont;1087;23;1110;47068
75;47;01;15;069;Colayrac-Saint-Cirq;3113;49;3162;47069
75;47;03;09;070;Condezaygues;850;23;873;47070
75;47;02;18;071;Coulx;242;3;245;47071
75;47;03;09;072;Courbiac;108;3;111;47072
75;47;01;06;073;Cours;198;5;203;47073
75;47;02;13;074;Couthures-sur-Garonne;360;6;366;47074
75;47;01;16;075;La Croix-Blanche;1078;23;1101;47075
75;47;01;17;076;Cuq;281;5;286;47076
75;47;03;09;077;Cuzorn;851;18;869;47077
75;47;04;11;078;Damazan;1357;46;1403;47078
75;47;03;16;079;Dausse;517;18;535;47079
75;47;03;10;080;Dévillac;133;3;136;47080
75;47;03;12;081;Dolmayrac;716;15;731;47081
75;47;01;16;082;Dondas;216;1;217;47082
75;47;03;10;083;Doudrac;104;1;105;47083
75;47;03;19;084;Douzains;270;6;276;47084
75;47;04;08;085;Durance;297;3;300;47085
75;47;02;07;086;Duras;1219;20;1239;47086
75;47;01;16;087;Engayrac;163;9;172;47087
75;47;02;07;088;Escassefort;614;9;623;47088
75;47;02;07;089;Esclottes;150;2;152;47089
75;47;04;05;090;Espiens;366;8;374;47090
75;47;01;15;091;Estillac;2189;41;2230;47091
75;47;01;17;092;Fals;392;6;398;47092
75;47;04;08;093;Fargues-sur-Ourbise;347;9;356;47093
75;47;02;14;094;Fauguerolles;810;15;825;47094
75;47;02;18;095;Fauillet;863;19;882;47095
75;47;03;19;096;Ferrensac;205;5;210;47096
75;47;04;11;097;Feugarolles;1010;21;1031;47097
75;47;04;05;098;Fieux;356;9;365;47098
75;47;03;12;099;Fongrave;622;16;638;47099
75;47;01;01;100;Foulayronnes;5449;219;5668;47100
75;47;02;14;101;Fourques-sur-Garonne;1330;28;1358;47101
75;47;04;05;102;Francescas;737;11;748;47102
75;47;04;05;103;Fréchou;230;4;234;47103
75;47;01;06;104;Frégimont;253;4;257;47104
75;47;03;16;105;Frespech;282;5;287;47105
75;47;03;09;106;Fumel;4755;99;4854;47106
75;47;01;06;107;Galapian;308;6;314;47107
75;47;02;13;108;Gaujac;246;7;253;47108
75;47;03;10;109;Gavaudun;291;5;296;47109
75;47;02;14;110;Gontaud-de-Nogaret;1651;28;1679;47110
75;47;01;06;111;Granges-sur-Lot;589;17;606;47111
75;47;02;18;112;Grateloup-Saint-Gayrand;422;13;435;47112
75;47;01;17;113;Grayssas;141;3;144;47113
75;47;02;08;114;Grézet-Cavagnan;396;1;397;47114
75;47;02;08;115;Guérin;254;7;261;47115
75;47;03;21;117;Hautefage-la-Tour;1014;16;1030;47117
75;47;02;18;118;Hautesvignes;186;1;187;47118
75;47;04;08;119;Houeillès;556;8;564;47119
75;47;02;07;120;Jusix;102;3;105;47120
75;47;02;08;121;Labastide-Castel-Amouroux;302;0;302;47121
75;47;02;18;122;Labretonie;186;2;188;47122
75;47;03;09;123;Lacapelle-Biron;418;5;423;47123
75;47;03;10;124;Lacaussade;212;6;218;47124
75;47;01;06;125;Lacépède;314;7;321;47125
75;47;02;07;126;Lachapelle;95;1;96;47126
75;47;02;18;127;Lafitte-sur-Lot;822;12;834;47127
75;47;01;17;128;Lafox;1116;29;1145;47128
75;47;01;06;129;Lagarrigue;278;6;284;47129
75;47;02;08;130;Lagruère;327;5;332;47130
75;47;02;07;131;Lagupie;699;15;714;47131
75;47;03;19;132;Lalandusse;224;4;228;47132
75;47;04;05;133;Lamontjoie;601;8;609;47133
75;47;04;05;134;Lannes;366;9;375;47134
75;47;02;18;135;Laparade;383;8;391;47135
75;47;02;19;136;Laperche;136;2;138;47136
75;47;01;15;137;Laplume;1344;32;1376;47137
75;47;01;16;138;Laroque-Timbaut;1638;24;1662;47138
75;47;04;05;139;Lasserre;88;1;89;47139
75;47;01;06;140;Laugnac;687;15;702;47140
75;47;03;10;141;Laussou;283;6;289;47141
75;47;02;19;142;Lauzun;763;6;769;47142
75;47;04;11;143;Lavardac;2263;59;2322;47143
75;47;02;19;144;Lavergne;574;20;594;47144
75;47;01;17;145;Layrac;3686;56;3742;47145
75;47;03;20;146;Lédat;1410;29;1439;47146
75;47;02;07;147;Lévignac-de-Guyenne;684;11;695;47147
75;47;04;08;148;Leyritz-Moncassin;204;1;205;47148
75;47;02;14;150;Longueville;367;6;373;47150
75;47;02;07;151;Loubès-Bernac;423;3;426;47151
75;47;03;19;152;Lougratte;403;10;413;47152
75;47;01;06;154;Lusignan-Petit;372;4;376;47154
75;47;01;06;155;Madaillan;651;16;667;47155
75;47;02;13;156;Marcellus;856;8;864;47156
75;47;02;98;157;Marmande;17421;587;18008;47157
75;47;01;15;158;Marmont-Pachas;174;3;177;47158
75;47;02;08;159;Le Mas-d'Agenais;1483;34;1517;47159
75;47;03;09;160;Masquières;183;2;185;47160
75;47;03;16;161;Massels;116;1;117;47161
75;47;03;16;162;Massoulès;217;5;222;47162
75;47;02;07;163;Mauvezin-sur-Gupie;607;8;615;47163
75;47;03;10;164;Mazières-Naresse;112;3;115;47164
75;47;02;13;165;Meilhan-sur-Garonne;1330;59;1389;47165
75;47;04;05;167;Mézin;1469;26;1495;47167
75;47;02;19;168;Miramont-de-Guyenne;3092;102;3194;47168
75;47;01;15;169;Moirax;1177;54;1231;47169
75;47;03;10;170;Monbahus;615;23;638;47170
75;47;01;16;171;Monbalen;437;8;445;47171
75;47;04;05;172;Moncaut;594;18;612;47172
75;47;03;12;173;Monclar;882;11;893;47173
75;47;04;05;174;Moncrabeau;736;17;753;47174
75;47;03;10;175;Monflanquin;2329;54;2383;47175
75;47;04;11;176;Mongaillard;174;12;186;47176
75;47;04;11;177;Monheurt;191;4;195;47177
75;47;03;10;178;Monségur;402;8;410;47178
75;47;03;09;179;Monsempron-Libos;2033;28;2061;47179
75;47;04;05;180;Montagnac-sur-Auvignon;631;14;645;47180
75;47;03;10;181;Montagnac-sur-Lède;271;3;274;47181
75;47;03;12;182;Montastruc;246;1;247;47182
75;47;03;19;183;Montauriol;166;6;172;47183
75;47;03;10;184;Montaut;260;4;264;47184
75;47;03;09;185;Montayral;2652;68;2720;47185
75;47;04;11;186;Montesquieu;773;12;785;47186
75;47;02;07;187;Monteton;328;2;330;47187
75;47;02;19;188;Montignac-de-Lauzun;291;4;295;47188
75;47;02;07;189;Montignac-Toupinerie;148;0;148;47189
75;47;01;06;190;Montpezat;549;45;594;47190
75;47;02;13;191;Montpouillan;846;9;855;47191
75;47;03;10;192;Monviel;78;1;79;47192
75;47;03;10;193;Moulinet;199;4;203;47193
75;47;02;07;194;Moustier;321;5;326;47194
75;47;04;05;195;Nérac;6837;507;7344;47195
75;47;01;06;196;Nicole;215;3;218;47196
75;47;04;05;197;Nomdieu;254;2;256;47197
75;47;03;10;198;Pailloles;335;6;341;47198
75;47;02;07;199;Pardaillan;316;5;321;47199
75;47;03;10;200;Parranquet;114;1;115;47200
75;47;01;04;201;Le Passage;9400;170;9570;47201
75;47;03;10;202;Paulhiac;309;7;316;47202
75;47;03;16;203;Penne-d'Agenais;2341;50;2391;47203
75;47;02;19;204;Peyrière;283;3;286;47204
75;47;04;08;205;Pindères;201;8;209;47205
75;47;03;12;206;Pinel-Hauterive;564;5;569;47206
75;47;04;11;207;Pompiey;205;5;210;47207
75;47;04;08;208;Pompogne;199;6;205;47208
75;47;01;01;209;Pont-du-Casse;4141;118;4259;47209
75;47;01;06;210;Port-Sainte-Marie;1846;30;1876;47210
75;47;04;05;211;Poudenas;223;7;230;47211
75;47;02;08;212;Poussignac;289;6;295;47212
75;47;01;06;213;Prayssas;995;27;1022;47213
75;47;04;11;214;Puch-d'Agenais;681;13;694;47214
75;47;03;21;215;Pujols;3675;138;3813;47215
75;47;02;07;216;Puymiclan;679;13;692;47216
75;47;01;17;217;Puymirol;919;15;934;47217
75;47;02;19;218;Puysserampion;240;4;244;47218
75;47;03;10;219;Rayet;180;2;182;47219
75;47;04;11;220;Razimet;298;5;303;47220
75;47;04;05;221;Réaup-Lisse;606;18;624;47221
75;47;04;08;222;La Réunion;486;9;495;47222
75;47;03;10;223;Rives;203;7;210;47223
75;47;02;08;224;Romestaing;161;6;167;47224
75;47;01;15;225;Roquefort;2048;39;2087;47225
75;47;02;19;226;Roumagne;528;9;537;47226
75;47;02;08;227;Ruffiac;177;2;179;47227
75;47;03;21;228;Saint-Antoine-de-Ficalba;717;10;727;47228
75;47;02;07;229;Saint-Astier;223;5;228;47229
75;47;03;10;230;Saint-Aubin;395;9;404;47230
75;47;02;07;231;Saint-Avit;175;2;177;47231
75;47;02;07;232;Saint-Barthélemy-d'Agenais;520;3;523;47232
75;47;02;13;233;Sainte-Bazeille;3160;98;3258;47233
75;47;01;17;234;Saint-Caprais-de-Lerm;663;20;683;47234
75;47;02;19;235;Saint-Colomb-de-Lauzun;471;4;475;47235
75;47;02;07;236;Sainte-Colombe-de-Duras;106;1;107;47236
75;47;03;21;237;Sainte-Colombe-de-Villeneuve;502;11;513;47237
75;47;01;15;238;Sainte-Colombe-en-Bruilhois;1586;53;1639;47238
75;47;03;12;239;Saint-Etienne-de-Fougères;850;13;863;47239
75;47;03;10;240;Saint-Etienne-de-Villeréal;279;10;289;47240
75;47;03;10;241;Saint-Eutrope-de-Born;678;18;696;47241
75;47;03;09;242;Saint-Front-sur-Lémance;518;13;531;47242
75;47;02;08;244;Sainte-Gemme-Martaillac;387;5;392;47244
75;47;02;07;245;Saint-Géraud;93;2;95;47245
75;47;01;15;246;Saint-Hilaire-de-Lusignan;1491;39;1530;47246
75;47;02;07;247;Saint-Jean-de-Duras;248;10;258;47247
75;47;01;17;248;Saint-Jean-de-Thurac;571;7;578;47248
75;47;04;11;249;Saint-Laurent;523;4;527;47249
75;47;04;11;250;Saint-Léger;123;4;127;47250
75;47;04;11;251;Saint-Léon;320;5;325;47251
75;47;03;12;252;Sainte-Livrade-sur-Lot;6456;175;6631;47252
75;47;02;08;253;Sainte-Marthe;645;5;650;47253
75;47;04;08;254;Saint-Martin-Curton;308;8;316;47254
75;47;01;16;255;Saint-Martin-de-Beauville;174;3;177;47255
75;47;03;10;256;Saint-Martin-de-Villeréal;102;4;106;47256
75;47;02;07;257;Saint-Martin-Petit;613;8;621;47257
75;47;04;05;258;Sainte-Maure-de-Peyriac;312;10;322;47258
75;47;03;10;259;Saint-Maurice-de-Lestapel;103;4;107;47259
75;47;01;16;260;Saint-Maurin;415;5;420;47260
75;47;01;17;262;Saint-Nicolas-de-la-Balerme;423;4;427;47262
75;47;02;14;263;Saint-Pardoux-du-Breuil;608;15;623;47263
75;47;02;19;264;Saint-Pardoux-Isaac;1105;19;1124;47264
75;47;03;12;265;Saint-Pastour;377;8;385;47265
75;47;04;05;266;Saint-Pé-Saint-Simon;198;2;200;47266
75;47;04;11;267;Saint-Pierre-de-Buzet;295;2;297;47267
75;47;01;17;269;Saint-Pierre-de-Clairac;844;19;863;47269
75;47;02;07;271;Saint-Pierre-sur-Dropt;358;3;361;47271
75;47;03;19;272;Saint-Quentin-du-Dropt;194;7;201;47272
75;47;01;16;273;Saint-Robert;187;6;193;47273
75;47;01;17;274;Saint-Romain-le-Noble;396;6;402;47274
75;47;01;06;275;Saint-Salvy;201;1;202;47275
75;47;01;06;276;Saint-Sardos;299;7;306;47276
75;47;02;13;277;Saint-Sauveur-de-Meilhan;337;1;338;47277
75;47;02;07;278;Saint-Sernin;475;9;484;47278
75;47;01;17;279;Saint-Sixte;353;6;359;47279
75;47;03;16;280;Saint-Sylvestre-sur-Lot;2324;53;2377;47280
75;47;01;17;281;Saint-Urcisse;249;1;250;47281
75;47;04;05;282;Saint-Vincent-de-Lamontjoie;233;7;240;47282
75;47;03;09;283;Saint-Vite;1163;30;1193;47283
75;47;03;10;284;Salles;293;7;300;47284
75;47;02;14;285;Samazan;895;17;912;47285
75;47;04;08;286;Sauméjan;106;0;106;47286
75;47;04;05;287;Saumont;266;3;269;47287
75;47;01;17;288;Sauvagnas;524;14;538;47288
75;47;01;16;289;La Sauvetat-de-Savères;524;11;535;47289
75;47;02;07;290;La Sauvetat-du-Dropt;549;6;555;47290
75;47;03;10;291;La Sauvetat-sur-Lède;630;16;646;47291
75;47;03;09;292;Sauveterre-la-Lémance;576;6;582;47292
75;47;01;17;293;Sauveterre-Saint-Denis;387;18;405;47293
75;47;02;07;294;Savignac-de-Duras;219;1;220;47294
75;47;03;10;295;Savignac-sur-Leyze;304;6;310;47295
75;47;02;19;296;Ségalas;155;2;157;47296
75;47;03;06;297;Sembas;141;3;144;47297
75;47;02;08;298;Sénestis;213;3;216;47298
75;47;03;19;299;Sérignac-Péboudou;172;5;177;47299
75;47;01;15;300;Sérignac-sur-Garonne;1172;20;1192;47300
75;47;02;07;301;Seyches;1062;11;1073;47301
75;47;04;05;302;Sos;651;7;658;47302
75;47;02;07;303;Soumensac;226;9;235;47303
75;47;02;14;304;Taillebourg;61;2;63;47304
75;47;01;16;305;Tayrac;386;6;392;47305
75;47;03;12;306;Le Temple-sur-Lot;1048;19;1067;47306
75;47;03;09;307;Thézac;200;5;205;47307
75;47;04;11;308;Thouars-sur-Garonne;222;3;225;47308
75;47;03;12;309;TombebÅ“uf;456;4;460;47309
75;47;02;18;310;Tonneins;9130;225;9355;47310
75;47;03;10;311;Tourliac;133;8;141;47311
75;47;03;09;312;Tournon-d'Agenais;761;13;774;47312
75;47;03;12;313;Tourtrès;138;1;139;47313
75;47;03;16;314;Trémons;395;10;405;47314
75;47;03;09;315;Trentels;896;26;922;47315
75;47;02;18;316;Varès;671;8;679;47316
75;47;02;18;317;Verteuil-d'Agenais;569;5;574;47317
75;47;04;11;318;Vianne;995;15;1010;47318
75;47;03;12;319;Villebramar;107;3;110;47319
75;47;04;08;320;Villefranche-du-Queyran;389;1;390;47320
75;47;02;07;321;Villeneuve-de-Duras;315;5;320;47321
75;47;03;99;323;Villeneuve-sur-Lot;21742;683;22425;47323
75;47;03;10;324;Villeréal;1283;32;1315;47324
75;47;02;08;325;Villeton;459;6;465;47325
75;47;02;14;326;Virazeil;1677;34;1711;47326
75;47;04;11;327;Xaintrailles;398;11;409;47327
75;47;03;09;328;Saint-Georges;550;19;569;47328
76;48;02;01;001;Albaret-le-Comtal;176;4;180;48001
76;48;02;12;002;Albaret-Sainte-Marie;561;21;582;48002
76;48;02;06;003;Allenc;253;5;258;48003
76;48;02;13;004;Altier;213;10;223;48004
76;48;02;08;005;Antrenas;330;8;338;48005
76;48;02;01;007;Arzenc-d'Apcher;50;0;50;48007
76;48;02;06;008;Arzenc-de-Randon;193;9;202;48008
76;48;02;01;009;Peyre en Aubrac;2291;82;2373;48009
76;48;02;07;010;Auroux;372;6;378;48010
76;48;02;01;012;Les Monts-Verts;354;12;366;48012
76;48;02;06;013;Badaroux;984;41;1025;48013
76;48;02;13;015;Pied-de-Borne;178;12;190;48015
76;48;02;03;016;Balsièges;558;18;576;48016
76;48;02;02;017;Banassac-Canilhac;1067;36;1103;48017
76;48;02;03;018;Barjac;769;18;787;48018
76;48;01;04;019;Barre-des-Cévennes;203;9;212;48019
76;48;01;04;020;Bassurels;65;0;65;48020
76;48;02;13;021;La Bastide-Puylaurent;154;3;157;48021
76;48;02;01;025;Les Bessons;426;25;451;48025
76;48;02;12;026;Blavignac;265;1;266;48026
76;48;02;13;027;Mont Lozère et Goulet;1039;49;1088;48027
76;48;01;13;028;Les Bondons;144;10;154;48028
76;48;02;06;029;Le Born;148;0;148;48029
76;48;02;13;030;Brenoux;387;8;395;48030
76;48;02;01;031;Brion;76;3;79;48031
76;48;02;01;032;Le Buisson;222;6;228;48032
76;48;02;02;034;La Canourgue;2122;98;2220;48034
76;48;01;04;036;Cassagnas;127;2;129;48036
76;48;02;06;037;Chadenet;120;2;122;48037
76;48;02;06;038;Bel-Air-Val-d'Ance;543;7;550;48038
76;48;02;02;039;Chanac;1467;33;1500;48039
76;48;02;07;041;Chastanier;77;0;77;48041
76;48;02;11;042;Chastel-Nouvel;900;35;935;48042
76;48;02;06;043;Châteauneuf-de-Randon;527;8;535;48043
76;48;02;01;044;Chauchailles;86;2;88;48044
76;48;02;06;045;Chaudeyrac;292;11;303;48045
76;48;02;11;046;Chaulhac;67;2;69;48046
76;48;02;07;048;Cheylard-l'Evêque;63;3;66;48048
76;48;01;13;050;Bédouès-Cocurès;451;15;466;48050
76;48;01;04;051;Le Collet-de-Dèze;691;50;741;48051
76;48;02;13;053;Cubières;189;8;197;48053
76;48;02;13;054;Cubiérettes;50;5;55;48054
76;48;02;03;055;Cultures;183;4;187;48055
76;48;02;03;056;Esclanèdes;405;10;415;48056
76;48;02;01;058;La Fage-Montivernoux;155;5;160;48058
76;48;02;01;059;La Fage-Saint-Julien;307;5;312;48059
76;48;01;05;061;Florac Trois Rivières;2067;43;2110;48061
76;48;02;11;063;Fontans;226;3;229;48063
76;48;02;01;064;Fournels;369;9;378;48064
76;48;01;04;065;Fraissinet-de-Fourques;80;0;80;48065
76;48;01;04;067;Gabriac;100;2;102;48067
76;48;02;03;068;Gabrias;158;6;164;48068
76;48;01;05;069;Gatuzières;53;0;53;48069
76;48;02;06;070;Grandrieu;751;15;766;48070
76;48;02;01;071;Grandvals;66;1;67;48071
76;48;02;03;072;Grèzes;233;6;239;48072
76;48;02;01;073;Les Hermaux;95;4;99;48073
76;48;01;05;074;Hures-la-Parade;231;11;242;48074
76;48;01;05;075;Ispagnac;897;27;924;48075
76;48;02;11;077;Julianges;47;2;49;48077
76;48;02;11;079;Lajo;114;3;117;48079
76;48;02;07;080;Langogne;2887;193;3080;48080
76;48;02;13;081;Lanuéjols;316;10;326;48081
76;48;02;06;082;Laubert;99;3;102;48082
76;48;02;11;083;Les Laubies;152;4;156;48083
76;48;02;02;085;Laval-du-Tarn;94;4;98;48085
76;48;02;07;086;Luc;209;5;214;48086
76;48;02;01;087;Prinsuéjols-Malbouzon;265;10;275;48087
76;48;01;02;088;La Malène;136;5;141;48088
76;48;02;11;089;Le Malzieu-Forain;493;11;504;48089
76;48;02;11;090;Le Malzieu-Ville;728;14;742;48090
76;48;02;01;091;Marchastel;50;3;53;48091
76;48;02;08;092;Marvejols;4684;244;4928;48092
76;48;01;02;094;Massegros Causses Gorges;960;27;987;48094
76;48;02;99;095;Mende;12318;829;13147;48095
76;48;01;05;096;Meyrueis;807;119;926;48096
76;48;01;04;097;Moissac-Vallée-Française;216;9;225;48097
76;48;01;04;098;Molezon;96;4;100;48098
76;48;02;03;099;Bourgs sur Colagne;2092;48;2140;48099
76;48;02;06;100;Montbel;117;3;120;48100
76;48;02;03;103;Montrodat;1193;71;1264;48103
76;48;02;01;104;Nasbinals;557;32;589;48104
76;48;02;07;105;Naussac-Fontanes;369;18;387;48105
76;48;02;01;106;Noalhac;96;7;103;48106
76;48;02;03;107;Palhers;179;7;186;48107
76;48;02;06;108;La Panouse;76;2;78;48108
76;48;02;11;110;Paulhac-en-Margeride;101;5;106;48110
76;48;02;06;111;Pelouse;237;8;245;48111
76;48;02;06;112;Pierrefiche;164;5;169;48112
76;48;01;04;115;Le Pompidou;159;7;166;48115
76;48;01;13;116;Pont de Montvert - Sud Mont Lozère;562;24;586;48116
76;48;02;13;117;Pourcharesses;121;2;123;48117
76;48;02;13;119;Prévenchères;250;13;263;48119
76;48;02;12;121;Prunières;239;10;249;48121
76;48;02;01;123;Recoules-d'Aubrac;172;6;178;48123
76;48;02;08;124;Recoules-de-Fumas;104;0;104;48124
76;48;02;08;126;Lachamp-Ribennes;358;12;370;48126
76;48;02;11;127;Monts-de-Randon;1291;21;1312;48127
76;48;02;12;128;Rimeize;593;21;614;48128
76;48;02;07;129;Rocles;229;6;235;48129
76;48;01;04;130;Rousses;124;1;125;48130
76;48;01;05;131;Le Rozier;133;7;140;48131
76;48;02;11;132;Saint-Alban-sur-Limagnole;1379;33;1412;48132
76;48;02;13;135;Saint-André-Capcèze;182;0;182;48135
76;48;01;04;136;Saint-André-de-Lancize;150;2;152;48136
76;48;02;13;137;Saint-Bauzile;624;25;649;48137
76;48;02;03;138;Saint-Bonnet-de-Chirac;67;2;69;48138
76;48;02;07;139;Saint Bonnet-Laval;251;2;253;48139
76;48;02;12;140;Saint-Chély-d'Apcher;4211;589;4800;48140
76;48;01;05;141;Mas-Saint-Chély;107;6;113;48141
76;48;01;04;144;Sainte-Croix-Vallée-Française;269;9;278;48144
76;48;02;11;145;Saint-Denis-en-Margeride;156;7;163;48145
76;48;01;05;146;Gorges du Tarn Causses;909;33;942;48146
76;48;02;13;147;Saint-Etienne-du-Valdonnez;643;51;694;48147
76;48;01;04;148;Saint-Etienne-Vallée-Française;505;27;532;48148
76;48;02;11;149;Sainte-Eulalie;36;2;38;48149
76;48;02;07;150;Saint-Flour-de-Mercoire;188;14;202;48150
76;48;02;06;151;Saint-Frézal-d'Albuges;63;3;66;48151
76;48;01;04;152;Ventalon en Cévennes;267;5;272;48152
76;48;02;11;153;Saint-Gal;88;5;93;48153
76;48;01;04;155;Saint-Germain-de-Calberte;465;6;471;48155
76;48;02;03;156;Saint-Germain-du-Teil;870;23;893;48156
76;48;02;06;157;Sainte-Hélène;107;4;111;48157
76;48;01;04;158;Saint-Hilaire-de-Lavit;104;4;108;48158
76;48;02;06;160;Saint-Jean-la-Fouillouse;156;7;163;48160
76;48;02;01;161;Saint-Juéry;69;2;71;48161
76;48;01;04;163;Saint-Julien-des-Points;114;3;117;48163
76;48;02;01;165;Saint-Laurent-de-Muret;186;10;196;48165
76;48;01;04;166;Cans et Cévennes;289;11;300;48166
76;48;02;01;167;Saint-Laurent-de-Veyrès;37;1;38;48167
76;48;02;08;168;Saint-Léger-de-Peyre;190;5;195;48168
76;48;02;11;169;Saint-Léger-du-Malzieu;210;11;221;48169
76;48;01;04;170;Saint-Martin-de-Boubaux;198;5;203;48170
76;48;01;04;171;Saint-Martin-de-Lansuscle;191;2;193;48171
76;48;01;04;173;Saint-Michel-de-Dèze;230;3;233;48173
76;48;02;06;174;Saint-Paul-le-Froid;139;3;142;48174
76;48;02;01;175;Saint-Pierre-de-Nogaret;176;10;186;48175
76;48;01;05;176;Saint-Pierre-des-Tripiers;90;4;94;48176
76;48;02;12;177;Saint-Pierre-le-Vieux;322;9;331;48177
76;48;01;04;178;Saint-Privat-de-Vallongue;222;6;228;48178
76;48;02;11;179;Saint-Privat-du-Fau;113;2;115;48179
76;48;02;02;181;Saint-Saturnin;63;4;67;48181
76;48;02;06;182;Saint-Sauveur-de-Ginestoux;58;2;60;48182
76;48;02;03;185;Les Salelles;165;5;170;48185
76;48;02;01;187;Les Salces;101;1;102;48187
76;48;02;11;188;Serverette;244;5;249;48188
76;48;02;01;190;Termes;215;8;223;48190
76;48;02;02;191;La Tieule;94;3;97;48191
76;48;02;01;192;Trélans;92;2;94;48192
76;48;01;04;193;Vebron;214;1;215;48193
76;48;01;13;194;Vialas;424;48;472;48194
76;48;02;13;198;Villefort;548;12;560;48198
52;49;03;15;002;Allonnes;2975;53;3028;49002
52;49;03;14;003;Tuffalun;1752;37;1789;49003
52;49;01;98;007;Angers;155850;3080;158930;49007
52;49;04;20;008;Angrie;931;25;956;49008
52;49;03;14;009;Antoigné;460;4;464;49009
52;49;04;20;010;Armaillé;319;5;324;49010
52;49;03;19;011;Artannes-sur-Thouet;428;18;446;49011
52;49;01;11;012;Aubigné-sur-Layon;368;11;379;49012
52;49;01;04;015;Avrillé;14443;357;14800;49015
52;49;01;21;017;Baracé;604;6;610;49017
52;49;03;08;018;Baugé-en-Anjou;11829;261;12090;49018
52;49;01;03;020;Beaucouzé;5439;107;5546;49020
52;49;03;08;021;Beaufort-en-Anjou;7229;154;7383;49021
52;49;01;11;022;Beaulieu-sur-Layon;1368;29;1397;49022
52;49;02;09;023;Beaupréau-en-Mauges;23419;716;24135;49023
52;49;04;10;026;Bécon-les-Granits;2789;90;2879;49026
52;49;02;09;027;Bégrolles-en-Mauges;2107;42;2149;49027
52;49;01;03;028;Béhuard;125;6;131;49028
52;49;01;17;029;Blaison-Saint-Sulpice;1293;28;1321;49029
52;49;03;15;030;Blou;975;32;1007;49030
52;49;01;02;035;Bouchemaine;6774;141;6915;49035
52;49;04;20;036;Bouillé-Ménard;751;20;771;49036
52;49;04;20;038;Bourg-l'Evêque;240;5;245;49038
52;49;03;15;041;Brain-sur-Allonnes;2039;35;2074;49041
52;49;03;15;045;La Breille-les-Pins;600;14;614;49045
52;49;01;05;048;Briollay;3084;41;3125;49048
52;49;01;86;050;Brissac Loire Aubance;10851;274;11125;49050
52;49;03;14;053;Brossay;350;4;354;49053
52;49;04;20;054;Candé;2824;62;2886;49054
52;49;01;05;055;Cantenay-Epinard;2317;35;2352;49055
52;49;04;20;056;Carbay;263;6;269;49056
52;49;02;13;057;Cernusson;337;6;343;49057
52;49;02;13;058;Les Cerqueux;877;9;886;49058
52;49;03;14;060;Bellevigne-les-Châteaux;3482;80;3562;49060
52;49;04;20;061;Challain-la-Potherie;797;19;816;49061
52;49;01;10;063;Chalonnes-sur-Loire;6518;175;6693;49063
52;49;04;21;064;Chambellay;397;12;409;49064
52;49;04;21;067;Chenillé-Champteussé;342;8;350;49067
52;49;01;10;068;Champtocé-sur-Loire;1864;31;1895;49068
52;49;02;16;069;Orée d'Anjou;16429;277;16706;49069
52;49;02;13;070;Chanteloup-les-Bois;694;10;704;49070
52;49;01;06;076;La Chapelle-Saint-Laud;763;7;770;49076
52;49;04;21;080;Les Hauts-d'Anjou;8759;185;8944;49080
52;49;01;10;082;Chaudefonds-sur-Layon;941;17;958;49082
52;49;01;11;086;Terranjou;3994;84;4078;49086
52;49;04;20;089;Chazé-sur-Argos;1053;28;1081;49089
52;49;01;21;090;Cheffes;974;12;986;49090
52;49;02;11;092;Chemillé-en-Anjou;20828;604;21432;49092
52;49;02;99;099;Cholet;54037;1942;55979;49099
52;49;03;14;100;Cizay-la-Madeleine;469;17;486;49100
52;49;02;13;102;Cléré-sur-Layon;337;5;342;49102
52;49;01;06;107;Cornillé-les-Caves;467;16;483;49107
52;49;02;13;109;Coron;1580;30;1610;49109
52;49;01;06;110;Corzé;1886;32;1918;49110
52;49;03;14;112;Le Coudray-Macouard;947;28;975;49112
52;49;03;14;113;Courchamps;519;9;528;49113
52;49;03;15;114;Courléon;145;4;149;49114
52;49;01;10;120;Denée;1384;23;1407;49120
52;49;03;14;121;Dénezé-sous-Doué;480;9;489;49121
52;49;03;19;123;Distré;1732;55;1787;49123
52;49;03;14;125;Doué-en-Anjou;11119;257;11376;49125
52;49;01;21;127;Durtal;3358;75;3433;49127
52;49;01;05;129;Ecouflant;4394;58;4452;49129
52;49;01;05;130;Ecuillé;667;7;674;49130
52;49;03;14;131;Epieds;734;7;741;49131
52;49;01;21;132;Etriché;1547;17;1564;49132
52;49;01;05;135;Feneu;2192;38;2230;49135
52;49;03;08;138;Les Bois d'Anjou;2601;58;2659;49138
52;49;03;19;140;Fontevraud-l'Abbaye;1528;25;1553;49140
52;49;04;21;155;Grez-Neuville;1432;40;1472;49155
52;49;01;10;160;Ingrandes-Le Fresne sur Loire;2665;58;2723;49160
52;49;04;21;161;La Jaille-Yvon;334;6;340;49161
52;49;01;06;163;Jarzé Villages;2752;28;2780;49163
52;49;01;17;167;Les Garennes sur Loire;4567;111;4678;49167
52;49;04;21;170;Juvardeil;807;12;819;49170
52;49;03;15;171;La Lande-Chasles;123;0;123;49171
52;49;01;06;174;Huillé-Lézigné;1315;21;1336;49174
52;49;04;21;176;Le Lion-d'Angers;5023;76;5099;49176
52;49;04;20;178;Loiré;876;21;897;49178
52;49;03;15;180;Longué-Jumelles;6831;121;6952;49180
52;49;03;14;182;Louresse-Rochemenier;880;16;896;49182
52;49;04;10;183;Val d'Erdre-Auxence;4903;84;4987;49183
52;49;01;06;188;Marcé;837;15;852;49188
52;49;02;13;192;Maulévrier;3203;78;3281;49192
52;49;02;18;193;Le May-sur-Evre;3820;90;3910;49193
52;49;03;08;194;Mazé-Milon;5925;105;6030;49194
52;49;02;13;195;Mazières-en-Mauges;1256;29;1285;49195
52;49;01;89;200;Longuenée-en-Anjou;6306;171;6477;49200
52;49;03;07;201;La Ménitré;2049;35;2084;49201
52;49;04;21;205;Miré;973;11;984;49205
52;49;01;21;209;Montigné-lès-Rairies;440;3;443;49209
52;49;02;13;211;Montilliers;1215;30;1245;49211
52;49;01;04;214;Montreuil-Juigné;7632;150;7782;49214
52;49;03;14;215;Montreuil-Bellay;3726;250;3976;49215
52;49;01;06;216;Montreuil-sur-Loir;590;6;596;49216
52;49;04;21;217;Montreuil-sur-Maine;775;10;785;49217
52;49;02;09;218;Montrevault-sur-Evre;15668;317;15985;49218
52;49;03;19;219;Montsoreau;431;6;437;49219
52;49;01;21;220;Morannes sur Sarthe-Daumeray;3666;56;3722;49220
52;49;03;15;221;Mouliherne;820;23;843;49221
52;49;01;11;222;Mozé-sur-Louet;2013;45;2058;49222
52;49;01;17;223;Mûrs-Erigné;5660;101;5761;49223
52;49;03;15;224;Neuillé;991;10;1001;49224
52;49;03;08;228;Noyant-Villages;5546;167;5713;49228
52;49;02;13;231;Nuaillé;1454;37;1491;49231
52;49;03;19;235;Parnay;424;15;439;49235
52;49;02;13;236;Passavant-sur-Layon;125;5;130;49236
52;49;03;08;237;La Pellerine;132;2;134;49237
52;49;02;13;240;La Plaine;997;31;1028;49240
52;49;01;07;241;Le Plessis-Grammoire;2552;60;2612;49241
52;49;02;16;244;Mauges-sur-Loire;17924;475;18399;49244
52;49;01;17;246;Les Ponts-de-Cé;12819;541;13360;49246
52;49;01;10;247;La Possonnière;2447;42;2489;49247
52;49;04;20;248;Ombrée d'Anjou;8970;251;9221;49248
52;49;03;14;253;Le Puy-Notre-Dame;1186;21;1207;49253
52;49;01;21;257;Les Rairies;1028;16;1044;49257
52;49;01;10;259;Rochefort-sur-Loire;2323;59;2382;49259
52;49;02;18;260;La Romagne;1947;86;2033;49260
52;49;03;85;261;Gennes-Val-de-Loire;8570;169;8739;49261
52;49;03;19;262;Rou-Marson;652;9;661;49262
52;49;04;10;266;Saint-Augustin-des-Bois;1227;29;1256;49266
52;49;01;06;267;Saint-Barthélemy-d'Anjou;9210;228;9438;49267
52;49;02;18;269;Saint-Christophe-du-Bois;2794;60;2854;49269
52;49;01;03;271;Saint-Clément-de-la-Place;2098;28;2126;49271
52;49;03;15;272;Saint-Clément-des-Levées;1086;20;1106;49272
52;49;01;02;278;Sainte-Gemmes-sur-Loire;3456;254;3710;49278
52;49;01;10;283;Saint-Georges-sur-Loire;3665;39;3704;49283
52;49;01;10;284;Saint-Germain-des-Prés;1406;23;1429;49284
52;49;01;17;288;Saint-Jean-de-la-Croix;226;6;232;49288
52;49;03;14;291;Saint-Just-sur-Dive;376;5;381;49291
52;49;01;11;292;Val-du-Layon;3411;48;3459;49292
52;49;01;03;294;Saint-Lambert-la-Potherie;2924;30;2954;49294
52;49;01;03;298;Saint-Léger-de-Linières;3694;63;3757;49298
52;49;02;18;299;Saint-Léger-sous-Cholet;3018;70;3088;49299
52;49;02;18;301;Sèvremoine;25162;553;25715;49301
52;49;03;14;302;Saint-Macaire-du-Bois;451;5;456;49302
52;49;01;03;306;Saint-Martin-du-Fouilloux;1661;36;1697;49306
52;49;01;07;307;Loire-Authion;15902;575;16477;49307
52;49;01;17;308;Saint-Melaine-sur-Aubance;2127;54;2181;49308
52;49;02;13;310;Saint-Paul-du-Bois;597;19;616;49310
52;49;03;15;311;Saint-Philbert-du-Peuple;1323;28;1351;49311
52;49;04;10;321;Saint-Sigismond;387;8;395;49321
52;49;01;06;323;Verrières-en-Anjou;7520;297;7817;49323
52;49;01;07;326;Sarrigné;812;19;831;49326
52;49;03;19;328;Saumur;26467;982;27449;49328
52;49;01;03;329;Savennières;1336;50;1386;49329
52;49;04;21;330;Sceaux-d'Anjou;1180;18;1198;49330
52;49;04;20;331;Segré-en-Anjou Bleu;17462;833;18295;49331
52;49;02;18;332;La Séguinière;4192;112;4304;49332
52;49;01;06;333;Seiches-sur-le-Loir;2912;60;2972;49333
52;49;01;06;334;Sermaise;332;5;337;49334
52;49;02;13;336;Somloire;883;16;899;49336
52;49;01;17;338;Soulaines-sur-Aubance;1428;28;1456;49338
52;49;01;05;339;Soulaire-et-Bourg;1492;39;1531;49339
52;49;03;19;341;Souzay-Champigny;748;23;771;49341
52;49;02;13;343;La Tessoualle;3189;73;3262;49343
52;49;04;21;344;Thorigné-d'Anjou;1235;25;1260;49344
52;49;01;11;345;Bellevigne-en-Layon;5751;115;5866;49345
52;49;01;21;347;Tiercé;4432;73;4505;49347
52;49;02;13;352;Toutlemonde;1322;33;1355;49352
52;49;01;07;353;Trélazé;14961;168;15129;49353
52;49;02;13;355;Trémentines;3088;53;3141;49355
52;49;03;19;358;Turquant;571;14;585;49358
52;49;03;14;359;Les Ulmes;577;15;592;49359
52;49;03;15;361;Varennes-sur-Loire;1829;37;1866;49361
52;49;03;19;362;Varrains;1218;50;1268;49362
52;49;03;14;364;Vaudelnay;1131;22;1153;49364
52;49;04;87;367;Erdre-en-Anjou;5739;84;5823;49367
52;49;03;15;368;Vernantes;1993;39;2032;49368
52;49;03;15;369;Vernoil-le-Fourrier;1270;21;1291;49369
52;49;03;19;370;Verrie;480;7;487;49370
52;49;02;13;371;Vezins;1727;29;1756;49371
52;49;02;13;373;Lys-Haut-Layon;7789;177;7966;49373
52;49;03;15;374;Villebernier;1437;32;1469;49374
52;49;01;06;377;Rives-du-Loir-en-Anjou;5651;94;5745;49377
52;49;03;15;378;Vivy;2537;35;2572;49378
52;49;02;13;381;Yzernay;1813;30;1843;49381
28;50;04;22;002;Agneaux;4153;439;4592;50002
28;50;03;01;003;Agon-Coutainville;2796;95;2891;50003
28;50;04;18;004;Airel;549;3;552;50004
28;50;04;18;006;Amigny;154;5;159;50006
28;50;01;03;008;Anctoville-sur-Boscq;443;18;461;50008
28;50;02;26;013;Anneville-en-Saire;386;9;395;50013
28;50;03;20;015;Annoville;651;13;664;50015
28;50;03;05;016;Appeville;182;2;184;50016
28;50;01;19;019;Aucey-la-Plaine;419;6;425;50019
28;50;02;05;021;Audouville-la-Hubert;75;1;76;50021
28;50;02;26;022;Aumeville-Lestre;112;3;115;50022
28;50;04;05;023;Auvers;676;10;686;50023
28;50;03;01;024;Auxais;170;3;173;50024
28;50;01;84;025;Avranches;10264;555;10819;50025
28;50;02;25;026;Azeville;80;1;81;50026
28;50;01;02;027;Bacilly;956;27;983;50027
28;50;03;20;028;La Baleine;101;3;104;50028
28;50;01;16;029;Barenton;1175;65;1240;50029
28;50;02;26;030;Barfleur;559;8;567;50030
28;50;02;17;031;Barneville-Carteret;2239;56;2295;50031
28;50;04;23;032;La Barre-de-Semilly;1035;40;1075;50032
28;50;02;17;033;Baubigny;141;4;145;50033
28;50;04;23;034;Baudre;544;18;562;50034
28;50;03;05;036;Baupte;429;8;437;50036
28;50;01;03;038;Beauchamps;426;11;437;50038
28;50;04;09;039;Beaucoudray;126;4;130;50039
28;50;01;16;040;Beauficel;123;6;129;50040
28;50;02;14;041;La Hague;11173;336;11509;50041
28;50;01;19;042;Beauvoir;433;5;438;50042
28;50;03;20;044;Belval;321;2;323;50044
28;50;02;17;045;Benoîtville;608;23;631;50045
28;50;04;18;046;Bérigny;427;6;433;50046
28;50;04;27;048;Beslon;556;9;565;50048
28;50;02;04;049;Besneville;660;19;679;50049
28;50;04;09;050;Beuvrigny;138;0;138;50050
28;50;02;05;052;Beuzeville-la-Bastille;143;2;145;50052
28;50;04;09;054;Biéville;191;4;195;50054
28;50;02;04;055;Biniville;113;2;115;50055
28;50;03;01;058;Blainville-sur-Mer;1620;45;1665;50058
28;50;02;05;059;Blosville;324;1;325;50059
28;50;04;27;060;La Bloutière;436;8;444;50060
28;50;01;27;062;Boisyvon;116;0;116;50062
28;50;02;04;064;La Bonneville;178;7;185;50064
28;50;01;02;066;Jullouville;2367;79;2446;50066
28;50;04;27;069;Bourguenolles;345;12;357;50069
28;50;02;05;070;Boutteville;74;5;79;50070
28;50;03;10;072;Brainville;212;6;218;50072
28;50;01;15;074;Brécey;2139;146;2285;50074
28;50;01;03;076;Bréhal;3455;87;3542;50076
28;50;02;24;077;Bretteville;1037;44;1081;50077
28;50;03;11;078;Bretteville-sur-Ay;408;7;415;50078
28;50;02;04;079;Breuville;409;9;418;50079
28;50;01;03;081;Bréville-sur-Mer;771;29;800;50081
28;50;02;04;082;Bricquebec-en-Cotentin;5826;150;5976;50082
28;50;02;17;083;Bricquebosq;600;7;607;50083
28;50;03;10;084;Bricqueville-la-Blouette;544;18;562;50084
28;50;01;03;085;Bricqueville-sur-Mer;1223;41;1264;50085
28;50;02;26;086;Brillevast;324;5;329;50086
28;50;02;25;087;Brix;2155;53;2208;50087
28;50;01;16;088;Brouains;135;2;137;50088
28;50;01;21;090;Buais-Les-Monts;611;10;621;50090
28;50;03;10;092;Cambernon;704;16;720;50092
28;50;03;20;093;Cametours;419;5;424;50093
28;50;03;10;094;Camprond;411;9;420;50094
28;50;04;23;095;Canisy;1766;57;1823;50095
28;50;02;26;096;Canteloup;209;8;217;50096
28;50;02;11;097;Canville-la-Rocque;121;2;123;50097
28;50;04;23;098;Carantilly;622;15;637;50098
28;50;04;83;099;Carentan-les-Marais;10052;181;10233;50099
28;50;02;26;101;Carneville;235;6;241;50101
28;50;01;02;102;Carolles;748;16;764;50102
28;50;02;04;105;Catteville;97;5;102;50105
28;50;04;18;106;Cavigny;268;2;270;50106
28;50;01;19;108;Céaux;414;12;426;50108
28;50;01;03;109;Cérences;1779;39;1818;50109
28;50;04;18;110;Cerisy-la-Forêt;1036;19;1055;50110
28;50;03;20;111;Cerisy-la-Salle;1004;16;1020;50111
28;50;01;15;112;La Chaise-Baudouin;465;7;472;50112
28;50;01;03;115;Le Grippon;383;11;394;50115
28;50;01;02;117;Champeaux;351;12;363;50117
28;50;04;27;118;Champrepus;328;6;334;50118
28;50;01;03;120;Chanteloup;359;4;363;50120
28;50;01;27;121;La Chapelle-Cécelin;244;4;248;50121
28;50;01;15;124;La Chapelle-Urée;165;3;168;50124
28;50;01;02;126;Chavoy;133;7;140;50126
28;50;02;98;129;Cherbourg-en-Cotentin;78549;2363;80912;50129
28;50;04;27;130;Chérencé-le-Héron;427;6;433;50130
28;50;02;26;135;Clitourps;226;3;229;50135
28;50;04;27;137;La Colombe;627;14;641;50137
28;50;02;04;138;Colomby;550;10;560;50138
28;50;04;09;139;Condé-sur-Vire;4044;161;4205;50139
28;50;02;26;142;Vicq-sur-Mer;1054;13;1067;50142
28;50;01;03;143;Coudeville-sur-Mer;859;34;893;50143
28;50;01;27;144;Coulouvray-Boisbenâtre;540;5;545;50144
28;50;03;10;145;Courcy;592;13;605;50145
28;50;01;19;146;Courtils;235;2;237;50146
28;50;03;10;147;Coutances;8408;1173;9581;50147
28;50;04;18;148;Couvains;544;4;548;50148
28;50;02;08;149;Couville;1182;18;1200;50149
28;50;02;26;150;Crasville;228;3;231;50150
28;50;03;11;151;Créances;2093;29;2122;50151
28;50;01;15;152;Les Cresnays;225;3;228;50152
28;50;01;19;155;Crollon;298;13;311;50155
28;50;02;04;156;Crosville-sur-Douve;66;0;66;50156
28;50;01;15;158;Cuves;280;9;289;50158
28;50;04;23;159;Dangy;682;15;697;50159
28;50;04;18;161;Le Dézert;599;9;608;50161
28;50;02;24;162;Digosville;1598;44;1642;50162
28;50;04;09;164;Domjean;1006;26;1032;50164
28;50;01;13;165;Donville-les-Bains;3109;74;3183;50165
28;50;03;11;166;Doville;327;15;342;50166
28;50;01;02;167;Dragey-Ronthon;805;21;826;50167
28;50;01;19;168;Ducey-Les Chéris;2799;61;2860;50168
28;50;02;25;169;Ecausseville;103;1;104;50169
28;50;02;25;172;Emondeville;350;8;358;50172
28;50;01;03;174;Equilly;196;9;205;50174
28;50;02;25;175;Eroudeville;196;8;204;50175
28;50;02;04;176;L'Etang-Bertrand;346;14;360;50176
28;50;02;04;177;Etienville;372;6;378;50177
28;50;02;26;178;Fermanville;1263;24;1287;50178
28;50;03;01;181;Feugères;330;8;338;50181
28;50;03;11;182;La Feuillie;287;8;295;50182
28;50;02;17;183;Fierville-les-Mines;346;6;352;50183
28;50;02;17;184;Flamanville;1766;22;1788;50184
28;50;04;27;185;Fleury;1045;24;1069;50185
28;50;02;25;186;Flottemanville;218;8;226;50186
28;50;01;03;188;Folligny;1084;26;1110;50188
28;50;02;25;190;Fontenay-sur-Mer;171;3;174;50190
28;50;04;09;192;Fourneaux;130;0;130;50192
28;50;01;16;193;Le Fresne-Poret;218;3;221;50193
28;50;02;25;194;Fresville;370;8;378;50194
28;50;01;16;195;Gathemo;254;2;256;50195
28;50;02;26;196;Gatteville-le-Phare;488;20;508;50196
28;50;03;20;197;Gavray-sur-Sienne;1956;25;1981;50197
28;50;03;01;198;Geffosses;471;11;482;50198
28;50;01;02;199;Genêts;447;4;451;50199
28;50;01;16;200;Ger;807;8;815;50200
28;50;01;15;205;La Godefroy;279;7;286;50205
28;50;02;04;207;Golleville;175;2;177;50207
28;50;03;01;208;Gonfreville;157;1;158;50208
28;50;02;26;209;Gonneville-Le Theil;1511;44;1555;50209
28;50;03;01;210;Gorges;342;8;350;50210
28;50;04;09;214;Gouvets;275;6;281;50214
28;50;03;01;215;Gouville-sur-Mer;3229;88;3317;50215
28;50;04;18;216;Graignes-Mesnil-Angot;805;91;896;50216
28;50;01;15;217;Le Grand-Celland;601;11;612;50217
28;50;01;13;218;Granville;12513;674;13187;50218
28;50;03;10;219;Gratot;667;12;679;50219
28;50;03;20;221;Grimesnil;59;2;61;50221
28;50;02;17;222;Grosville;785;21;806;50222
28;50;04;27;225;Le Guislain;143;1;144;50225
28;50;02;25;227;Le Ham;310;5;315;50227
28;50;03;20;228;Hambye;1105;32;1137;50228
28;50;01;21;229;Hamelin;87;1;88;50229
28;50;02;08;230;Hardinvast;883;34;917;50230
28;50;03;20;231;Hauteville-sur-Mer;686;23;709;50231
28;50;03;01;232;Hauteville-la-Guichard;473;18;491;50232
28;50;02;04;233;Hautteville-Bocage;159;5;164;50233
28;50;04;27;234;La Haye-Bellefond;77;0;77;50234
28;50;02;17;235;La Haye-d'Ectot;271;5;276;50235
28;50;03;11;236;La Haye;3971;118;4089;50236
28;50;01;03;237;La Haye-Pesnel;1258;25;1283;50237
28;50;02;17;238;Héauville;457;6;463;50238
28;50;04;22;239;Thèreval;1788;45;1833;50239
28;50;02;17;240;Helleville;547;8;555;50240
28;50;02;25;241;Hémevez;181;5;186;50241
28;50;03;10;243;Heugueville-sur-Sienne;499;16;515;50243
28;50;02;05;246;Hiesville;70;1;71;50246
28;50;01;03;247;Hocquigny;188;5;193;50247
28;50;02;25;251;Huberville;365;10;375;50251
28;50;01;03;252;Hudimesnil;908;16;924;50252
28;50;01;19;253;Huisnes-sur-Mer;170;7;177;50253
28;50;01;15;256;Isigny-le-Buat;3221;102;3323;50256
28;50;02;25;258;Joganville;112;3;115;50258
28;50;01;19;259;Juilley;641;26;667;50259
28;50;01;15;260;Juvigny les Vallées;1689;41;1730;50260
28;50;04;09;261;Lamberville;169;2;171;50261
28;50;04;27;262;La Lande-d'Airou;530;6;536;50262
28;50;01;21;263;Lapenty;364;10;374;50263
28;50;03;11;265;Laulne;196;2;198;50265
28;50;03;20;266;Lengronne;413;10;423;50266
28;50;03;11;267;Lessay;2236;55;2291;50267
28;50;02;25;268;Lestre;249;5;254;50268
28;50;02;05;269;Liesville-sur-Douve;206;6;212;50269
28;50;02;25;270;Lieusaint;399;12;411;50270
28;50;01;15;271;Lingeard;86;1;87;50271
28;50;03;20;272;Lingreville;1019;19;1038;50272
28;50;03;11;273;Montsenelle;1412;20;1432;50273
28;50;01;21;274;Les Loges-Marchis;1012;153;1165;50274
28;50;01;15;275;Les Loges-sur-Brécey;125;7;132;50275
28;50;01;02;276;Lolif;583;19;602;50276
28;50;01;03;277;Longueville;590;15;605;50277
28;50;01;03;278;Le Loreur;283;6;289;50278
28;50;04;22;279;Le Lorey;600;15;615;50279
28;50;01;03;281;La Lucerne-d'Outremer;772;19;791;50281
28;50;01;03;282;Le Luot;298;10;308;50282
28;50;04;23;283;La Luzerne;74;1;75;50283
28;50;02;04;285;Magneville;313;4;317;50285
28;50;01;02;288;Marcey-les-Grèves;1294;29;1323;50288
28;50;03;01;289;Marchésieux;720;12;732;50289
28;50;01;19;290;Marcilly;324;7;331;50290
28;50;04;27;291;Margueray;121;4;125;50291
28;50;04;22;292;Marigny-Le-Lozon;2687;58;2745;50292
28;50;02;08;294;Martinvast;1305;38;1343;50294
28;50;04;27;295;Maupertuis;143;2;145;50295
28;50;02;26;296;Maupertus-sur-Mer;220;9;229;50296
28;50;04;18;297;La Meauffe;1019;30;1049;50297
28;50;04;05;298;Méautis;646;13;659;50298
28;50;02;17;299;Le Mesnil;220;7;227;50299
28;50;01;15;300;Le Mesnil-Adelée;164;7;171;50300
28;50;04;22;302;Le Mesnil-Amey;286;7;293;50302
28;50;01;03;304;Le Mesnil-Aubert;195;7;202;50304
28;50;02;24;305;Le Mesnil-au-Val;733;18;751;50305
28;50;04;22;310;Le Mesnil-Eury;170;4;174;50310
28;50;03;20;311;Le Mesnil-Garnier;226;8;234;50311
28;50;01;15;312;Le Mesnil-Gilbert;134;4;138;50312
28;50;01;21;315;Le Mesnillard;248;8;256;50315
28;50;01;19;317;Le Mesnil-Ozenne;272;3;275;50317
28;50;04;18;321;Le Mesnil-Rouxelin;499;21;520;50321
28;50;04;18;324;Le Mesnil-Véneron;112;2;114;50324
28;50;03;20;326;Le Mesnil-Villeman;235;1;236;50326
28;50;01;03;327;La Meurdraquière;186;6;192;50327
28;50;03;11;328;Millières;776;14;790;50328
28;50;02;17;332;Les Moitiers-d'Allonne;711;15;726;50332
28;50;04;27;334;Montabot;276;3;279;50334
28;50;02;25;335;Montaigu-la-Brisette;501;9;510;50335
28;50;03;20;336;Montaigu-les-Bois;227;3;230;50336
28;50;04;27;338;Montbray;299;4;303;50338
28;50;03;01;340;Montcuit;189;4;193;50340
28;50;02;25;341;Montebourg;2106;104;2210;50341
28;50;02;26;342;Montfarville;802;27;829;50342
28;50;03;10;345;Monthuchon;691;20;711;50345
28;50;01;21;347;Montjoie-Saint-Martin;234;4;238;50347
28;50;03;20;349;Montmartin-sur-Mer;1374;35;1409;50349
28;50;03;20;350;Montpinchon;519;9;528;50350
28;50;04;09;351;Montrabot;92;2;94;50351
28;50;04;22;352;Montreuil-sur-Lozon;334;7;341;50352
28;50;01;19;353;Le Mont-Saint-Michel;29;0;29;50353
28;50;04;18;356;Moon-sur-Elle;804;20;824;50356
28;50;04;27;357;Morigny;72;1;73;50357
28;50;01;16;359;Mortain-Bocage;2929;265;3194;50359
28;50;02;04;360;Morville;276;12;288;50360
28;50;01;03;361;La Mouche;241;5;246;50361
28;50;01;21;362;Moulines;285;5;290;50362
28;50;04;09;363;Moyon Villages;1451;35;1486;50363
28;50;03;01;364;Muneville-le-Bingard;707;8;715;50364
28;50;01;03;365;Muneville-sur-Mer;489;10;499;50365
28;50;03;01;368;Nay;68;2;70;50368
28;50;02;04;369;Négreville;819;25;844;50369
28;50;02;04;370;Néhou;614;4;618;50370
28;50;01;16;371;Le Neufbourg;407;12;419;50371
28;50;03;11;372;Neufmesnil;180;3;183;50372
28;50;02;05;373;Neuville-au-Plain;89;4;93;50373
28;50;02;04;374;Neuville-en-Beaumont;27;1;28;50374
28;50;03;10;376;Nicorps;388;13;401;50376
28;50;03;20;378;Notre-Dame-de-Cenilly;634;9;643;50378
28;50;01;15;379;Notre-Dame-de-Livoye;159;3;162;50379
28;50;02;08;382;Nouainville;633;19;652;50382
28;50;02;26;384;Octeville-l'Avenel;221;3;224;50384
28;50;02;04;387;Orglandes;360;6;366;50387
28;50;03;10;388;Orval sur Sienne;1147;38;1185;50388
28;50;03;20;389;Ouville;443;12;455;50389
28;50;02;25;390;Ozeville;154;3;157;50390
28;50;01;21;391;Grandparigny;2643;92;2735;50391
28;50;04;27;393;Percy-en-Normandie;2600;106;2706;50393
28;50;03;01;394;Périers;2256;31;2287;50394
28;50;02;26;395;La Pernelle;271;4;275;50395
28;50;01;16;397;Perriers-en-Beauficel;210;6;216;50397
28;50;04;09;398;Le Perron;201;2;203;50398
28;50;01;15;399;Le Petit-Celland;178;4;182;50399
28;50;02;05;400;Picauville;3263;37;3300;50400
28;50;02;17;401;Pierreville;739;13;752;50401
28;50;02;17;402;Les Pieux;3220;88;3308;50402
28;50;03;11;403;Pirou;1432;37;1469;50403
28;50;03;11;405;Le Plessis-Lastelle;239;8;247;50405
28;50;01;19;407;Poilley;929;37;966;50407
28;50;01;19;408;Pontaubault;569;13;582;50408
28;50;04;18;409;Pont-Hébert;1924;210;2134;50409
28;50;01;19;410;Pontorson;4318;78;4396;50410
28;50;01;02;411;Ponts;678;15;693;50411
28;50;02;17;412;Port-Bail-sur-Mer;2556;68;2624;50412
28;50;01;19;413;Précey;574;6;580;50413
28;50;02;26;417;Quettehou;1779;30;1809;50417
28;50;03;20;419;Quettreville-sur-Sienne;3199;65;3264;50419
28;50;04;23;420;Quibou;865;23;888;50420
28;50;02;25;421;Quinéville;267;6;273;50421
28;50;03;01;422;Raids;193;0;193;50422
28;50;04;18;423;Rampan;201;6;207;50423
28;50;02;04;425;Rauville-la-Bigot;1116;26;1142;50425
28;50;02;04;426;Rauville-la-Place;370;6;376;50426
28;50;01;15;428;Reffuveille;513;4;517;50428
28;50;03;10;429;Regnéville-sur-Mer;741;32;773;50429
28;50;02;04;430;Reigneville-Bocage;39;3;42;50430
28;50;04;22;431;Remilly Les Marais;1072;12;1084;50431
28;50;02;26;433;Réville;1002;22;1024;50433
28;50;02;04;435;Rocheville;597;15;612;50435
28;50;01;16;436;Romagny Fontenay;1278;43;1321;50436
28;50;03;20;437;Roncey;799;10;809;50437
28;50;02;17;442;Le Rozel;250;6;256;50442
28;50;01;19;443;Sacey;516;10;526;50443
28;50;04;09;444;Saint-Amand-Villages;2500;57;2557;50444
28;50;04;05;445;Saint-André-de-Bohon;353;13;366;50445
28;50;04;18;446;Saint-André-de-l'Epine;544;13;557;50446
28;50;01;03;447;Saint-Aubin-des-Préaux;458;13;471;50447
28;50;01;21;448;Saint-Aubin-de-Terregatte;661;17;678;50448
28;50;01;16;450;Saint-Barthélemy;333;7;340;50450
28;50;01;15;451;Saint-Brice;127;2;129;50451
28;50;01;21;452;Saint-Brice-de-Landelles;664;22;686;50452
28;50;04;27;453;Sainte-Cécile;785;18;803;50453
28;50;02;17;454;Saint-Christophe-du-Foc;423;9;432;50454
28;50;04;18;455;Saint-Clair-sur-l'Elle;961;20;981;50455
28;50;01;16;456;Saint-Clément-Rancoudray;548;9;557;50456
28;50;02;04;457;Sainte-Colombe;196;5;201;50457
28;50;02;25;461;Saint-Cyr;198;9;207;50461
28;50;01;16;462;Saint-Cyr-du-Bailleul;369;8;377;50462
28;50;03;20;463;Saint-Denis-le-Gast;525;10;535;50463
28;50;03;20;464;Saint-Denis-le-Vêtu;632;5;637;50464
28;50;02;25;467;Saint-Floxel;494;13;507;50467
28;50;04;18;468;Saint-Fromond;770;15;785;50468
28;50;02;26;469;Sainte-Geneviève;313;7;320;50469
28;50;02;17;471;Saint-Georges-de-la-Rivière;284;11;295;50471
28;50;01;15;472;Saint-Georges-de-Livoye;204;10;214;50472
28;50;04;18;473;Saint-Georges-d'Elle;390;7;397;50473
28;50;01;16;474;Saint-Georges-de-Rouelley;545;11;556;50474
28;50;04;18;475;Saint-Georges-Montcocq;955;46;1001;50475
28;50;04;18;476;Saint-Germain-d'Elle;225;1;226;50476
28;50;02;25;478;Saint-Germain-de-Tournebut;426;7;433;50478
28;50;02;05;479;Saint-Germain-de-Varreville;110;4;114;50479
28;50;02;17;480;Saint-Germain-le-Gaillard;757;23;780;50480
28;50;03;11;481;Saint-Germain-sur-Ay;900;18;918;50481
28;50;03;01;482;Saint-Germain-sur-Sèves;162;3;165;50482
28;50;04;22;483;Saint-Gilles;955;28;983;50483
28;50;01;21;484;Saint-Hilaire-du-HarcouÃ«t;5850;332;6182;50484
28;50;02;04;486;Saint-Jacques-de-Néhou;619;9;628;50486
28;50;01;21;487;Saint-James;4907;109;5016;50487
28;50;04;18;488;Saint-Jean-de-Daye;638;5;643;50488
28;50;01;02;489;Saint-Jean-de-la-Haize;531;14;545;50489
28;50;02;17;490;Saint-Jean-de-la-Rivière;354;9;363;50490
28;50;04;18;491;Saint-Jean-de-Savigny;447;6;453;50491
28;50;04;09;492;Saint-Jean-d'Elle;2498;55;2553;50492
28;50;01;03;493;Saint-Jean-des-Champs;1443;37;1480;50493
28;50;01;15;495;Saint-Jean-du-Corail-des-Bois;75;5;80;50495
28;50;01;02;496;Saint-Jean-le-Thomas;384;8;392;50496
28;50;02;25;498;Saint-Joseph;798;26;824;50498
28;50;01;15;499;Saint-Laurent-de-Cuves;481;7;488;50499
28;50;01;21;500;Saint-Laurent-de-Terregatte;654;12;666;50500
28;50;04;99;502;Saint-Lô;19050;913;19963;50502
28;50;04;09;504;Saint-Louet-sur-Vire;206;1;207;50504
28;50;01;15;505;Saint-Loup;679;35;714;50505
28;50;03;01;506;Saint-Malo-de-la-Lande;482;4;486;50506
28;50;02;25;507;Saint-Marcouf;344;7;351;50507
28;50;02;05;509;Sainte-Marie-du-Mont;712;18;730;50509
28;50;03;01;510;Saint-Martin-d'Aubigny;602;4;606;50510
28;50;02;25;511;Saint-Martin-d'Audouville;128;4;132;50511
28;50;04;23;512;Saint-Martin-de-Bonfossé;526;9;535;50512
28;50;03;20;513;Saint-Martin-de-Cenilly;176;3;179;50513
28;50;01;16;514;Chaulieu;307;1;308;50514
28;50;02;05;517;Saint-Martin-de-Varreville;172;5;177;50517
28;50;01;27;518;Saint-Martin-le-Bouillant;327;4;331;50518
28;50;02;08;519;Saint-Martin-le-Gréard;567;8;575;50519
28;50;01;27;521;Saint-Maur-des-Bois;154;4;158;50521
28;50;02;17;522;Saint-Maurice-en-Cotentin;255;7;262;50522
28;50;02;05;523;Sainte-Mère-Eglise;3076;51;3127;50523
28;50;01;15;525;Saint-Michel-de-Montjoie;328;1;329;50525
28;50;03;11;528;Saint-Nicolas-de-Pierrepont;305;12;317;50528
28;50;01;15;529;Saint-Nicolas-des-Bois;81;2;83;50529
28;50;01;19;531;Saint-Ovin;767;35;802;50531
28;50;01;13;532;Saint-Pair-sur-Mer;4078;149;4227;50532
28;50;03;11;533;Saint-Patrice-de-Claids;178;3;181;50533
28;50;01;02;535;Le Parc;921;26;947;50535
28;50;02;17;536;Saint-Pierre-d'Arthéglise;158;0;158;50536
28;50;03;10;537;Saint-Pierre-de-Coutances;414;19;433;50537
28;50;04;18;538;Saint-Pierre-de-Semilly;456;8;464;50538
28;50;02;26;539;Saint-Pierre-Eglise;1810;25;1835;50539
28;50;01;02;540;Saint-Pierre-Langers;620;18;638;50540
28;50;01;03;541;Saint-Planchers;1399;47;1446;50541
28;50;01;27;542;Saint-Pois;490;7;497;50542
28;50;01;19;543;Saint-Quentin-sur-le-Homme;1345;32;1377;50543
28;50;04;23;546;Bourgvallées;3247;68;3315;50546
28;50;03;11;548;Saint-Sauveur-de-Pierrepont;121;3;124;50548
28;50;01;03;549;Saint-Sauveur-la-Pommeraye;402;6;408;50549
28;50;03;01;550;Saint-Sauveur-Villages;3601;148;3749;50550
28;50;02;04;551;Saint-Sauveur-le-Vicomte;2088;40;2128;50551
28;50;03;01;552;Saint-Sébastien-de-Raids;331;6;337;50552
28;50;01;21;553;Saint-Senier-de-Beuvron;346;2;348;50553
28;50;01;15;554;Saint-Senier-sous-Avranches;1420;59;1479;50554
28;50;04;23;556;Sainte-Suzanne-sur-Vire;696;10;706;50556
28;50;02;26;562;Saint-Vaast-la-Hougue;1712;30;1742;50562
28;50;04;09;563;Saint-Vigor-des-Monts;279;8;287;50563
28;50;04;05;564;Terre-et-Marais;1322;29;1351;50564
28;50;01;02;565;Sartilly-Baie-Bocage;2815;58;2873;50565
28;50;02;25;567;Saussemesnil;880;22;902;50567
28;50;03;10;568;Saussey;462;15;477;50568
28;50;03;20;569;Savigny;450;8;458;50569
28;50;01;21;570;Savigny-le-Vieux;426;7;433;50570
28;50;02;05;571;Sébeville;34;1;35;50571
28;50;02;17;572;Sénoville;189;7;196;50572
28;50;01;19;574;Servon;271;11;282;50574
28;50;02;08;575;Sideville;769;13;782;50575
28;50;02;17;576;Siouville-Hague;952;31;983;50576
28;50;02;17;577;Sortosville-en-Beaumont;311;8;319;50577
28;50;02;25;578;Sortosville;79;1;80;50578
28;50;02;04;579;Sottevast;1421;29;1450;50579
28;50;02;17;580;Sotteville;465;9;474;50580
28;50;01;16;582;Sourdeval;3156;64;3220;50582
28;50;01;03;584;Subligny;407;6;413;50584
28;50;02;17;585;Surtainville;1154;27;1181;50585
28;50;02;04;587;Taillepied;17;1;18;50587
28;50;02;25;588;Tamerville;678;22;700;50588
28;50;01;19;589;Tanis;289;12;301;50589
28;50;01;27;590;Le Tanu;406;5;411;50590
28;50;01;16;591;Le Teilleul;1674;27;1701;50591
28;50;04;09;592;Tessy-Bocage;2277;44;2321;50592
28;50;02;26;593;Teurthéville-Bocage;588;8;596;50593
28;50;02;08;594;Teurthéville-Hague;1041;23;1064;50594
28;50;02;26;596;Théville;338;12;350;50596
28;50;01;15;597;Tirepied-sur-Sée;953;23;976;50597
28;50;02;26;598;Tocqueville;270;3;273;50598
28;50;02;08;599;Tollevast;1569;44;1613;50599
28;50;04;09;601;Torigny-les-Villes;4397;55;4452;50601
28;50;03;10;603;Tourville-sur-Sienne;778;24;802;50603
28;50;02;17;604;Tréauville;755;13;768;50604
28;50;04;18;606;Tribehou;520;5;525;50606
28;50;04;27;607;La Trinité;391;6;397;50607
28;50;02;05;609;Turqueville;127;3;130;50609
28;50;02;25;610;Urville;209;6;215;50610
28;50;01;02;612;Vains;745;86;831;50612
28;50;02;26;613;Valcanville;402;9;411;50613
28;50;02;25;615;Valognes;6822;266;7088;50615
28;50;01;19;616;Le Val-Saint-Père;1971;71;2042;50616
28;50;03;11;617;Varenguebec;331;2;333;50617
28;50;02;26;618;Varouville;244;11;255;50618
28;50;02;26;619;Le Vast;326;10;336;50619
28;50;02;25;621;Vaudreville;72;0;72;50621
28;50;03;10;624;La Vendelée;479;24;503;50624
28;50;03;20;626;Ver;377;8;385;50626
28;50;01;15;628;Vernix;155;4;159;50628
28;50;03;11;629;Vesly;737;4;741;50629
28;50;02;26;633;Le Vicel;119;3;122;50633
28;50;02;26;634;Videcosville;84;1;85;50634
28;50;04;27;637;Villebaudon;316;3;319;50637
28;50;04;27;639;Villedieu-les-Poêles-Rouffigny;3852;67;3919;50639
28;50;04;18;641;Villiers-Fossard;657;15;672;50641
28;50;02;08;643;Virandeville;783;24;807;50643
28;50;01;13;647;Yquelon;1135;43;1178;50647
28;50;02;25;648;Yvetot-Bocage;1182;31;1213;50648
44;51;04;23;001;Ablancourt;166;1;167;51001
44;51;02;06;002;Saint-Martin-d'Ablois;1407;23;1430;51002
44;51;01;04;003;Aigny;276;5;281;51003
44;51;02;22;004;Allemanche-Launay-et-Soyer;117;4;121;51004
44;51;02;21;005;Allemant;175;3;178;51005
44;51;04;20;006;Alliancelles;147;4;151;51006
44;51;02;07;007;Ambonnay;957;25;982;51007
44;51;04;20;008;Ambrières;218;6;224;51008
44;51;02;22;009;Anglure;834;11;845;51009
44;51;02;22;010;Angluzelles-et-Courcelles;139;4;143;51010
44;51;03;06;012;Anthenay;71;0;71;51012
44;51;03;06;013;Aougny;99;5;104;51013
44;51;03;09;014;Arcis-le-Ponsart;298;6;304;51014
44;51;01;01;015;Argers;112;1;113;51015
44;51;04;20;016;Arrigny;238;4;242;51016
44;51;04;23;017;Arzillières-Neuville;325;6;331;51017
44;51;02;22;018;Athis;900;20;920;51018
44;51;03;10;019;Aubérive;253;8;261;51019
44;51;03;09;020;Aubilly;53;3;56;51020
44;51;04;23;022;Aulnay-l'Aître;188;5;193;51022
44;51;01;04;023;Aulnay-sur-Marne;266;6;272;51023
44;51;03;02;025;Auménancourt;1074;10;1084;51025
44;51;01;01;027;Auve;302;21;323;51027
44;51;02;07;028;Avenay-Val-d'Or;1031;12;1043;51028
44;51;02;08;029;Avize;1754;160;1914;51029
44;51;02;07;030;AÃ¿-Champagne;5309;86;5395;51030
44;51;01;10;031;Baconnes;266;10;276;51031
44;51;02;22;032;Bagneux;427;5;432;51032
44;51;02;06;033;Le Baizil;251;3;254;51033
44;51;02;06;034;Bannay;20;0;20;51034
44;51;02;22;035;Bannes;253;3;256;51035
44;51;02;21;036;Barbonne-Fayel;507;7;514;51036
44;51;03;09;037;Baslieux-lès-Fismes;338;2;340;51037
44;51;02;06;038;Baslieux-sous-Châtillon;183;6;189;51038
44;51;04;20;039;Bassu;95;5;100;51039
44;51;04;20;040;Bassuet;250;3;253;51040
44;51;02;22;041;Baudement;103;4;107;51041
44;51;02;06;042;Baye;386;8;394;51042
44;51;03;02;043;Bazancourt;2352;28;2380;51043
44;51;03;10;044;Beaumont-sur-Vesle;796;16;812;51044
44;51;02;06;045;Beaunay;104;0;104;51045
44;51;03;02;046;Beine-Nauroy;995;15;1010;51046
44;51;01;01;047;Belval-en-Argonne;44;3;47;51047
44;51;02;06;048;Belval-sous-Châtillon;161;0;161;51048
44;51;02;22;049;Bergères-lès-Vertus;576;4;580;51049
44;51;02;21;050;Bergères-sous-Montmirail;135;2;137;51050
44;51;03;02;051;Berméricourt;221;2;223;51051
44;51;03;02;052;Berru;596;4;600;51052
44;51;01;01;053;Berzieux;76;7;83;51053
44;51;03;10;054;Bétheniville;1281;14;1295;51054
44;51;03;15;055;Bétheny;7069;108;7177;51055
44;51;02;21;056;Bethon;255;3;258;51056
44;51;04;20;057;Bettancourt-la-Longue;76;2;78;51057
44;51;03;14;058;Bezannes;2978;70;3048;51058
44;51;04;23;059;Bignicourt-sur-Marne;361;6;367;51059
44;51;04;20;060;Bignicourt-sur-Saulx;171;3;174;51060
44;51;03;10;061;Billy-le-Grand;119;2;121;51061
44;51;01;01;062;Binarville;95;3;98;51062
44;51;02;06;063;Binson-et-Orquigny;164;2;166;51063
44;51;04;23;065;Blacy;632;13;645;51065
44;51;04;23;066;Blaise-sous-Arzillières;330;3;333;51066
44;51;04;20;068;Blesme;202;2;204;51068
44;51;03;06;069;Bligny;118;1;119;51069
44;51;02;21;070;Boissy-le-Repos;227;0;227;51070
44;51;02;21;071;Bouchy-Saint-Genest;194;7;201;51071
44;51;03;09;072;Bouilly;220;3;223;51072
44;51;03;09;073;Bouleuse;223;3;226;51073
44;51;03;02;074;Boult-sur-Suippe;1773;27;1800;51074
44;51;03;02;075;Bourgogne-Fresne;1422;33;1455;51075
44;51;02;06;076;Boursault;441;9;450;51076
44;51;03;09;077;Bouvancourt;182;4;186;51077
44;51;01;10;078;Bouy;575;14;589;51078
44;51;02;07;079;Bouzy;867;23;890;51079
44;51;04;20;080;Brandonvillers;190;1;191;51080
44;51;03;09;081;Branscourt;320;5;325;51081
44;51;01;01;082;Braux-Sainte-Cohière;93;6;99;51082
44;51;01;01;083;Braux-Saint-Remy;81;3;84;51083
44;51;04;23;084;Bréban;78;1;79;51084
44;51;02;06;085;Le Breuil;378;3;381;51085
44;51;03;09;086;Breuil-sur-Vesle;334;11;345;51086
44;51;01;05;087;Breuvery-sur-Coole;217;8;225;51087
44;51;03;02;088;Brimont;448;7;455;51088
44;51;03;06;089;Brouillet;72;4;76;51089
44;51;02;22;090;Broussy-le-Grand;312;12;324;51090
44;51;02;21;091;Broussy-le-Petit;134;7;141;51091
44;51;02;21;092;Broyes;357;4;361;51092
44;51;02;08;093;Brugny-Vaudancourt;445;14;459;51093
44;51;04;20;094;Brusson;177;7;184;51094
44;51;04;20;095;Le Buisson;94;3;97;51095
44;51;01;01;097;Bussy-le-Château;175;4;179;51097
44;51;04;20;098;Bussy-le-Repos;136;4;140;51098
44;51;01;05;099;Bussy-Lettrée;322;9;331;51099
44;51;02;06;100;La Caure;107;2;109;51100
44;51;03;02;101;Caurel;689;8;697;51101
44;51;03;02;102;Cauroy-lès-Hermonville;469;10;479;51102
44;51;02;22;103;La Celle-sous-Chantemerle;140;1;141;51103
44;51;01;01;104;Cernay-en-Dormois;138;4;142;51104
44;51;03;18;105;Cernay-lès-Reims;1438;25;1463;51105
44;51;01;05;106;Cernon;125;5;130;51106
44;51;02;22;107;Chaintrix-Bierges;336;3;339;51107
44;51;01;97;108;Châlons-en-Champagne;44379;1246;45625;51108
44;51;03;09;109;Châlons-sur-Vesle;188;2;190;51109
44;51;02;22;110;Chaltrait;55;1;56;51110
44;51;03;06;111;Chambrecy;147;8;155;51111
44;51;03;09;112;Chamery;430;6;436;51112
44;51;02;06;113;Champaubert;122;2;124;51113
44;51;03;14;115;Champfleury;568;3;571;51115
44;51;02;21;116;Champguyon;279;4;283;51116
44;51;01;04;117;Champigneul-Champagne;319;8;327;51117
44;51;03;14;118;Champigny;1573;25;1598;51118
44;51;02;07;119;Champillon;512;7;519;51119
44;51;02;06;120;Champlat-et-Boujacourt;155;0;155;51120
44;51;02;06;121;Champvoisy;250;3;253;51121
44;51;04;20;122;Changy;117;5;122;51122
44;51;02;21;124;Chantemerle;47;3;50;51124
44;51;04;23;125;Chapelaine;51;1;52;51125
44;51;01;01;126;La Chapelle-Felcourt;47;3;50;51126
44;51;02;22;127;La Chapelle-Lasson;87;2;89;51127
44;51;02;06;128;La Chapelle-sous-Orbais;54;2;56;51128
44;51;02;21;129;Charleville;249;9;258;51129
44;51;04;20;130;Charmont;231;5;236;51130
44;51;01;01;132;Les Charmontois;117;0;117;51132
44;51;01;01;133;Le Châtelier;63;0;63;51133
44;51;04;23;134;Châtelraould-Saint-Louvent;245;8;253;51134
44;51;04;20;135;Châtillon-sur-Broué;78;0;78;51135
44;51;02;06;136;Châtillon-sur-Marne;638;16;654;51136
44;51;02;21;137;Châtillon-sur-Morin;223;3;226;51137
44;51;01;01;138;Châtrices;35;2;37;51138
44;51;01;01;139;Chaudefontaine;316;13;329;51139
44;51;03;06;140;Chaumuzy;390;2;392;51140
44;51;04;23;141;La Chaussée-sur-Marne;778;15;793;51141
44;51;02;08;142;Chavot-Courcourt;333;11;344;51142
44;51;01;01;143;Le Chemin;56;0;56;51143
44;51;04;20;144;Cheminon;604;10;614;51144
44;51;03;09;145;Chenay;225;6;231;51145
44;51;01;05;146;Cheniers;105;4;109;51146
44;51;01;01;147;La Cheppe;330;13;343;51147
44;51;01;05;148;Cheppes-la-Prairie;157;2;159;51148
44;51;01;05;149;Chepy;440;13;453;51149
44;51;01;04;150;Cherville;82;1;83;51150
44;51;02;21;151;Chichey;174;3;177;51151
44;51;03;10;152;Chigny-les-Roses;540;13;553;51152
44;51;02;08;153;Chouilly;1022;31;1053;51153
44;51;02;22;154;Clamanges;213;3;216;51154
44;51;02;22;155;Clesles;612;10;622;51155
44;51;04;20;156;Cloyes-sur-Marne;124;1;125;51156
44;51;02;06;157;Coizard-Joches;72;1;73;51157
44;51;02;22;158;Val-des-Marais;567;11;578;51158
44;51;01;03;160;Compertrix;1376;46;1422;51160
44;51;01;04;161;Condé-sur-Marne;768;14;782;51161
44;51;02;22;162;Conflans-sur-Seine;636;7;643;51162
44;51;02;06;163;Congy;268;2;270;51163
44;51;02;22;164;Connantray-Vaurefroy;148;3;151;51164
44;51;02;22;165;Connantre;1036;30;1066;51165
44;51;01;01;166;Contault;68;2;70;51166
44;51;04;23;167;Coole;148;3;151;51167
44;51;01;03;168;Coolus;220;8;228;51168
44;51;04;23;169;Corbeil;95;5;100;51169
44;51;02;21;170;Corfélix;111;2;113;51170
44;51;03;02;171;Cormicy;1487;26;1513;51171
44;51;03;18;172;Cormontreuil;6458;92;6550;51172
44;51;02;06;173;Cormoyeux;124;1;125;51173
44;51;02;06;174;Corribert;62;0;62;51174
44;51;02;21;175;Corrobert;210;7;217;51175
44;51;02;22;176;Corroy;151;7;158;51176
44;51;03;09;177;Coulommes-la-Montagne;205;4;209;51177
44;51;01;05;178;Coupetz;80;2;82;51178
44;51;01;05;179;Coupéville;164;0;164;51179
44;51;03;09;181;Courcelles-Sapicourt;395;11;406;51181
44;51;02;22;182;Courcemain;93;3;96;51182
44;51;03;02;183;Courcy;1210;19;1229;51183
44;51;04;23;184;Courdemanges;392;13;405;51184
44;51;02;21;185;Courgivaux;299;1;300;51185
44;51;02;06;186;Courjeonnet;47;0;47;51186
44;51;03;09;187;Courlandon;283;4;287;51187
44;51;03;09;188;Courmas;213;8;221;51188
44;51;03;09;190;Courtagnon;68;0;68;51190
44;51;01;01;191;Courtémont;60;1;61;51191
44;51;02;06;192;Courthiézy;347;5;352;51192
44;51;01;01;193;Courtisols;2382;91;2473;51193
44;51;03;09;194;Courville;460;6;466;51194
44;51;04;23;195;Couvrot;823;23;846;51195
44;51;02;08;196;Cramant;880;13;893;51196
44;51;01;01;197;La Croix-en-Champagne;79;2;81;51197
44;51;03;09;198;Crugny;668;6;674;51198
44;51;02;06;199;Cuchery;408;6;414;51199
44;51;02;08;200;Cuis;369;12;381;51200
44;51;03;06;201;Cuisles;126;4;130;51201
44;51;02;07;202;Cumières;749;12;761;51202
44;51;01;01;203;Cuperly;223;2;225;51203
44;51;02;06;204;Damery;1377;25;1402;51204
44;51;01;10;205;Dampierre-au-Temple;272;4;276;51205
44;51;01;01;206;Dampierre-le-Château;113;2;115;51206
44;51;01;05;208;Dampierre-sur-Moivre;110;2;112;51208
44;51;02;07;210;Dizy;1496;34;1530;51210
44;51;01;01;211;Dommartin-Dampierre;68;0;68;51211
44;51;01;05;212;Dommartin-Lettrée;155;1;156;51212
44;51;01;01;213;Dommartin-sous-Hans;60;2;62;51213
44;51;01;01;214;Dommartin-Varimont;138;8;146;51214
44;51;04;20;215;Dompremy;127;3;130;51215
44;51;03;10;216;Dontrien;263;4;267;51216
44;51;02;06;217;Dormans;2918;43;2961;51217
44;51;04;20;218;Val-de-Vière;130;1;131;51218
44;51;04;20;219;Drosnay;223;1;224;51219
44;51;04;23;220;Drouilly;140;1;141;51220
44;51;01;01;222;Eclaires;95;3;98;51222
44;51;04;20;223;Ecollemont;56;1;57;51223
44;51;04;20;224;Ecriennes;170;2;172;51224
44;51;03;09;225;Ecueil;305;2;307;51225
44;51;02;22;226;Ecury-le-Repos;55;1;56;51226
44;51;01;05;227;Ecury-sur-Coole;488;21;509;51227
44;51;01;01;228;Elise-Daucourt;84;0;84;51228
44;51;01;01;229;Epense;120;6;126;51229
44;51;02;98;230;Epernay;22433;468;22901;51230
44;51;01;05;231;L'Epine;654;15;669;51231
44;51;03;10;232;Epoye;415;6;421;51232
44;51;02;21;233;Escardes;69;3;72;51233
44;51;02;22;234;Esclavolles-Lurey;618;11;629;51234
44;51;02;21;235;Les Essarts-lès-Sézanne;246;10;256;51235
44;51;02;21;236;Les Essarts-le-Vicomte;139;3;142;51236
44;51;02;21;237;Esternay;1820;30;1850;51237
44;51;02;06;238;Etoges;490;8;498;51238
44;51;02;22;239;Etréchy;105;1;106;51239
44;51;04;20;240;Etrepy;127;3;130;51240
44;51;02;22;241;Euvy;81;1;82;51241
44;51;01;03;242;Fagnières;4843;108;4951;51242
44;51;02;22;243;Faux-Fresnay;308;8;316;51243
44;51;01;05;244;Faux-Vésigneul;241;8;249;51244
44;51;03;09;245;Faverolles-et-CoÃ«my;573;10;583;51245
44;51;04;20;246;Favresse;222;6;228;51246
44;51;02;06;247;Fèrebrianges;143;3;146;51247
44;51;02;22;248;Fère-Champenoise;2162;41;2203;51248
44;51;02;06;249;Festigny;389;5;394;51249
44;51;03;09;250;Fismes;5589;51;5640;51250
44;51;02;08;251;Flavigny;170;5;175;51251
44;51;02;06;252;Fleury-la-Rivière;518;8;526;51252
44;51;01;01;253;Florent-en-Argonne;228;5;233;51253
44;51;02;21;254;Fontaine-Denis-Nuisy;232;2;234;51254
44;51;01;01;255;Fontaine-en-Dormois;13;0;13;51255
44;51;02;07;256;Fontaine-sur-Ay;340;8;348;51256
44;51;02;21;258;La Forestière;209;13;222;51258
44;51;01;05;259;Francheville;196;7;203;51259
44;51;01;05;260;Le Fresne;76;3;79;51260
44;51;04;23;262;Frignicourt;1816;33;1849;51262
44;51;02;21;263;Fromentières;380;7;387;51263
44;51;02;21;264;Le Gault-Soigny;512;15;527;51264
44;51;02;21;265;Gaye;590;12;602;51265
44;51;02;07;266;Germaine;530;16;546;51266
44;51;03;09;267;Germigny;176;2;178;51267
44;51;02;22;268;Germinon;178;4;182;51268
44;51;04;20;269;Giffaumont-Champaubert;274;1;275;51269
44;51;04;20;270;Gigny-Bussy;237;5;242;51270
44;51;01;01;272;Givry-en-Argonne;456;5;461;51272
44;51;02;22;273;Givry-lès-Loisy;70;4;74;51273
44;51;01;01;274;Gizaucourt;117;3;120;51274
44;51;04;23;275;Glannes;188;3;191;51275
44;51;02;22;276;Gourgançon;145;7;152;51276
44;51;04;20;277;Sainte-Marie-du-Lac-Nuisement;272;2;274;51277
44;51;01;04;278;Les Grandes-Loges;275;5;280;51278
44;51;02;22;279;Granges-sur-Aube;184;4;188;51279
44;51;01;01;280;Gratreuil;25;0;25;51280
44;51;02;08;281;Grauves;619;11;630;51281
44;51;03;09;282;Gueux;1796;45;1841;51282
44;51;01;01;283;Hans;147;6;153;51283
44;51;04;20;284;Haussignémont;304;1;305;51284
44;51;01;05;285;Haussimont;139;5;144;51285
44;51;04;20;286;Hauteville;237;8;245;51286
44;51;02;07;287;Hautvillers;675;15;690;51287
44;51;04;20;288;Heiltz-le-Hutier;238;8;246;51288
44;51;04;20;289;Heiltz-le-Maurupt;435;9;444;51289
44;51;04;20;290;Heiltz-l'Evêque;288;6;294;51290
44;51;03;02;291;Hermonville;1391;31;1422;51291
44;51;01;01;292;Herpont;127;4;131;51292
44;51;03;02;293;Heutrégiville;478;7;485;51293
44;51;03;09;294;Hourges;78;1;79;51294
44;51;04;23;295;Huiron;304;2;306;51295
44;51;04;23;296;Humbauville;78;1;79;51296
44;51;02;06;298;Igny-Comblizy;428;3;431;51298
44;51;03;02;299;Isles-sur-Suippe;928;15;943;51299
44;51;04;20;300;Isle-sur-Marne;95;2;97;51300
44;51;01;04;301;Isse;109;8;117;51301
44;51;02;08;302;Les Istres-et-Bury;95;1;96;51302
44;51;01;04;303;Jâlons;552;10;562;51303
44;51;02;21;304;Janvilliers;171;4;175;51304
44;51;03;09;305;Janvry;126;2;128;51305
44;51;02;21;306;Joiselle;103;3;106;51306
44;51;01;01;307;Jonchery-sur-Suippe;222;3;225;51307
44;51;03;09;308;Jonchery-sur-Vesle;1857;53;1910;51308
44;51;03;06;309;Jonquery;113;4;117;51309
44;51;03;09;310;Jouy-lès-Reims;227;2;229;51310
44;51;04;20;311;Jussecourt-Minecourt;208;2;210;51311
44;51;01;04;312;Juvigny;938;29;967;51312
44;51;02;21;313;Lachy;323;5;328;51313
44;51;03;06;314;Lagery;225;3;228;51314
44;51;04;20;315;Landricourt;146;2;148;51315
44;51;04;20;316;Larzicourt;273;5;278;51316
44;51;01;01;317;Laval-sur-Tourbe;54;0;54;51317
44;51;03;02;318;Lavannes;571;16;587;51318
44;51;01;05;319;Lenharrée;100;3;103;51319
44;51;02;06;320;Leuvrigny;310;8;318;51320
44;51;03;06;321;Lhéry;81;3;84;51321
44;51;04;23;322;Lignon;124;1;125;51322
44;51;02;21;323;Linthelles;105;6;111;51323
44;51;02;21;324;Linthes;114;0;114;51324
44;51;04;20;325;Lisse-en-Champagne;113;2;115;51325
44;51;01;10;326;Livry-Louvercy;1091;14;1105;51326
44;51;02;22;327;Loisy-en-Brie;180;2;182;51327
44;51;04;23;328;Loisy-sur-Marne;1104;24;1128;51328
44;51;03;02;329;Loivre;1348;18;1366;51329
44;51;03;10;333;Ludes;674;7;681;51333
44;51;04;20;334;Luxémont-et-Villotte;472;11;483;51334
44;51;01;01;336;Maffrécourt;58;1;59;51336
44;51;03;09;337;Magneux;271;3;274;51337
44;51;03;10;338;Mailly-Champagne;640;16;656;51338
44;51;01;05;339;Mairy-sur-Marne;557;15;572;51339
44;51;04;23;340;Maisons-en-Champagne;539;14;553;51340
44;51;01;01;341;Malmy;34;2;36;51341
44;51;02;08;342;Mancy;246;7;253;51342
44;51;02;22;343;Marcilly-sur-Seine;628;21;649;51343
44;51;02;07;344;Mardeuil;1480;20;1500;51344
44;51;02;06;345;Mareuil-en-Brie;284;2;286;51345
44;51;02;06;346;Mareuil-le-Port;1157;18;1175;51346
44;51;03;06;348;Marfaux;116;1;117;51348
44;51;04;23;349;Margerie-Hancourt;173;4;177;51349
44;51;02;06;350;Margny;125;5;130;51350
44;51;02;22;351;Marigny;108;1;109;51351
44;51;04;23;352;Marolles;876;18;894;51352
44;51;02;22;353;Marsangis;47;1;48;51353
44;51;01;05;354;Marson;283;9;292;51354
44;51;01;01;355;Massiges;52;0;52;51355
44;51;04;20;356;Matignicourt-Goncourt;151;5;156;51356
44;51;01;04;357;Matougues;612;13;625;51357
44;51;04;20;358;Maurupt-le-Montois;584;10;594;51358
44;51;02;21;359;Mécringes;207;3;210;51359
44;51;02;21;360;Le Meix-Saint-Epoing;294;2;296;51360
44;51;04;23;361;Le Meix-Tiercelin;167;1;168;51361
44;51;03;02;362;Merfy;603;19;622;51362
44;51;04;20;363;Merlaut;254;7;261;51363
44;51;03;09;364;Méry-Prémecy;66;1;67;51364
44;51;03;09;365;Les Mesneux;876;21;897;51365
44;51;02;22;367;Le Mesnil-sur-Oger;1055;36;1091;51367
44;51;01;01;368;Minaucourt-le-Mesnil-lès-Hurlus;50;3;53;51368
44;51;02;21;369;MÅ“urs-Verdey;314;14;328;51369
44;51;01;01;370;Moiremont;193;10;203;51370
44;51;01;05;371;Moivre;62;1;63;51371
44;51;01;05;372;Moncetz-Longevas;528;9;537;51372
44;51;04;20;373;Moncetz-l'Abbaye;92;4;96;51373
44;51;02;21;374;Mondement-Montgivroux;26;0;26;51374
44;51;03;10;375;Montbré;319;5;324;51375
44;51;02;21;376;Montgenost;151;3;154;51376
44;51;01;05;377;Montépreux;47;0;47;51377
44;51;02;08;378;Monthelon;348;5;353;51378
44;51;03;09;379;Montigny-sur-Vesle;510;8;518;51379
44;51;02;21;380;Montmirail;3571;49;3620;51380
44;51;02;06;381;Montmort-Lucy;613;11;624;51381
44;51;03;09;382;Mont-sur-Courville;119;4;123;51382
44;51;02;08;384;Morangis;408;7;415;51384
44;51;02;21;386;Morsains;136;3;139;51386
44;51;02;22;387;Moslins;297;3;300;51387
44;51;01;10;388;Mourmelon-le-Grand;5150;49;5199;51388
44;51;01;10;389;Mourmelon-le-Petit;813;8;821;51389
44;51;02;08;390;Moussy;783;10;793;51390
44;51;03;09;391;Muizon;2119;65;2184;51391
44;51;02;07;392;Mutigny;189;5;194;51392
44;51;02;07;393;Nanteuil-la-Forêt;293;7;300;51393
44;51;02;21;395;Nesle-la-Reposte;98;1;99;51395
44;51;02;06;396;Nesle-le-Repons;143;3;146;51396
44;51;01;01;397;La Neuville-aux-Bois;139;2;141;51397
44;51;02;06;398;La Neuville-aux-Larris;185;2;187;51398
44;51;01;01;399;La Neuville-au-Pont;544;9;553;51399
44;51;02;21;402;Neuvy;266;7;273;51402
44;51;03;02;403;Nogent-l'Abbesse;524;5;529;51403
44;51;01;01;404;Noirlieu;107;4;111;51404
44;51;04;20;406;Norrois;152;1;153;51406
44;51;02;21;407;La Noue;420;5;425;51407
44;51;01;05;409;Nuisement-sur-Coole;367;10;377;51409
44;51;02;06;410;Œuilly;652;10;662;51410
44;51;02;22;412;Ognes;60;2;62;51412
44;51;02;08;413;Oiry;871;18;889;51413
44;51;03;06;414;Olizy;150;5;155;51414
44;51;01;05;415;Omey;205;0;205;51415
44;51;02;06;416;Orbais-l'Abbaye;550;3;553;51416
44;51;04;20;417;Orconte;378;5;383;51417
44;51;03;09;418;Ormes;446;3;449;51418
44;51;04;20;419;Outines;129;2;131;51419
44;51;04;20;420;Outrepont;82;0;82;51420
44;51;02;21;421;Oyes;99;3;102;51421
44;51;03;09;422;Pargny-lès-Reims;475;10;485;51422
44;51;04;20;423;Pargny-sur-Saulx;1766;14;1780;51423
44;51;01;01;424;Passavant-en-Argonne;207;1;208;51424
44;51;02;06;425;Passy-Grigny;383;14;397;51425
44;51;02;21;426;Péas;66;3;69;51426
44;51;03;10;428;Les Petites-Loges;495;7;502;51428
44;51;03;09;429;Pévy;205;3;208;51429
44;51;02;22;430;Pierre-Morains;86;2;88;51430
44;51;02;08;431;Pierry;1198;19;1217;51431
44;51;02;22;432;Pleurs;836;19;855;51432
44;51;04;20;433;Plichancourt;256;3;259;51433
44;51;02;08;434;Plivot;740;21;761;51434
44;51;02;22;435;Pocancy;178;2;180;51435
44;51;01;05;436;Pogny;924;18;942;51436
44;51;03;06;437;Poilly;95;0;95;51437
44;51;01;01;438;Poix;69;1;70;51438
44;51;03;02;439;Pomacle;465;8;473;51439
44;51;03;10;440;Pontfaverger-Moronvilliers;1745;17;1762;51440
44;51;04;20;441;Ponthion;106;1;107;51441
44;51;04;20;442;Possesse;137;0;137;51442
44;51;02;22;443;Potangis;121;3;124;51443
44;51;03;02;444;Pouillon;506;8;514;51444
44;51;03;06;445;Pourcy;202;1;203;51445
44;51;04;23;446;Pringy;434;8;442;51446
44;51;03;10;447;Prosnes;486;13;499;51447
44;51;03;09;448;Prouilly;555;10;565;51448
44;51;03;18;449;Prunay;1028;16;1044;51449
44;51;03;18;450;Puisieulx;426;8;434;51450
44;51;02;21;451;Queudes;90;5;95;51451
44;51;01;01;452;Rapsécourt;33;0;33;51452
44;51;01;04;453;Recy;1033;30;1063;51453
44;51;03;99;454;Reims;181194;2920;184114;51454
44;51;04;20;455;Reims-la-Brûlée;223;3;226;51455
44;51;01;01;456;Remicourt;60;1;61;51456
44;51;02;06;457;Reuil;280;18;298;51457
44;51;02;21;458;Reuves;63;0;63;51458
44;51;02;21;459;Réveillon;110;1;111;51459
44;51;02;21;460;Rieux;195;5;200;51460
44;51;03;10;461;Rilly-la-Montagne;1020;22;1042;51461
44;51;04;23;463;Les Rivières-Henruel;168;4;172;51463
44;51;03;09;464;Romain;309;17;326;51464
44;51;02;06;465;Romery;163;2;165;51465
44;51;03;06;466;Romigny;217;5;222;51466
44;51;03;09;468;Rosnay;363;10;373;51468
44;51;02;22;469;Rouffy;111;5;116;51469
44;51;01;01;470;Rouvroy-Ripont;4;0;4;51470
44;51;03;09;471;Sacy;376;3;379;51471
44;51;04;20;472;Saint-Amand-sur-Fion;1033;17;1050;51472
44;51;02;21;473;Saint-Bon;104;6;110;51473
44;51;03;15;474;Saint-Brice-Courcelles;3417;40;3457;51474
44;51;04;23;475;Saint-Chéron;61;1;62;51475
44;51;01;05;476;Saint-Etienne-au-Temple;819;13;832;51476
44;51;03;02;477;Saint-Etienne-sur-Suippe;330;4;334;51477
44;51;04;20;478;Saint-Eulien;424;12;436;51478
44;51;03;09;479;Saint-Euphraise-et-Clairizet;242;5;247;51479
44;51;02;06;480;Sainte-Gemme;138;3;141;51480
44;51;01;05;482;Saint-Germain-la-Ville;681;13;694;51482
44;51;01;04;483;Saint-Gibrien;536;7;543;51483
44;51;03;09;484;Saint-Gilles;279;4;283;51484
44;51;01;10;485;Saint-Hilaire-au-Temple;346;6;352;51485
44;51;01;01;486;Saint-Hilaire-le-Grand;373;4;377;51486
44;51;03;10;487;Saint-Hilaire-le-Petit;342;6;348;51487
44;51;02;07;488;Saint-Imoges;317;34;351;51488
44;51;04;20;489;Saint-Jean-devant-Possesse;32;3;35;51489
44;51;01;05;490;Saint-Jean-sur-Moivre;203;2;205;51490
44;51;01;01;491;Saint-Jean-sur-Tourbe;89;3;92;51491
44;51;02;22;492;Saint-Just-Sauvage;1426;38;1464;51492
44;51;03;18;493;Saint-Léonard;109;3;112;51493
44;51;02;21;495;Saint-Loup;78;0;78;51495
44;51;04;20;496;Saint-Lumier-en-Champagne;268;5;273;51496
44;51;04;20;497;Saint-Lumier-la-Populeuse;44;0;44;51497
44;51;01;01;498;Saint-Mard-sur-Auve;63;1;64;51498
44;51;02;22;499;Saint-Mard-lès-Rouffy;161;7;168;51499
44;51;01;01;500;Saint-Mard-sur-le-Mont;118;0;118;51500
44;51;01;01;501;Sainte-Marie-Ã -Py;195;8;203;51501
44;51;01;05;502;Saint-Martin-aux-Champs;114;0;114;51502
44;51;03;10;503;Saint-Martin-l'Heureux;85;1;86;51503
44;51;01;04;504;Saint-Martin-sur-le-Pré;804;31;835;51504
44;51;03;10;505;Saint-Masmes;486;4;490;51505
44;51;01;05;506;Saint-Memmie;5474;78;5552;51506
44;51;01;01;507;Sainte-Menehould;4165;116;4281;51507
44;51;04;23;508;Saint-Ouen-Domprot;204;6;210;51508
44;51;01;04;509;Saint-Pierre;307;8;315;51509
44;51;04;20;510;Saint-Quentin-les-Marais;129;0;129;51510
44;51;02;22;511;Saint-Quentin-le-Verger;119;2;121;51511
44;51;01;05;512;Saint-Quentin-sur-Coole;102;2;104;51512
44;51;04;20;513;Saint-Remy-en-Bouzemont-Saint-Genest-et-Isson;525;6;531;51513
44;51;02;21;514;Saint-Remy-sous-Broyes;106;2;108;51514
44;51;01;01;515;Saint-Remy-sur-Bussy;338;8;346;51515
44;51;02;22;516;Saint-Saturnin;51;0;51;51516
44;51;03;10;517;Saint-Souplet-sur-Py;120;4;124;51517
44;51;03;02;518;Saint-Thierry;616;24;640;51518
44;51;01;01;519;Saint-Thomas-en-Argonne;39;2;41;51519
44;51;04;23;520;Saint-Utin;77;1;78;51520
44;51;04;20;521;Saint-Vrain;226;3;229;51521
44;51;04;20;522;Sapignicourt;419;4;423;51522
44;51;03;06;523;Sarcy;269;4;273;51523
44;51;02;22;524;Saron-sur-Aube;304;6;310;51524
44;51;01;05;525;Sarry;2037;86;2123;51525
44;51;02;21;526;Saudoy;386;10;396;51526
44;51;03;09;527;Savigny-sur-Ardres;272;4;276;51527
44;51;04;20;528;Scrupt;130;0;130;51528
44;51;03;10;529;Selles;417;1;418;51529
44;51;03;10;530;Sept-Saulx;671;12;683;51530
44;51;04;20;531;Sermaize-les-Bains;1789;32;1821;51531
44;51;03;09;532;Sermiers;568;14;582;51532
44;51;01;01;533;Servon-Melzicourt;106;0;106;51533
44;51;03;09;534;Serzy-et-Prin;207;4;211;51534
44;51;02;21;535;Sézanne;4772;108;4880;51535
44;51;03;18;536;Sillery;1796;39;1835;51536
44;51;01;01;537;Sivry-Ante;179;4;183;51537
44;51;01;05;538;Sogny-aux-Moulins;111;0;111;51538
44;51;04;20;539;Sogny-en-l'Angle;71;0;71;51539
44;51;02;21;542;Soizy-aux-Bois;190;0;190;51542
44;51;01;01;543;Somme-Bionne;71;7;78;51543
44;51;01;01;544;Sommepy-Tahure;639;19;658;51544
44;51;01;05;545;Sommesous;502;16;518;51545
44;51;01;01;546;Somme-Suippe;506;147;653;51546
44;51;01;01;547;Somme-Tourbe;140;2;142;51547
44;51;01;01;548;Somme-Vesle;363;262;625;51548
44;51;01;01;549;Somme-Yèvre;121;3;124;51549
44;51;04;23;550;Sompuis;270;11;281;51550
44;51;04;23;551;Somsois;199;6;205;51551
44;51;04;23;552;Songy;265;4;269;51552
44;51;01;01;553;Souain-Perthes-lès-Hurlus;240;5;245;51553
44;51;01;05;555;Soudé;166;0;166;51555
44;51;01;05;556;Soudron;292;5;297;51556
44;51;04;23;557;Soulanges;466;9;475;51557
44;51;02;22;558;Soulières;141;3;144;51558
44;51;01;01;559;Suippes;3864;49;3913;51559
44;51;02;06;560;Suizy-le-Franc;109;3;112;51560
44;51;03;18;562;Taissy;2183;36;2219;51562
44;51;02;06;563;Talus-Saint-Prix;106;2;108;51563
44;51;02;07;564;Val de Livre;607;16;623;51564
44;51;02;22;565;Thaas;102;0;102;51565
44;51;01;04;566;Thibie;295;2;297;51566
44;51;04;20;567;Thiéblemont-Farémont;527;6;533;51567
44;51;03;02;568;Thil;301;6;307;51568
44;51;03;09;569;Thillois;508;70;578;51569
44;51;02;21;570;Le Thoult-Trosnay;105;2;107;51570
44;51;03;10;571;Val-de-Vesle;916;10;926;51571
44;51;01;01;572;Tilloy-et-Bellay;233;11;244;51572
44;51;03;14;573;Tinqueux;10294;139;10433;51573
44;51;01;05;574;Togny-aux-BÅ“ufs;138;2;140;51574
44;51;02;07;576;Tours-sur-Marne;1384;13;1397;51576
44;51;03;06;577;Tramery;151;3;154;51577
44;51;02;22;578;Trécon;87;1;88;51578
44;51;02;21;579;Tréfols;177;3;180;51579
44;51;03;10;580;Trépail;436;5;441;51580
44;51;03;09;581;Treslon;246;1;247;51581
44;51;03;09;582;Trigny;542;9;551;51582
44;51;04;20;583;Trois-Fontaines-l'Abbaye;190;5;195;51583
44;51;03;18;584;Trois-Puits;147;2;149;51584
44;51;02;06;585;Troissy;794;62;856;51585
44;51;03;09;586;Unchair;177;5;182;51586
44;51;01;10;587;Vadenay;232;5;237;51587
44;51;01;01;588;Valmy;303;5;308;51588
44;51;04;20;589;Vanault-le-Châtel;174;1;175;51589
44;51;04;20;590;Vanault-les-Dames;366;9;375;51590
44;51;03;09;591;Vandeuil;176;3;179;51591
44;51;02;06;592;Vandières;298;6;304;51592
44;51;01;05;594;Vassimont-et-Chapelaine;65;1;66;51594
44;51;01;05;595;Vatry;155;2;157;51595
44;51;02;21;596;Vauchamps;367;10;377;51596
44;51;02;06;597;Vauciennes;336;7;343;51597
44;51;04;20;598;Vauclerc;485;21;506;51598
44;51;03;10;599;Vaudemange;323;5;328;51599
44;51;03;10;600;Vaudesincourt;98;1;99;51600
44;51;04;20;601;Vavray-le-Grand;158;3;161;51601
44;51;04;20;602;Vavray-le-Petit;65;0;65;51602
44;51;02;22;603;Vélye;205;2;207;51603
44;51;03;09;604;Ventelay;258;3;261;51604
44;51;02;06;605;Venteuil;528;10;538;51605
44;51;02;21;607;Verdon;206;2;208;51607
44;51;04;20;608;Vernancourt;86;5;91;51608
44;51;02;06;609;Verneuil;846;20;866;51609
44;51;01;01;610;Verrières;391;6;397;51610
44;51;02;22;611;Vert-Toulon;286;4;290;51611
44;51;02;22;612;Blancs-Coteaux;3332;176;3508;51612
44;51;03;10;613;Verzenay;1047;8;1055;51613
44;51;03;10;614;Verzy;961;23;984;51614
44;51;01;05;616;Vésigneul-sur-Marne;233;3;236;51616
44;51;01;04;617;La Veuve;605;11;616;51617
44;51;02;21;618;Le Vézier;190;3;193;51618
44;51;01;01;619;Le Vieil-Dampierre;113;3;116;51619
44;51;01;01;620;Vienne-la-Ville;173;7;180;51620
44;51;01;01;621;Vienne-le-Château;517;10;527;51621
44;51;03;09;622;Ville-Dommange;401;9;410;51622
44;51;03;10;623;Ville-en-Selve;281;46;327;51623
44;51;03;06;624;Ville-en-Tardenois;648;6;654;51624
44;51;02;21;625;Villeneuve-la-Lionne;283;3;286;51625
44;51;02;21;626;La Villeneuve-lès-Charleville;118;4;122;51626
44;51;02;22;627;Villeneuve-Renneville-Chevigny;323;11;334;51627
44;51;02;21;628;Villeneuve-Saint-Vistre-et-Villevotte;122;5;127;51628
44;51;03;10;629;Villers-Allerand;912;23;935;51629
44;51;02;22;630;Villers-aux-Bois;330;5;335;51630
44;51;03;14;631;Villers-aux-NÅ“uds;246;6;252;51631
44;51;01;01;632;Villers-en-Argonne;237;6;243;51632
44;51;03;02;633;Villers-Franqueux;296;15;311;51633
44;51;01;04;634;Villers-le-Château;264;8;272;51634
44;51;04;20;635;Villers-le-Sec;110;1;111;51635
44;51;03;10;636;Villers-Marmery;501;12;513;51636
44;51;02;06;637;Villers-sous-Châtillon;212;3;215;51637
44;51;02;22;638;Villeseneux;207;6;213;51638
44;51;02;06;639;La Ville-sous-Orbais;43;1;44;51639
44;51;01;01;640;Ville-sur-Tourbe;213;1;214;51640
44;51;02;06;641;Villevenard;203;5;208;51641
44;51;02;22;642;Villiers-aux-Corneilles;111;4;115;51642
44;51;02;08;643;Vinay;549;5;554;51643
44;51;02;06;644;Vincelles;308;10;318;51644
44;51;02;21;645;Vindey;110;2;112;51645
44;51;01;01;646;Virginy;82;3;85;51646
44;51;04;20;647;Vitry-en-Perthois;830;24;854;51647
44;51;01;05;648;Vitry-la-Ville;382;9;391;51648
44;51;04;23;649;Vitry-le-François;11376;251;11627;51649
44;51;01;01;650;Voilemont;46;1;47;51650
44;51;02;22;652;Vouarces;58;0;58;51652
44;51;04;20;654;Vouillers;258;2;260;51654
44;51;02;22;655;Vouzy;291;5;296;51655
44;51;01;04;656;Vraux;454;18;472;51656
44;51;03;09;657;Vrigny;247;0;247;51657
44;51;04;20;658;Vroil;104;0;104;51658
44;51;01;01;659;Wargemoulin-Hurlus;47;1;48;51659
44;51;03;02;660;Warmeriville;2591;28;2619;51660
44;51;03;02;662;Witry-lès-Reims;4971;74;5045;51662
44;51;02;07;663;Magenta;1697;15;1712;51663
44;52;01;11;001;Ageville;312;8;320;52001
44;52;02;02;002;Aigremont;23;0;23;52002
44;52;01;12;003;Aillianville;150;2;152;52003
44;52;03;12;004;Aingoulaincourt;13;0;13;52004
44;52;01;04;005;Aizanville;34;4;38;52005
44;52;03;13;006;Allichamps;355;4;359;52006
44;52;03;09;007;Ambonville;87;2;89;52007
44;52;01;01;008;Andelot-Blancheville;867;10;877;52008
44;52;02;11;009;Andilly-en-Bassigny;105;1;106;52009
44;52;01;01;011;Annéville-la-Prairie;91;0;91;52011
44;52;03;12;012;Annonville;30;2;32;52012
44;52;02;03;013;Anrosey;124;2;126;52013
44;52;02;16;014;Aprey;187;5;192;52014
44;52;02;03;015;Arbigny-sous-Varennes;86;0;86;52015
44;52;02;16;016;Arbot;68;2;70;52016
44;52;01;04;017;Arc-en-Barrois;729;14;743;52017
44;52;03;09;019;Arnancourt;90;4;94;52019
44;52;03;17;021;Attancourt;267;4;271;52021
44;52;01;04;022;Aubepierre-sur-Aube;185;3;188;52022
44;52;02;16;023;Auberive;155;5;160;52023
44;52;01;12;025;Audeloncourt;87;2;89;52025
44;52;02;16;027;Aujeurres;73;2;75;52027
44;52;02;16;028;Aulnoy-sur-Aube;54;0;54;52028
44;52;03;09;029;Autigny-le-Grand;138;4;142;52029
44;52;03;09;030;Autigny-le-Petit;56;4;60;52030
44;52;01;04;031;Autreville-sur-la-Renne;371;9;380;52031
44;52;02;02;033;Avrecourt;108;4;112;52033
44;52;03;17;034;Bailly-aux-Forges;143;5;148;52034
44;52;02;16;035;Baissey;186;3;189;52035
44;52;02;11;037;Bannes;370;3;373;52037
44;52;01;12;038;Bassoncourt;64;0;64;52038
44;52;03;09;039;Baudrecourt;89;0;89;52039
44;52;02;16;040;Bay-sur-Aube;54;1;55;52040
44;52;02;10;042;Beauchemin;107;1;108;52042
44;52;02;03;043;Belmont;58;2;60;52043
44;52;03;01;044;Roches-Bettaincourt;553;11;564;52044
44;52;03;15;045;Bettancourt-la-Ferrée;1792;39;1831;52045
44;52;03;09;047;Beurville;103;0;103;52047
44;52;01;11;050;Biesles;1340;31;1371;52050
44;52;02;03;051;Bize;85;4;89;52051
44;52;01;04;053;Blaisy;73;1;74;52053
44;52;03;09;055;Blécourt;115;2;117;52055
44;52;01;04;056;Blessonville;187;6;193;52056
44;52;03;09;057;Blumeray;104;4;108;52057
44;52;01;01;058;Bologne;1851;27;1878;52058
44;52;02;11;059;Bonnecourt;141;0;141;52059
44;52;02;02;060;Bourbonne-les-Bains;1977;53;2030;52060
44;52;01;01;061;Bourdons-sur-Rognon;291;2;293;52061
44;52;02;16;062;Bourg;160;4;164;52062
44;52;01;12;063;Bourg-Sainte-Marie;99;1;100;52063
44;52;01;12;064;Bourmont-entre-Meuse-et-Mouzon;781;34;815;52064
44;52;03;09;065;Bouzancourt;65;1;66;52065
44;52;03;09;066;Brachay;63;3;66;52066
44;52;01;12;067;Brainville-sur-Meuse;75;0;75;52067
44;52;01;04;069;Braux-le-Châtel;144;1;145;52069
44;52;02;16;070;Brennes;123;3;126;52070
44;52;01;05;072;Brethenay;379;10;389;52072
44;52;01;12;074;Breuvannes-en-Bassigny;673;20;693;52074
44;52;01;01;075;Briaucourt;177;6;183;52075
44;52;01;04;076;Bricon;448;14;462;52076
44;52;03;17;079;Brousseval;659;10;669;52079
44;52;01;04;082;Bugnières;155;5;160;52082
44;52;02;03;083;Champsevraine;737;14;751;52083
44;52;01;12;084;Busson;42;0;42;52084
44;52;01;02;085;Buxières-lès-Clefmont;26;2;28;52085
44;52;01;06;087;Buxières-lès-Villiers;197;20;217;52087
44;52;03;17;088;Ceffonds;645;21;666;52088
44;52;02;02;089;Celles-en-Bassigny;76;0;76;52089
44;52;02;03;090;Celsoy;102;1;103;52090
44;52;03;01;091;Cerisières;85;7;92;52091
44;52;02;16;092;Chalancey;105;2;107;52092
44;52;02;03;093;Chalindrey;2429;42;2471;52093
44;52;02;16;094;Vals-des-Tilles;178;2;180;52094
44;52;01;12;095;Chalvraines;190;2;192;52095
44;52;01;12;097;Chambroncourt;49;1;50;52097
44;52;03;08;099;Chamouilley;798;10;808;52099
44;52;01;12;101;Champigneulles-en-Bassigny;41;1;42;52101
44;52;02;10;102;Champigny-lès-Langres;422;13;435;52102
44;52;02;03;103;Champigny-sous-Varennes;113;2;115;52103
44;52;03;15;104;Chancenay;1045;23;1068;52104
44;52;02;11;105;Changey;300;11;311;52105
44;52;02;10;106;Chanoy;122;2;124;52106
44;52;01;01;107;Chantraines;226;5;231;52107
44;52;02;11;108;Charmes;146;4;150;52108
44;52;03;09;109;Charmes-en-l'Angle;7;0;7;52109
44;52;03;09;110;Charmes-la-Grande;153;6;159;52110
44;52;02;16;113;Chassigny;261;2;263;52113
44;52;01;04;114;Châteauvillain;1579;17;1596;52114
44;52;02;10;115;Chatenay-Mâcheron;99;2;101;52115
44;52;02;10;116;Chatenay-Vaudin;49;2;51;52116
44;52;03;09;118;Chatonrupt-Sommermont;279;6;285;52118
44;52;02;03;119;Chaudenay;345;9;354;52119
44;52;02;02;120;Chauffourt;189;7;196;52120
44;52;01;98;121;Chaumont;21847;1195;23042;52121
44;52;01;12;122;Chaumont-la-Ville;116;1;117;52122
44;52;03;08;123;Chevillon;1297;21;1318;52123
44;52;02;03;124;Chézeaux;76;0;76;52124
44;52;01;06;125;Chamarandes-Choignes;1042;172;1214;52125
44;52;02;16;126;Choilley-Dardenay;159;4;163;52126
44;52;01;02;127;Choiseul;78;4;82;52127
44;52;01;01;128;Cirey-lès-Mareilles;145;3;148;52128
44;52;03;09;129;Cirey-sur-Blaise;121;1;122;52129
44;52;01;04;130;Cirfontaines-en-Azois;189;1;190;52130
44;52;03;12;131;Cirfontaines-en-Ornois;74;1;75;52131
44;52;01;02;132;Clefmont;168;3;171;52132
44;52;01;12;133;Clinchamp;71;0;71;52133
44;52;02;16;134;Cohons;223;1;224;52134
44;52;02;03;135;Coiffy-le-Bas;88;0;88;52135
44;52;02;02;136;Coiffy-le-Haut;111;0;111;52136
44;52;02;16;137;Colmier-le-Bas;22;0;22;52137
44;52;02;16;138;Colmier-le-Haut;63;1;64;52138
44;52;01;04;140;Colombey les Deux Eglises;706;22;728;52140
44;52;01;05;141;Condes;298;6;304;52141
44;52;01;01;142;Consigny;72;1;73;52142
44;52;02;16;145;Coublanc;118;5;123;52145
44;52;01;04;146;Coupray;155;3;158;52146
44;52;02;16;147;Courcelles-en-Montagne;89;0;89;52147
44;52;03;09;149;Courcelles-sur-Blaise;93;2;95;52149
44;52;01;04;151;Cour-l'Evêque;148;2;150;52151
44;52;02;03;155;Culmont;513;12;525;52155
44;52;03;08;156;Curel;407;7;414;52156
44;52;01;04;157;Curmont;12;1;13;52157
44;52;02;16;158;Cusey;282;4;286;52158
44;52;01;11;159;Cuves;26;1;27;52159
44;52;01;01;160;Daillancourt;64;2;66;52160
44;52;01;02;161;Daillecourt;72;0;72;52161
44;52;02;02;162;Dammartin-sur-Meuse;197;2;199;52162
44;52;02;11;163;Dampierre;384;4;388;52163
44;52;02;02;164;Damrémont;197;5;202;52164
44;52;01;04;165;Dancevoir;194;5;199;52165
44;52;01;01;167;Darmannes;262;3;265;52167
44;52;01;04;168;Dinteville;60;3;63;52168
44;52;03;08;169;Domblain;78;2;80;52169
44;52;02;16;170;Dommarien;166;7;173;52170
44;52;03;17;171;Dommartin-le-Franc;243;3;246;52171
44;52;03;09;172;Dommartin-le-Saint-Père;280;7;287;52172
44;52;03;01;173;Domremy-Landéville;77;2;79;52173
44;52;01;12;174;Doncourt-sur-Meuse;37;1;38;52174
44;52;03;09;175;Donjeux;390;4;394;52175
44;52;03;01;177;Doulaincourt-Saucourt;790;34;824;52177
44;52;03;09;178;Doulevant-le-Château;362;10;372;52178
44;52;03;17;179;Doulevant-le-Petit;20;2;22;52179
44;52;03;12;181;Echenay;91;2;93;52181
44;52;03;13;182;Eclaron-Braucourt-Sainte-Livière;2017;46;2063;52182
44;52;01;01;183;Ecot-la-Combe;39;1;40;52183
44;52;03;12;184;Effincourt;59;5;64;52184
44;52;02;02;185;Enfonvelle;61;1;62;52185
44;52;03;12;187;Epizon;159;4;163;52187
44;52;02;16;189;Le Val-d'Esnoms;400;11;411;52189
44;52;01;11;190;Esnouveaux;286;5;291;52190
44;52;01;05;193;Euffigneix;302;13;315;52193
44;52;03;08;194;Eurville-Bienville;2033;33;2066;52194
44;52;02;03;195;Farincourt;37;0;37;52195
44;52;02;10;196;Faverolles;96;4;100;52196
44;52;02;03;197;Fayl-Billot;1298;96;1394;52197
44;52;03;08;198;Fays;70;3;73;52198
44;52;03;09;199;Ferrière-et-Lafolie;50;2;52;52199
44;52;02;16;200;Flagey;77;5;82;52200
44;52;03;09;201;Flammerécourt;69;0;69;52201
44;52;03;08;203;Fontaines-sur-Marne;146;2;148;52203
44;52;01;11;204;Forcey;63;4;67;52204
44;52;01;07;205;Foulain;687;17;704;52205
44;52;03;17;206;Frampas;154;4;158;52206
44;52;02;02;207;Frécourt;99;4;103;52207
44;52;02;02;208;Fresnes-sur-Apance;146;2;148;52208
44;52;01;01;211;Froncles;1449;23;1472;52211
44;52;03;09;212;Fronville;308;3;311;52212
44;52;02;03;213;Genevrières;131;6;137;52213
44;52;01;01;214;La Genevroye;31;1;32;52214
44;52;02;16;216;Germaines;47;1;48;52216
44;52;01;12;217;Germainvilliers;87;4;91;52217
44;52;03;12;218;Germay;48;0;48;52218
44;52;03;12;219;Germisay;18;0;18;52219
44;52;01;04;220;Giey-sur-Aujon;142;1;143;52220
44;52;01;04;221;Gillancourt;118;4;122;52221
44;52;03;12;222;Gillaumé;35;0;35;52222
44;52;02;03;223;Gilley;65;3;68;52223
44;52;01;12;227;Graffigny-Chemin;215;10;225;52227
44;52;02;03;228;Grandchamp;78;1;79;52228
44;52;02;03;229;Grenant;151;2;153;52229
44;52;03;09;230;Gudmont-Villiers;281;5;286;52230
44;52;03;09;231;Guindrecourt-aux-Ormes;91;2;93;52231
44;52;01;01;232;Guindrecourt-sur-Blaise;62;0;62;52232
44;52;02;03;233;Guyonvelle;104;2;106;52233
44;52;01;12;234;Hâcourt;41;0;41;52234
44;52;03;13;235;Hallignicourt;260;4;264;52235
44;52;01;12;237;Harréville-les-Chanteurs;278;10;288;52237
44;52;02;03;240;Heuilley-le-Grand;193;7;200;52240
44;52;02;03;242;Haute-Amance;962;16;978;52242
44;52;01;12;243;Huilliécourt;120;1;121;52243
44;52;03;13;244;Humbécourt;761;10;771;52244
44;52;01;12;245;Humberville;62;5;67;52245
44;52;02;10;246;Humes-Jorquenay;579;12;591;52246
44;52;01;12;247;Illoud;207;8;215;52247
44;52;01;02;248;Is-en-Bassigny;545;17;562;52248
44;52;02;16;249;Isômes;147;6;153;52249
44;52;03;09;250;Joinville;3015;68;3083;52250
44;52;01;05;251;Jonchery;995;35;1030;52251
44;52;01;04;253;Juzennecourt;212;3;215;52253
44;52;01;04;254;Lachapelle-en-Blaisy;85;3;88;52254
44;52;01;12;256;Lafauche;75;4;79;52256
44;52;02;03;257;Laferté-sur-Amance;105;2;107;52257
44;52;01;04;258;Laferté-sur-Aube;311;2;313;52258
44;52;01;01;260;Lamancine;123;3;126;52260
44;52;02;02;264;Laneuvelle;61;2;63;52264
44;52;03;08;265;Bayard-sur-Marne;1298;28;1326;52265
44;52;03;17;266;Laneuville-Ã -Rémy;66;0;66;52266
44;52;03;13;267;Laneuville-au-Pont;216;3;219;52267
44;52;02;10;269;Langres;7668;396;8064;52269
44;52;01;11;271;Lanques-sur-Rognon;197;6;203;52271
44;52;01;04;272;Lanty-sur-Aube;114;2;116;52272
44;52;02;02;273;Larivière-Arnoncourt;121;1;122;52273
44;52;01;04;274;Latrecey-Ormoy-sur-Aube;291;9;300;52274
44;52;02;02;275;Lavernoy;69;0;69;52275
44;52;01;06;276;Laville-aux-Bois;223;7;230;52276
44;52;02;02;277;Lavilleneuve;59;1;60;52277
44;52;01;04;278;Lavilleneuve-au-Roi;71;0;71;52278
44;52;02;10;280;Lecey;199;3;202;52280
44;52;01;04;282;Leffonds;340;5;345;52282
44;52;03;09;284;Leschères-sur-le-Blaiseron;94;1;95;52284
44;52;02;16;285;Leuchey;78;2;80;52285
44;52;01;12;286;Leurville;77;0;77;52286
44;52;01;12;287;Levécourt;88;1;89;52287
44;52;03;12;288;Lezéville;121;0;121;52288
44;52;01;12;289;Liffol-le-Petit;315;8;323;52289
44;52;02;03;290;Les Loges;132;2;134;52290
44;52;01;12;291;Longchamp;62;0;62;52291
44;52;02;16;292;Longeau-Percey;722;18;740;52292
44;52;03;13;294;Louvemont;696;13;709;52294
44;52;01;11;295;Louvières;94;0;94;52295
44;52;01;07;297;Luzy-sur-Marne;273;11;284;52297
44;52;02;16;298;Maâtz;73;1;74;52298
44;52;03;08;300;Magneux;163;2;165;52300
44;52;01;12;301;Maisoncelles;61;1;62;52301
44;52;03;08;302;Maizières;189;3;192;52302
44;52;02;03;303;Maizières-sur-Amance;95;1;96;52303
44;52;01;12;304;Malaincourt-sur-Meuse;52;1;53;52304
44;52;01;11;305;Mandres-la-Côte;553;5;558;52305
44;52;01;12;306;Manois;444;9;453;52306
44;52;02;10;307;Marac;214;4;218;52307
44;52;01;04;308;Maranville;403;4;407;52308
44;52;01;01;310;Marbéville;99;2;101;52310
44;52;02;02;311;Marcilly-en-Bassigny;224;4;228;52311
44;52;02;10;312;Mardor;53;3;56;52312
44;52;01;01;313;Mareilles;143;1;144;52313
44;52;01;11;315;Marnay-sur-Marne;336;1;337;52315
44;52;03;09;316;Mathons;69;2;71;52316
44;52;02;02;318;Melay;245;6;251;52318
44;52;01;12;319;Mennouveaux;71;0;71;52319
44;52;01;12;320;Merrey;94;3;97;52320
44;52;03;09;321;Mertrud;179;7;186;52321
44;52;01;01;322;Meures;132;4;136;52322
44;52;01;12;325;Millières;117;5;122;52325
44;52;01;01;326;Mirbel;43;0;43;52326
44;52;03;13;327;MoÃ«slains;444;10;454;52327
44;52;02;02;328;Montcharvot;32;1;33;52328
44;52;01;04;330;Montheries;68;2;70;52330
44;52;03;17;331;La Porte du Der;2282;65;2347;52331
44;52;02;02;332;Val-de-Meuse;1832;54;1886;52332
44;52;01;01;335;Montot-sur-Rognon;120;1;121;52335
44;52;03;17;336;Montreuil-sur-Blaise;147;3;150;52336
44;52;03;12;337;Montreuil-sur-Thonnance;59;0;59;52337
44;52;03;17;341;Morancourt;131;2;133;52341
44;52;01;12;342;Morionvilliers;27;1;28;52342
44;52;02;16;344;Mouilleron;31;1;32;52344
44;52;03;09;346;Mussey-sur-Marne;381;6;387;52346
44;52;03;08;347;Narcy;237;5;242;52347
44;52;02;11;348;Neuilly-l'Evêque;580;19;599;52348
44;52;01;07;349;Neuilly-sur-Suize;307;9;316;52349
44;52;02;02;350;Neuvelle-lès-Voisey;68;0;68;52350
44;52;01;11;352;Ninville;68;4;72;52352
44;52;01;11;353;Nogent;3591;61;3652;52353
44;52;02;03;354;Noidant-Chatenoy;84;0;84;52354
44;52;02;16;355;Noidant-le-Rocheux;151;4;155;52355
44;52;03;09;356;Nomécourt;108;4;112;52356
44;52;03;12;357;Noncourt-sur-le-Rongeant;177;2;179;52357
44;52;01;02;358;Noyers;90;0;90;52358
44;52;03;09;359;Nully;150;3;153;52359
44;52;02;16;360;Occey;165;3;168;52360
44;52;02;11;362;Orbigny-au-Mont;136;2;138;52362
44;52;02;11;363;Orbigny-au-Val;98;7;105;52363
44;52;02;16;364;Orcevaux;102;3;105;52364
44;52;01;04;365;Orges;345;3;348;52365
44;52;02;10;366;Ormancey;77;1;78;52366
44;52;01;01;367;Ormoy-lès-Sexfontaines;41;1;42;52367
44;52;01;12;369;Orquevaux;70;0;70;52369
44;52;03;08;370;Osne-le-Val;255;5;260;52370
44;52;01;01;371;Oudincourt;139;2;141;52371
44;52;01;12;372;Outremécourt;84;6;90;52372
44;52;01;12;373;Ozières;33;1;34;52373
44;52;02;03;374;Le Pailly;276;5;281;52374
44;52;02;03;375;Palaiseul;55;0;55;52375
44;52;03;12;376;Pansey;106;3;109;52376
44;52;02;02;377;Parnoy-en-Bassigny;288;8;296;52377
44;52;03;12;378;Paroy-sur-Saulx;46;2;48;52378
44;52;02;10;380;Peigney;382;4;386;52380
44;52;02;10;383;Perrancey-les-Vieux-Moulins;292;7;299;52383
44;52;02;16;384;Perrogney-les-Fontaines;112;0;112;52384
44;52;01;02;385;Perrusse;30;2;32;52385
44;52;03;13;386;Perthes;515;4;519;52386
44;52;02;03;388;Pierremont-sur-Amance;149;2;151;52388
44;52;02;03;390;Pisseloup;56;1;57;52390
44;52;03;17;391;Planrupt;306;8;314;52391
44;52;02;11;392;Plesnoy;115;2;117;52392
44;52;02;16;393;Poinsenot;55;0;55;52393
44;52;02;03;394;Poinson-lès-Fayl;213;9;222;52394
44;52;02;16;395;Poinson-lès-Grancey;55;0;55;52395
44;52;01;11;396;Poinson-lès-Nogent;140;3;143;52396
44;52;02;11;397;Poiseul;71;1;72;52397
44;52;03;12;398;Poissons;632;14;646;52398
44;52;01;04;399;Pont-la-Ville;105;7;112;52399
44;52;02;02;400;Le Châtelet-sur-Meuse;155;0;155;52400
44;52;01;11;401;Poulangy;367;12;379;52401
44;52;02;16;403;Praslay;78;1;79;52403
44;52;02;16;405;Le Montsaugeonnais;1188;22;1210;52405
44;52;02;03;406;Pressigny;198;5;203;52406
44;52;01;12;407;Prez-sous-Lafauche;281;7;288;52407
44;52;03;17;411;Rives Dervoises;1329;47;1376;52411
44;52;03;17;413;Rachecourt-Suzémont;106;2;108;52413
44;52;03;08;414;Rachecourt-sur-Marne;770;12;782;52414
44;52;02;02;415;Rançonnières;115;0;115;52415
44;52;01;02;416;Rangecourt;63;1;64;52416
44;52;01;04;419;Rennepont;131;5;136;52419
44;52;01;01;420;Reynel;126;1;127;52420
44;52;01;05;421;Riaucourt;477;9;486;52421
44;52;01;04;422;Richebourg;262;5;267;52422
44;52;01;01;423;Rimaucourt;671;8;679;52423
44;52;02;03;424;Rivières-le-Bois;69;0;69;52424
44;52;02;16;425;Rivière-les-Fosses;196;4;200;52425
44;52;01;04;426;Rizaucourt-Buchey;128;1;129;52426
44;52;01;01;428;Rochefort-sur-la-Côte;64;1;65;52428
44;52;03;08;429;Roches-sur-Marne;556;3;559;52429
44;52;02;16;431;Rochetaillée;168;2;170;52431
44;52;02;11;432;Rolampont;1413;30;1443;52432
44;52;01;12;433;Romain-sur-Meuse;91;1;92;52433
44;52;03;01;436;Rouécourt;49;1;50;52436
44;52;02;16;437;Rouelles;25;0;25;52437
44;52;02;03;438;Rougeux;104;2;106;52438
44;52;02;16;439;Rouvres-sur-Aube;76;1;77;52439
44;52;03;09;440;Rouvroy-sur-Marne;375;7;382;52440
44;52;03;09;442;Rupt;343;10;353;52442
44;52;03;12;443;Sailly;33;0;33;52443
44;52;01;12;444;Saint-Blin;352;10;362;52444
44;52;02;03;445;Saint-Broingt-le-Bois;69;2;71;52445
44;52;02;16;446;Saint-Broingt-les-Fosses;233;4;237;52446
44;52;02;10;447;Saint-Ciergues;183;2;185;52447
44;52;03;99;448;Saint-Dizier;22928;499;23427;52448
44;52;02;10;449;Saints-Geosmes;1116;32;1148;52449
44;52;02;16;450;Saint-Loup-sur-Aujon;129;4;133;52450
44;52;02;10;452;Saint-Martin-lès-Langres;109;0;109;52452
44;52;02;10;453;Saint-Maurice;132;1;133;52453
44;52;01;12;455;Saint-Thiébault;236;6;242;52455
44;52;03;09;456;Saint-Urbain-Maconcourt;638;10;648;52456
44;52;02;03;457;Saint-Vallier-sur-Marne;172;3;175;52457
44;52;01;11;459;Sarcey;113;1;114;52459
44;52;02;02;461;Sarrey;380;10;390;52461
44;52;03;12;463;Saudron;45;2;47;52463
44;52;02;03;464;Saulles;48;2;50;52464
44;52;02;02;465;Saulxures;130;0;130;52465
44;52;02;03;467;Savigny;59;2;61;52467
44;52;01;12;468;Semilly;110;4;114;52468
44;52;01;07;469;Semoutiers-Montsaon;741;16;757;52469
44;52;02;02;470;Serqueux;369;13;382;52470
44;52;01;01;472;Sexfontaines;141;0;141;52472
44;52;01;01;473;Signéville;90;1;91;52473
44;52;01;04;474;Silvarouvres;36;0;36;52474
44;52;03;08;475;Sommancourt;60;6;66;52475
44;52;01;12;476;Sommerécourt;81;3;84;52476
44;52;03;17;479;Sommevoire;664;18;682;52479
44;52;01;01;480;Soncourt-sur-Marne;362;8;370;52480
44;52;01;12;482;Soulaucourt-sur-Mouzon;97;2;99;52482
44;52;02;03;483;Soyers;68;1;69;52483
44;52;03;09;484;Suzannecourt;360;15;375;52484
44;52;02;16;486;Ternat;64;0;64;52486
44;52;03;17;487;Thilleux;70;3;73;52487
44;52;01;11;488;Thivet;271;0;271;52488
44;52;01;12;489;Thol-lès-Millières;35;1;36;52489
44;52;03;09;490;Thonnance-lès-Joinville;682;21;703;52490
44;52;03;12;491;Thonnance-les-Moulins;116;5;121;52491
44;52;02;03;492;Torcenay;554;14;568;52492
44;52;02;03;493;Tornay;30;0;30;52493
44;52;01;05;494;Treix;221;9;230;52494
44;52;03;09;495;Trémilly;85;1;86;52495
44;52;03;08;497;Troisfontaines-la-Ville;433;9;442;52497
44;52;02;16;499;Vaillant;43;0;43;52499
44;52;03;13;500;Valcourt;622;9;631;52500
44;52;03;08;502;Valleret;65;0;65;52502
44;52;02;03;503;Valleroy;25;0;25;52503
44;52;02;03;504;Varennes-sur-Amance;261;4;265;52504
44;52;01;12;505;Vaudrecourt;35;0;35;52505
44;52;01;04;506;Vaudrémont;96;3;99;52506
44;52;02;16;507;Vauxbons;56;0;56;52507
44;52;03;17;510;Vaux-sur-Blaise;372;7;379;52510
44;52;03;09;511;Vaux-sur-Saint-Urbain;56;2;58;52511
44;52;03;09;512;Vecqueville;512;15;527;52512
44;52;02;03;513;Velles;62;1;63;52513
44;52;01;07;514;Verbiesles;342;11;353;52514
44;52;02;16;515;Verseilles-le-Bas;103;4;107;52515
44;52;02;16;516;Verseilles-le-Haut;49;4;53;52516
44;52;01;12;517;Vesaignes-sous-Lafauche;134;1;135;52517
44;52;01;11;518;Vesaignes-sur-Marne;101;2;103;52518
44;52;02;16;519;Vesvres-sous-Chalancey;46;0;46;52519
44;52;02;02;520;Vicq;149;7;156;52520
44;52;01;01;522;Viéville;339;10;349;52522
44;52;01;01;523;Vignes-la-Côte;67;4;71;52523
44;52;01;01;524;Vignory;233;0;233;52524
44;52;01;04;525;Villars-en-Azois;69;1;70;52525
44;52;02;16;526;Villars-Santenoge;79;1;80;52526
44;52;03;17;528;Ville-en-Blaisois;146;1;147;52528
44;52;02;16;529;Villegusien-le-Lac;983;18;1001;52529
44;52;03;13;534;Villiers-en-Lieu;1498;36;1534;52534
44;52;01;06;535;Villiers-le-Sec;714;11;725;52535
44;52;02;16;536;Villiers-lès-Aprey;45;0;45;52536
44;52;01;04;538;Villiers-sur-Suize;263;2;265;52538
44;52;02;03;539;Violot;67;0;67;52539
44;52;02;16;540;Vitry-en-Montagne;22;0;22;52540
44;52;01;11;541;Vitry-lès-Nogent;204;4;208;52541
44;52;02;16;542;Vivey;52;1;53;52542
44;52;03;17;543;Voillecomte;516;10;526;52543
44;52;02;02;544;Voisey;277;2;279;52544
44;52;02;16;545;Voisines;107;2;109;52545
44;52;02;03;546;Voncourt;15;0;15;52546
44;52;01;01;547;Vouécourt;202;1;203;52547
44;52;01;01;548;Vraincourt;92;2;94;52548
44;52;01;12;549;Vroncourt-la-Côte;27;0;27;52549
44;52;03;17;550;Wassy;2819;110;2929;52550
52;53;02;08;001;Ahuillé;1831;59;1890;53001
52;53;03;14;002;Alexain;606;9;615;53002
52;53;03;07;003;Ambrières-les-Vallées;2639;69;2708;53003
52;53;03;05;005;Andouillé;2319;50;2369;53005
52;53;02;02;007;Argentré;2825;75;2900;53007
52;53;03;09;008;Aron;1819;50;1869;53008
52;53;01;15;009;Arquenay;659;14;673;53009
52;53;03;06;010;Assé-le-Bérenger;460;13;473;53010
52;53;01;04;011;Astillé;879;19;898;53011
52;53;01;04;012;Athée;476;26;502;53012
52;53;03;17;013;Averton;564;16;580;53013
52;53;03;05;015;La Baconnière;1923;44;1967;53015
52;53;03;06;016;Bais;1224;14;1238;53016
52;53;01;15;017;Val-du-Maine;956;27;983;53017
52;53;01;04;018;Ballots;1298;32;1330;53018
52;53;01;15;019;Bannes;118;3;121;53019
52;53;03;09;021;La Bazoge-Montpinçon;1047;28;1075;53021
52;53;01;15;022;La Bazouge-de-Chemeré;516;10;526;53022
52;53;03;06;023;La Bazouge-des-Alleux;561;6;567;53023
52;53;01;15;025;Bazougers;1096;12;1108;53025
52;53;02;13;026;Beaulieu-sur-Oudon;529;9;538;53026
52;53;01;15;027;Beaumont-Pied-de-BÅ“uf;203;3;206;53027
52;53;03;09;028;Belgeard;585;12;597;53028
52;53;01;01;029;Bierné-les-Villages;1252;32;1284;53029
52;53;01;15;030;Le Bignon-du-Maine;325;4;329;53030
52;53;03;05;031;La Bigottière;496;2;498;53031
52;53;01;04;033;La Boissière;115;5;120;53033
52;53;02;02;034;Bonchamp-lès-Laval;6137;193;6330;53034
52;53;01;03;035;Bouchamps-lès-Craon;587;9;596;53035
52;53;01;15;036;Bouère;1065;20;1085;53036
52;53;01;15;037;Bouessay;729;26;755;53037
52;53;03;17;038;Boulay-les-Ifs;143;4;147;53038
52;53;02;13;039;Le Bourgneuf-la-Forêt;1736;36;1772;53039
52;53;02;13;040;Bourgon;630;12;642;53040
52;53;01;04;041;Brains-sur-les-Marches;277;5;282;53041
52;53;03;07;042;Brecé;844;12;856;53042
52;53;03;06;043;Brée;554;11;565;53043
52;53;02;13;045;La Brûlatte;682;18;700;53045
52;53;01;15;046;Le Buret;307;3;310;53046
52;53;03;07;047;Carelles;269;4;273;53047
52;53;03;05;048;Chailland;1155;34;1189;53048
52;53;02;02;049;Châlons-du-Maine;711;8;719;53049
52;53;03;09;051;Champéon;600;6;606;53051
52;53;03;17;052;Champfrémont;293;7;300;53052
52;53;03;06;053;Champgenéteux;505;21;526;53053
52;53;02;16;054;Changé;6209;198;6407;53054
52;53;03;07;055;Chantrigné;606;15;621;53055
52;53;02;02;056;La Chapelle-Anthenaise;983;26;1009;53056
52;53;03;09;057;La Chapelle-au-Riboul;507;10;517;53057
52;53;01;04;058;La Chapelle-Craonnaise;336;13;349;53058
52;53;03;15;059;La Chapelle-Rainsouin;413;6;419;53059
52;53;03;09;061;Charchigné;464;6;470;53061
52;53;01;88;062;Château-Gontier-sur-Mayenne;16950;666;17616;53062
52;53;01;01;063;Châtelain;455;14;469;53063
52;53;03;07;064;Châtillon-sur-Colmont;979;24;1003;53064
52;53;01;01;066;Chemazé;1381;32;1413;53066
52;53;01;15;067;Chémeré-le-Roi;395;12;407;53067
52;53;01;03;068;Chérancé;155;1;156;53068
52;53;03;17;069;Chevaigné-du-Maine;160;5;165;53069
52;53;03;07;071;Colombiers-du-Plessis;484;22;506;53071
52;53;03;09;072;Commer;1253;28;1281;53072
52;53;01;04;073;Congrier;887;23;910;53073
52;53;03;14;074;Contest;842;35;877;53074
52;53;01;04;075;Cosmes;275;7;282;53075
52;53;01;15;076;Cossé-en-Champagne;329;11;340;53076
52;53;01;04;077;Cossé-le-Vivien;3199;77;3276;53077
52;53;01;01;078;Coudray;852;16;868;53078
52;53;03;07;079;Couesmes-Vaucé;378;11;389;53079
52;53;03;17;080;Couptrain;133;2;135;53080
52;53;01;04;082;Courbeveille;640;13;653;53082
52;53;03;17;083;Courcité;854;29;883;53083
52;53;01;03;084;Craon;4486;178;4664;53084
52;53;03;17;085;Crennes-sur-Fraubée;194;2;196;53085
52;53;03;05;086;La Croixille;652;12;664;53086
52;53;01;15;087;La Cropte;210;4;214;53087
52;53;01;04;088;Cuillé;842;29;871;53088
52;53;01;01;089;Daon;509;5;514;53089
52;53;01;03;090;Denazé;159;5;164;53090
52;53;03;07;091;Désertines;456;15;471;53091
52;53;03;07;093;La Dorée;272;5;277;53093
52;53;02;08;094;Entrammes;2255;41;2296;53094
52;53;03;05;096;Ernée;5717;96;5813;53096
52;53;03;06;097;Evron;8614;229;8843;53097
52;53;01;04;098;Fontaine-Couverte;432;9;441;53098
52;53;02;08;099;Forcé;1096;33;1129;53099
52;53;03;07;100;Fougerolles-du-Plessis;1176;15;1191;53100
52;53;01;01;101;Fromentières;836;11;847;53101
52;53;01;04;102;Gastines;168;2;170;53102
52;53;02;13;103;Le Genest-Saint-Isle;2134;58;2192;53103
52;53;01;01;104;Gennes-Longuefuye;1330;23;1353;53104
52;53;03;02;105;Gesnes;230;5;235;53105
52;53;03;17;106;Gesvres;509;11;520;53106
52;53;03;07;107;Gorron;2552;55;2607;53107
52;53;02;13;108;La Gravelle;563;6;569;53108
52;53;03;09;109;Grazay;621;17;638;53109
52;53;01;15;110;Grez-en-Bouère;997;19;1016;53110
52;53;03;09;111;La Haie-Traversaine;464;14;478;53111
52;53;03;17;112;Le Ham;393;7;400;53112
52;53;03;06;113;Hambers;611;14;625;53113
52;53;03;09;114;Hardanges;204;2;206;53114
52;53;03;07;115;Hercé;313;12;325;53115
52;53;03;09;116;Le Horps;720;18;738;53116
52;53;01;01;117;Houssay;499;5;504;53117
52;53;03;09;118;Le Housseau-Brétignolles;235;2;237;53118
52;53;02;08;119;L'Huisserie;4326;157;4483;53119
52;53;03;06;120;Izé;455;10;465;53120
52;53;03;17;121;Javron-les-Chapelles;1379;30;1409;53121
52;53;03;09;122;Jublains;750;17;767;53122
52;53;03;05;123;Juvigné;1465;14;1479;53123
52;53;01;03;124;Prée-d'Anjou;1393;43;1436;53124
52;53;03;07;125;Landivy;1156;22;1178;53125
52;53;03;05;126;Larchamp;1115;16;1131;53126
52;53;03;09;127;Lassay-les-Châteaux;2234;58;2292;53127
52;53;01;04;128;Laubrières;364;4;368;53128
52;53;02;13;129;Launay-Villiers;383;5;388;53129
52;53;02;99;130;Laval;49733;2637;52370;53130
52;53;03;07;131;Lesbois;194;2;196;53131
52;53;03;07;132;Levaré;285;11;296;53132
52;53;03;17;133;Lignières-Orgères;718;17;735;53133
52;53;03;06;134;Livet;172;1;173;53134
52;53;01;04;135;Livré-la-Touche;736;23;759;53135
52;53;01;01;136;La Roche-Neuville;1194;38;1232;53136
52;53;02;13;137;Loiron-Ruillé;2745;63;2808;53137
52;53;03;17;139;Loupfougères;412;6;418;53139
52;53;02;02;140;Louverné;4375;96;4471;53140
52;53;02;08;141;Louvigné;1150;31;1181;53141
52;53;03;17;142;Madré;291;6;297;53142
52;53;01;15;143;Maisoncelles-du-Maine;516;11;527;53143
52;53;03;09;144;Marcillé-la-Ville;761;24;785;53144
52;53;01;03;145;Marigné-Peuton;546;14;560;53145
52;53;03;09;146;Martigné-sur-Mayenne;1914;28;1942;53146
52;53;03;14;147;Mayenne;12823;680;13503;53147
52;53;01;03;148;Mée;235;1;236;53148
52;53;01;01;150;Ménil;905;28;933;53150
52;53;01;04;151;Méral;1110;15;1125;53151
52;53;01;15;152;Meslay-du-Maine;2808;71;2879;53152
52;53;03;06;153;Mézangers;635;13;648;53153
52;53;03;07;154;Montaudin;912;15;927;53154
52;53;03;05;155;Montenay;1363;24;1387;53155
52;53;02;02;156;Montflours;252;8;260;53156
52;53;02;08;157;Montigné-le-Brillant;1322;53;1375;53157
52;53;02;13;158;Montjean;1039;20;1059;53158
52;53;03;09;160;Montreuil-Poulay;374;7;381;53160
52;53;03;06;161;Montsûrs;3162;62;3224;53161
52;53;03;09;162;Moulay;990;17;1007;53162
52;53;03;06;163;Neau;778;4;782;53163
52;53;03;17;164;Neuilly-le-Vendin;345;8;353;53164
52;53;01;03;165;Niafles;354;7;361;53165
52;53;02;08;168;Nuillé-sur-Vicoin;1206;25;1231;53168
52;53;02;13;169;Olivet;414;9;423;53169
52;53;03;07;170;Oisseau;1158;25;1183;53170
52;53;01;01;172;Origné;410;9;419;53172
52;53;03;17;173;La Pallu;181;6;187;53173
52;53;03;14;174;Parigné-sur-Braye;840;23;863;53174
52;53;02;08;175;Parné-sur-Roc;1371;48;1419;53175
52;53;03;07;176;Le Pas;549;11;560;53176
52;53;03;05;177;La Pellerine;305;5;310;53177
52;53;01;03;178;Peuton;229;10;239;53178
52;53;03;14;179;Placé;352;8;360;53179
52;53;01;03;180;Pommerieux;642;28;670;53180
52;53;03;07;181;Pontmain;813;14;827;53181
52;53;02;13;182;Port-Brillet;1799;27;1826;53182
52;53;01;15;184;Préaux;163;7;170;53184
52;53;03;17;185;Pré-en-Pail-Saint-Samson;2291;87;2378;53185
52;53;01;04;186;Quelaines-Saint-Gault;2121;64;2185;53186
52;53;03;17;187;Ravigny;229;13;242;53187
52;53;01;04;188;Renazé;2529;58;2587;53188
52;53;03;09;189;Rennes-en-Grenouilles;103;2;105;53189
52;53;03;09;190;Le Ribay;465;10;475;53190
52;53;01;04;191;La RoÃ«;248;2;250;53191
52;53;01;04;192;La Rouaudière;318;4;322;53192
52;53;01;15;193;Ruillé-Froid-Fonds;566;11;577;53193
52;53;03;02;195;Sacé;500;8;508;53195
52;53;03;17;196;Saint-Aignan-de-Couptrain;359;12;371;53196
52;53;01;04;197;Saint-Aignan-sur-RoÃ«;901;24;925;53197
52;53;03;17;198;Saint-Aubin-du-Désert;229;7;236;53198
52;53;03;07;199;Saint-Aubin-Fosse-Louvain;216;4;220;53199
52;53;03;14;200;Saint-Baudelle;1146;57;1203;53200
52;53;02;16;201;Saint-Berthevin;7353;259;7612;53201
52;53;03;07;202;Saint-Berthevin-la-Tannière;308;3;311;53202
52;53;01;15;203;Saint-Brice;525;13;538;53203
52;53;03;17;204;Saint-Calais-du-Désert;388;12;400;53204
52;53;01;15;206;Saint-Charles-la-Forêt;200;10;210;53206
52;53;03;17;208;Saint-Cyr-en-Pail;494;17;511;53208
52;53;02;13;209;Saint-Cyr-le-Gravelais;559;14;573;53209
52;53;01;01;210;Saint-Denis-d'Anjou;1548;30;1578;53210
52;53;03;05;211;Saint-Denis-de-Gastines;1447;33;1480;53211
52;53;01;15;212;Saint-Denis-du-Maine;429;9;438;53212
52;53;03;07;213;Saint-Ellier-du-Maine;494;8;502;53213
52;53;01;04;214;Saint-Erblon;166;4;170;53214
52;53;03;09;216;Saint-Fraimbault-de-Prières;993;27;1020;53216
52;53;03;06;218;Sainte-Gemmes-le-Robert;798;25;823;53218
52;53;03;14;219;Saint-Georges-Buttavent;1412;40;1452;53219
52;53;03;15;220;Saint-Georges-le-Fléchard;392;8;400;53220
52;53;03;06;221;Saint-Georges-sur-Erve;391;9;400;53221
52;53;03;14;222;Saint-Germain-d'Anxure;365;8;373;53222
52;53;03;17;223;Saint-Germain-de-Coulamer;335;9;344;53223
52;53;02;16;224;Saint-Germain-le-Fouilloux;1184;31;1215;53224
52;53;03;05;225;Saint-Germain-le-Guillaume;512;10;522;53225
52;53;03;05;226;Saint-Hilaire-du-Maine;832;32;864;53226
52;53;03;15;228;Blandouet-Saint Jean;576;14;590;53228
52;53;02;16;229;Saint-Jean-sur-Mayenne;1652;48;1700;53229
52;53;03;09;230;Saint-Julien-du-Terroux;223;9;232;53230
52;53;03;15;232;Saint-Léger;311;3;314;53232
52;53;01;15;233;Saint-Loup-du-Dorat;340;2;342;53233
52;53;03;07;234;Saint-Loup-du-Gast;370;13;383;53234
52;53;03;09;235;Sainte-Marie-du-Bois;227;4;231;53235
52;53;03;17;236;Saint-Mars-du-Désert;170;1;171;53236
52;53;03;07;237;Saint-Mars-sur-Colmont;454;13;467;53237
52;53;03;07;238;Saint-Mars-sur-la-Futaie;519;10;529;53238
52;53;01;04;240;Saint-Martin-du-Limet;437;6;443;53240
52;53;01;04;242;Saint-Michel-de-la-RoÃ«;260;3;263;53242
52;53;02;13;243;Saint-OuÃ«n-des-Toits;1782;36;1818;53243
52;53;03;05;245;Saint-Pierre-des-Landes;922;27;949;53245
52;53;03;17;246;Saint-Pierre-des-Nids;1853;33;1886;53246
52;53;02;13;247;Saint-Pierre-la-Cour;2265;44;2309;53247
52;53;03;15;248;Saint-Pierre-sur-Erve;141;3;144;53248
52;53;03;06;249;Vimartin-sur-Orthe;1113;14;1127;53249
52;53;01;04;250;Saint-Poix;407;6;413;53250
52;53;01;03;251;Saint-Quentin-les-Anges;464;8;472;53251
52;53;01;04;253;Saint-Saturnin-du-Limet;515;5;520;53253
52;53;03;15;255;Sainte-Suzanne-et-Chammes;1278;31;1309;53255
52;53;03;06;256;Saint-Thomas-de-Courceriers;172;4;176;53256
52;53;03;15;257;Saulges;318;8;326;53257
52;53;01;04;258;La Selle-Craonnaise;912;28;940;53258
52;53;01;04;259;Senonnes;347;8;355;53259
52;53;01;04;260;Simplé;415;1;416;53260
52;53;03;07;261;Soucé;167;3;170;53261
52;53;02;08;262;Soulgé-sur-Ouette;1109;34;1143;53262
52;53;03;09;263;ThubÅ“uf;280;8;288;53263
52;53;03;15;264;Thorigné-en-Charnie;194;3;197;53264
52;53;03;15;265;Torcé-Viviers-en-Charnie;765;15;780;53265
52;53;03;06;266;Trans;227;4;231;53266
52;53;03;15;267;Vaiges;1166;32;1198;53267
52;53;03;05;269;Vautorte;609;5;614;53269
52;53;03;07;270;Vieuvy;108;8;116;53270
52;53;03;17;271;Villaines-la-Juhel;2738;42;2780;53271
52;53;03;17;272;Villepail;185;1;186;53272
52;53;01;15;273;Villiers-Charlemagne;1087;22;1109;53273
52;53;03;06;276;Voutré;924;15;939;53276
44;54;03;02;001;Abaucourt;296;3;299;54001
44;54;01;17;002;Abbéville-lès-Conflans;232;4;236;54002
44;54;04;10;003;Aboncourt;96;4;100;54003
44;54;01;17;004;Affléville;178;2;180;54004
44;54;03;10;005;Affracourt;109;1;110;54005
44;54;03;03;006;Agincourt;442;7;449;54006
44;54;04;16;007;Aingeray;520;3;523;54007
44;54;04;10;008;Allain;472;14;486;54008
44;54;01;04;009;Allamont;167;3;170;54009
44;54;04;10;010;Allamps;499;13;512;54010
44;54;01;11;011;Allondrelle-la-Malmaison;654;2;656;54011
44;54;03;03;012;Amance;350;5;355;54012
44;54;02;01;013;Amenoncourt;83;2;85;54013
44;54;02;01;014;Ancerviller;264;14;278;54014
44;54;01;17;015;Anderny;259;6;265;54015
44;54;04;16;016;Andilly;288;7;295;54016
44;54;02;01;017;Angomont;76;1;77;54017
44;54;01;17;018;Anoux;271;7;278;54018
44;54;04;16;019;Ansauville;79;1;80;54019
44;54;02;08;020;Anthelupt;452;6;458;54020
44;54;03;02;021;Armaucourt;231;1;232;54021
44;54;04;18;022;Arnaville;563;10;573;54022
44;54;02;01;023;Arracourt;248;2;250;54023
44;54;03;02;024;Arraye-et-Han;363;6;369;54024
44;54;03;03;025;Art-sur-Meurthe;1591;208;1799;54025
44;54;02;01;026;Athienville;177;3;180;54026
44;54;03;18;027;Atton;872;12;884;54027
44;54;01;04;028;Auboué;2617;18;2635;54028
44;54;01;17;029;Audun-le-Roman;2462;48;2510;54029
44;54;02;01;030;Autrepierre;82;0;82;54030
44;54;03;02;031;Autreville-sur-Moselle;266;5;271;54031
44;54;03;10;032;Autrey;187;4;191;54032
44;54;01;17;033;Avillers;129;0;129;54033
44;54;04;16;034;Avrainville;215;10;225;54034
44;54;02;01;035;Avricourt;387;3;390;54035
44;54;01;17;036;Avril;1150;17;1167;54036
44;54;03;05;037;Azelot;424;2;426;54037
44;54;02;01;038;Azerailles;755;18;773;54038
44;54;02;01;039;Baccarat;4192;61;4253;54039
44;54;02;01;040;Badonviller;1553;32;1585;54040
44;54;04;10;041;Bagneux;145;7;152;54041
44;54;03;10;042;Bainville-aux-Miroirs;284;2;286;54042
44;54;03;15;043;Bainville-sur-Madon;1427;18;1445;54043
44;54;02;01;044;Barbas;195;2;197;54044
44;54;02;09;045;Barbonville;433;7;440;54045
44;54;04;10;046;Barisey-au-Plain;395;8;403;54046
44;54;04;10;047;Barisey-la-Côte;249;6;255;54047
44;54;01;17;048;Les Baroches;351;15;366;54048
44;54;01;11;049;Baslieux;538;14;552;54049
44;54;02;01;050;Bathelémont;65;1;66;54050
44;54;01;04;051;Batilly;1272;21;1293;54051
44;54;04;10;052;Battigny;148;2;150;54052
44;54;02;08;053;Bauzemont;156;6;162;54053
44;54;02;09;054;Bayon;1557;18;1575;54054
44;54;04;18;055;Bayonville-sur-Mad;320;5;325;54055
44;54;01;11;056;Bazailles;141;2;143;54056
44;54;04;16;057;Beaumont;75;0;75;54057
44;54;01;17;058;Béchamps;89;2;91;54058
44;54;03;02;059;Belleau;755;10;765;54059
44;54;03;02;060;Belleville;1465;16;1481;54060
44;54;02;01;061;Bénaménil;584;11;595;54061
44;54;03;10;062;Benney;657;10;667;54062
44;54;04;16;063;Bernécourt;174;4;178;54063
44;54;02;01;064;Bertrambois;315;6;321;54064
44;54;02;01;065;Bertrichamps;1095;23;1118;54065
44;54;01;17;066;Bettainvillers;405;2;407;54066
44;54;01;11;067;Beuveille;758;11;769;54067
44;54;04;10;068;Beuvezin;93;2;95;54068
44;54;01;17;069;Beuvillers;439;8;447;54069
44;54;03;02;070;Bey-sur-Seille;174;0;174;54070
44;54;02;01;071;Bezange-la-Grande;158;1;159;54071
44;54;03;02;072;Bezaumont;259;5;264;54072
44;54;04;20;073;Bicqueley;918;15;933;54073
44;54;02;08;074;Bienville-la-Petite;37;0;37;54074
44;54;02;01;075;Bionville;118;2;120;54075
44;54;02;09;076;Blainville-sur-l'Eau;3973;46;4019;54076
44;54;02;01;077;Blâmont;1063;12;1075;54077
44;54;02;01;078;Blémerey;57;1;58;54078
44;54;03;18;079;Blénod-lès-Pont-Ã -Mousson;4628;31;4659;54079
44;54;04;10;080;Blénod-lès-Toul;1045;19;1064;54080
44;54;01;11;081;Boismont;422;6;428;54081
44;54;01;04;082;Boncourt;170;3;173;54082
44;54;02;08;083;Bonviller;177;3;180;54083
44;54;01;17;084;Mont-Bonvillers;945;14;959;54084
44;54;02;09;085;Borville;89;2;91;54085
44;54;04;16;086;Boucq;354;11;365;54086
44;54;04;16;087;Bouillonville;151;1;152;54087
44;54;04;16;088;Bouvron;240;1;241;54088
44;54;03;03;089;Bouxières-aux-Chênes;1417;20;1437;54089
44;54;03;02;090;Bouxières-aux-Dames;4159;41;4200;54090
44;54;03;18;091;Bouxières-sous-Froidmont;389;4;393;54091
44;54;03;10;092;Bouzanville;64;1;65;54092
44;54;01;04;093;Brainville;168;2;170;54093
44;54;03;10;094;Bralleville;173;3;176;54094
44;54;03;02;095;Bratte;46;0;46;54095
44;54;01;23;096;Bréhain-la-Ville;429;9;438;54096
44;54;02;01;097;Bréménil;102;3;105;54097
44;54;02;09;098;Brémoncourt;167;3;170;54098
44;54;01;17;099;Val de Briey;8069;231;8300;54099
44;54;03;02;100;Brin-sur-Seille;780;12;792;54100
44;54;02;01;101;Brouville;129;1;130;54101
44;54;04;16;102;Bruley;609;15;624;54102
44;54;01;04;103;Bruville;224;5;229;54103
44;54;03;03;104;Buissoncourt;260;2;262;54104
44;54;04;10;105;Bulligny;527;15;542;54105
44;54;02;01;106;Bures;62;2;64;54106
44;54;02;01;107;Buriville;74;3;77;54107
44;54;03;05;108;Burthecourt-aux-Chênes;130;4;134;54108
44;54;03;10;109;Ceintrey;933;12;945;54109
44;54;03;03;110;Cerville;562;12;574;54110
44;54;03;15;111;Chaligny;2826;19;2845;54111
44;54;01;04;112;Chambley-Bussières;706;9;715;54112
44;54;03;03;113;Champenoux;1490;15;1505;54113
44;54;03;18;114;Champey-sur-Moselle;332;5;337;54114
44;54;03;21;115;Champigneulles;6671;65;6736;54115
44;54;02;09;116;Chanteheux;2159;43;2202;54116
44;54;03;10;117;Chaouilley;115;3;118;54117
44;54;01;11;118;Charency-Vezin;600;10;610;54118
44;54;04;16;119;Charey;87;3;90;54119
44;54;04;20;120;Charmes-la-Côte;328;8;336;54120
44;54;02;09;121;Charmois;191;3;194;54121
44;54;04;20;122;Chaudeney-sur-Moselle;729;17;746;54122
44;54;03;15;123;Chavigny;1739;10;1749;54123
44;54;02;01;124;Chazelles-sur-Albe;45;3;48;54124
44;54;02;01;125;Chenevières;490;8;498;54125
44;54;03;02;126;Chenicourt;221;1;222;54126
44;54;01;07;127;Chenières;631;19;650;54127
44;54;04;20;128;Choloy-Ménillot;717;7;724;54128
44;54;02;01;129;Cirey-sur-Vezouze;1610;25;1635;54129
44;54;02;09;130;Clayeures;181;1;182;54130
44;54;03;02;131;Clémery;496;10;506;54131
44;54;03;10;132;Clérey-sur-Brenon;63;2;65;54132
44;54;02;01;133;Coincourt;119;4;123;54133
44;54;01;11;134;Colmey;244;7;251;54134
44;54;04;10;135;Colombey-les-Belles;1449;20;1469;54135
44;54;01;04;136;Conflans-en-Jarnisy;2383;33;2416;54136
44;54;01;11;137;Cons-la-Grandville;507;17;524;54137
44;54;01;11;138;Cosnes-et-Romain;2741;56;2797;54138
44;54;02;08;139;Courbesseaux;366;2;368;54139
44;54;04;10;140;Courcelles;96;0;96;54140
44;54;03;05;141;Coyviller;149;2;151;54141
44;54;03;10;142;Crantenoy;158;2;160;54142
44;54;04;10;143;Crépey;391;7;398;54143
44;54;03;10;144;Crévéchamps;398;3;401;54144
44;54;02;08;145;Crévic;931;12;943;54145
44;54;04;10;146;Crézilles;294;3;297;54146
44;54;02;08;147;Crion;104;2;106;54147
44;54;02;08;148;Croismare;647;8;655;54148
44;54;01;23;149;Crusnes;1568;12;1580;54149
44;54;03;02;150;Custines;3082;28;3110;54150
44;54;01;07;151;Cutry;1042;28;1070;54151
44;54;02;09;152;Damelevières;3155;45;3200;54152
44;54;01;04;153;Dampvitoux;55;0;55;54153
44;54;02;01;154;Deneuvre;491;21;512;54154
44;54;02;08;155;Deuxville;410;7;417;54155
44;54;03;10;156;Diarville;502;17;519;54156
44;54;03;02;157;Dieulouard;4772;45;4817;54157
44;54;04;10;158;Dolcourt;133;2;135;54158
44;54;03;08;159;Dombasle-sur-Meurthe;9668;189;9857;54159
44;54;04;16;160;Domèvre-en-Haye;403;9;412;54160
44;54;02;01;161;Domèvre-sur-Vezouze;311;10;321;54161
44;54;04;20;162;Domgermain;1164;14;1178;54162
44;54;02;01;163;Domjevin;258;2;260;54163
44;54;03;10;164;Dommarie-Eulmont;87;2;89;54164
44;54;03;19;165;Dommartemont;575;28;603;54165
44;54;04;16;166;Dommartin-la-Chaussée;32;2;34;54166
44;54;04;20;167;Dommartin-lès-Toul;1951;37;1988;54167
44;54;03;03;168;Dommartin-sous-Amance;287;2;289;54168
44;54;01;17;169;Domprix;93;3;96;54169
44;54;02;09;170;Domptail-en-l'Air;71;1;72;54170
44;54;01;04;171;Doncourt-lès-Conflans;1158;21;1179;54171
44;54;01;11;172;Doncourt-lès-Longuyon;290;7;297;54172
44;54;02;08;173;Drouville;212;4;216;54173
44;54;04;20;174;Ecrouves;4428;53;4481;54174
44;54;02;09;175;Einvaux;370;3;373;54175
44;54;02;08;176;Einville-au-Jard;1116;22;1138;54176
44;54;02;01;177;Emberménil;257;3;260;54177
44;54;01;11;178;Epiez-sur-Chiers;194;3;197;54178
44;54;03;02;179;Eply;302;4;306;54179
44;54;03;03;180;Erbéviller-sur-Amezule;72;2;74;54180
44;54;01;23;181;Errouville;699;17;716;54181
44;54;04;16;182;Essey-et-Maizerais;332;10;342;54182
44;54;02;09;183;Essey-la-Côte;78;0;78;54183
44;54;03;19;184;Essey-lès-Nancy;8833;188;9021;54184
44;54;03;10;185;Etreval;60;1;61;54185
44;54;03;03;186;Eulmont;1105;21;1126;54186
44;54;04;16;187;Euvezin;113;1;114;54187
44;54;03;02;188;Faulx;1367;10;1377;54188
44;54;04;10;189;Favières;597;8;605;54189
44;54;04;10;190;Fécocourt;112;3;115;54190
44;54;02;01;191;Fenneviller;101;2;103;54191
44;54;03;09;192;Ferrières;301;4;305;54192
44;54;03;18;193;Fey-en-Haye;77;1;78;54193
44;54;01;23;194;Fillières;512;9;521;54194
44;54;02;08;195;Flainval;203;0;203;54195
44;54;03;15;196;Flavigny-sur-Moselle;1735;134;1869;54196
44;54;03;05;197;Fléville-devant-Nancy;2225;25;2250;54197
44;54;01;17;198;Fléville-Lixières;309;5;314;54198
44;54;02;01;199;Flin;382;11;393;54199
44;54;04;16;200;Flirey;156;1;157;54200
44;54;02;01;201;Fontenoy-la-Joûte;309;3;312;54201
44;54;04;16;202;Fontenoy-sur-Moselle;376;4;380;54202
44;54;03;10;203;Forcelles-Saint-Gorgon;138;3;141;54203
44;54;03;10;204;Forcelles-sous-Gugney;93;2;95;54204
44;54;04;20;205;Foug;2629;30;2659;54205
44;54;02;09;206;Fraimbois;391;5;396;54206
44;54;03;10;207;Fraisnes-en-Saintois;100;2;102;54207
44;54;04;16;208;Francheville;288;2;290;54208
44;54;02;09;209;Franconville;71;0;71;54209
44;54;02;01;210;Fréménil;211;4;215;54210
44;54;02;01;211;Frémonville;189;2;191;54211
44;54;01;11;212;Fresnois-la-Montagne;413;13;426;54212
44;54;01;04;213;Friauville;367;5;372;54213
44;54;03;15;214;Frolois;700;6;706;54214
44;54;03;21;215;Frouard;6584;78;6662;54215
44;54;02;09;216;Froville;125;0;125;54216
44;54;02;01;217;Gélacourt;169;2;171;54217
44;54;04;10;218;Gélaucourt;58;1;59;54218
44;54;03;03;219;Gellenoncourt;79;0;79;54219
44;54;04;10;220;Gémonville;79;0;79;54220
44;54;03;10;221;Gerbécourt-et-Haplemont;230;1;231;54221
44;54;02;09;222;Gerbéviller;1328;23;1351;54222
44;54;04;10;223;Germiny;218;7;225;54223
44;54;03;10;224;Germonville;123;1;124;54224
44;54;04;16;225;Gézoncourt;179;3;182;54225
44;54;04;10;226;Gibeaumeix;171;3;174;54226
44;54;01;04;227;Giraumont;1346;17;1363;54227
44;54;02;09;228;Giriviller;70;3;73;54228
44;54;02;01;229;Glonville;366;5;371;54229
44;54;02;01;230;Gogney;50;0;50;54230
44;54;01;17;231;Gondrecourt-Aix;175;3;178;54231
44;54;04;16;232;Gondreville;2712;50;2762;54232
44;54;02;01;233;Gondrexon;37;2;39;54233
44;54;01;11;234;Gorcy;2877;45;2922;54234
44;54;03;10;235;Goviller;421;9;430;54235
44;54;01;11;236;Grand-Failly;352;8;360;54236
44;54;04;10;237;Grimonviller;86;3;89;54237
44;54;03;10;238;Gripport;271;1;272;54238
44;54;04;16;239;Griscourt;137;2;139;54239
44;54;04;16;240;Grosrouvres;57;0;57;54240
44;54;03;10;241;Gugney;75;3;78;54241
44;54;04;20;242;Gye;272;4;276;54242
44;54;02;01;243;Hablainville;213;7;220;54243
44;54;01;04;244;Hagéville;111;3;114;54244
44;54;02;09;245;Haigneville;61;0;61;54245
44;54;02;01;246;Halloville;66;6;72;54246
44;54;03;10;247;Hammeville;177;4;181;54247
44;54;04;16;248;Hamonville;100;0;100;54248
44;54;01;04;249;Hannonville-Suzémont;254;4;258;54249
44;54;03;03;250;Haraucourt;735;6;741;54250
44;54;02;01;251;Harbouey;125;1;126;54251
44;54;03;10;252;Haroué;506;6;512;54252
44;54;01;04;253;Hatrize;773;12;785;54253
44;54;01;07;254;Haucourt-Moulaine;3394;43;3437;54254
44;54;02;09;255;Haudonville;85;6;91;54255
44;54;02;09;256;Haussonville;305;8;313;54256
44;54;03;05;257;Heillecourt;5403;83;5486;54257
44;54;02;08;258;Hénaménil;144;3;147;54258
44;54;02;01;259;Herbéviller;240;2;242;54259
44;54;02;09;260;Hériménil;955;18;973;54260
44;54;01;07;261;Herserange;4409;46;4455;54261
44;54;02;08;262;Hoéville;197;0;197;54262
44;54;01;04;263;Homécourt;6267;55;6322;54263
44;54;03;10;264;Houdelmont;284;0;284;54264
44;54;03;05;265;Houdemont;2097;44;2141;54265
44;54;03;10;266;Houdreville;407;10;417;54266
44;54;03;10;268;Housséville;142;4;146;54268
44;54;02;08;269;Hudiviller;360;5;365;54269
44;54;01;23;270;Hussigny-Godbrange;3693;65;3758;54270
44;54;02;01;271;Igney;122;6;128;54271
44;54;04;16;272;Jaillon;469;3;472;54272
44;54;01;04;273;Jarny;8219;186;8405;54273
44;54;03;05;274;Jarville-la-Malgrange;9354;237;9591;54274
44;54;04;16;275;Jaulny;190;6;196;54275
44;54;03;02;276;Jeandelaincourt;795;7;802;54276
44;54;01;04;277;Jeandelize;373;2;375;54277
44;54;03;10;278;Jevoncourt;99;1;100;54278
44;54;03;18;279;Jezainville;983;21;1004;54279
44;54;01;17;280;JÅ“uf;6570;53;6623;54280
44;54;02;08;281;Jolivet;896;18;914;54281
44;54;01;17;282;Joppécourt;161;4;165;54282
44;54;01;04;283;Jouaville;290;9;299;54283
44;54;01;17;284;Joudreville;1137;20;1157;54284
44;54;02;01;285;Juvrecourt;56;1;57;54285
44;54;01;04;286;Labry;1587;30;1617;54286
44;54;02;01;287;Lachapelle;260;1;261;54287
44;54;04;16;288;Lagney;498;5;503;54288
44;54;03;03;289;Laître-sous-Amance;366;10;376;54289
44;54;01;23;290;Laix;211;3;214;54290
44;54;03;10;291;LalÅ“uf;291;2;293;54291
44;54;02;09;292;Lamath;190;3;193;54292
44;54;02;09;293;Landécourt;85;4;89;54293
44;54;03;02;294;Landremont;147;1;148;54294
44;54;01;17;295;Landres;972;111;1083;54295
44;54;03;03;296;Laneuvelotte;433;4;437;54296
44;54;02;01;297;Laneuveville-aux-Bois;309;3;312;54297
44;54;04;20;298;Laneuveville-derrière-Foug;153;2;155;54298
44;54;03;10;299;Laneuveville-devant-Bayon;226;6;232;54299
44;54;03;03;300;Laneuveville-devant-Nancy;6553;109;6662;54300
44;54;03;02;301;Lanfroicourt;128;1;129;54301
44;54;01;17;302;Lantéfontaine;746;18;764;54302
44;54;02;01;303;Laronxe;368;3;371;54303
44;54;03;06;304;Laxou;14366;191;14557;54304
44;54;03;02;305;Lay-Saint-Christophe;2400;48;2448;54305
44;54;04;20;306;Lay-Saint-Remy;343;5;348;54306
44;54;03;10;307;Lebeuville;176;4;180;54307
44;54;02;01;308;Leintrey;146;3;149;54308
44;54;03;10;309;Lemainville;379;3;382;54309
44;54;03;10;310;Leménil-Mitry;3;0;3;54310
44;54;03;03;311;Lenoncourt;595;8;603;54311
44;54;03;18;312;Lesménils;480;10;490;54312
44;54;03;02;313;Létricourt;229;1;230;54313
44;54;01;07;314;Lexy;3816;65;3881;54314
44;54;03;02;315;Leyr;902;6;908;54315
44;54;04;16;316;Limey-Remenauville;298;5;303;54316
44;54;04;16;317;Lironville;131;5;136;54317
44;54;04;16;318;Liverdun;5863;73;5936;54318
44;54;03;18;320;Loisy;324;4;328;54320
44;54;01;23;321;Longlaville;2365;28;2393;54321
44;54;01;11;322;Longuyon;5218;62;5280;54322
44;54;01;07;323;Longwy;14774;272;15046;54323
44;54;02;09;324;Lorey;89;1;90;54324
44;54;02;09;325;Loromontzey;82;8;90;54325
44;54;01;17;326;Lubey;222;10;232;54326
44;54;04;16;327;Lucey;630;15;645;54327
44;54;03;05;328;Ludres;6142;89;6231;54328
44;54;02;98;329;Lunéville;17867;324;18191;54329
44;54;03;05;330;Lupcourt;428;9;437;54330
44;54;02;09;331;Magnières;280;6;286;54331
44;54;03;18;332;Maidières;1547;24;1571;54332
44;54;03;02;333;Mailly-sur-Seille;248;14;262;54333
44;54;01;17;334;Mairy-Mainville;561;11;572;54334
44;54;02;08;335;Maixe;412;4;416;54335
44;54;03;15;336;Maizières;927;11;938;54336
44;54;01;17;337;Malavillers;129;3;132;54337
44;54;03;02;338;Malleloy;980;14;994;54338
44;54;03;19;339;Malzéville;8191;270;8461;54339
44;54;04;16;340;Mamey;343;5;348;54340
44;54;04;16;343;Mandres-aux-Quatre-Tours;187;5;192;54343
44;54;03;10;344;Mangonville;218;4;222;54344
44;54;03;05;345;Manoncourt-en-Vermois;344;5;349;54345
44;54;04;16;346;Manoncourt-en-WoÃ«vre;246;4;250;54346
44;54;04;16;348;Manonville;236;8;244;54348
44;54;02;01;349;Manonviller;163;2;165;54349
44;54;02;01;350;Marainviller;697;8;705;54350
44;54;03;21;351;Marbache;1682;15;1697;54351
44;54;03;15;352;Maron;829;9;838;54352
44;54;01;04;353;Mars-la-Tour;922;16;938;54353
44;54;03;10;354;Marthemont;46;0;46;54354
44;54;04;16;355;Martincourt;94;2;96;54355
44;54;02;09;356;Mattexey;67;2;69;54356
44;54;03;21;357;Maxéville;9818;119;9937;54357
44;54;03;03;358;Mazerulles;279;5;284;54358
44;54;02;09;359;Méhoncourt;243;3;246;54359
44;54;04;16;360;Ménil-la-Tour;337;8;345;54360
44;54;01;17;362;Mercy-le-Bas;1281;7;1288;54362
44;54;01;17;363;Mercy-le-Haut;270;6;276;54363
44;54;03;15;364;Méréville;1289;19;1308;54364
44;54;02;01;365;Merviller;324;9;333;54365
44;54;03;15;366;Messein;1976;20;1996;54366
44;54;01;07;367;Mexy;2278;67;2345;54367
44;54;02;01;368;Mignéville;175;3;178;54368
44;54;03;02;369;Millery;617;7;624;54369
44;54;04;16;370;Minorville;225;1;226;54370
44;54;01;04;371;Moineville;1069;20;1089;54371
44;54;03;02;372;Moivrons;511;2;513;54372
44;54;02;09;373;Moncel-lès-Lunéville;618;5;623;54373
44;54;03;03;374;Moncel-sur-Seille;514;9;523;54374
44;54;03;18;375;Montauville;1078;17;1095;54375
44;54;03;02;376;Montenoy;409;7;416;54376
44;54;02;01;377;Montigny;159;0;159;54377
44;54;01;11;378;Montigny-sur-Chiers;473;8;481;54378
44;54;04;10;379;Mont-l'Etroit;97;0;97;54379
44;54;04;10;380;Mont-le-Vignoble;413;10;423;54380
44;54;02;01;381;Montreux;55;2;57;54381
44;54;01;11;382;Mont-Saint-Martin;8994;113;9107;54382
44;54;02;09;383;Mont-sur-Meurthe;1117;11;1128;54383
44;54;01;23;385;Morfontaine;1086;25;1111;54385
44;54;02;09;386;Moriviller;92;1;93;54386
44;54;03;02;387;Morville-sur-Seille;151;0;151;54387
44;54;02;01;388;Mouacourt;74;2;76;54388
44;54;01;17;389;Mouaville;99;2;101;54389
44;54;03;18;390;Mousson;101;3;104;54390
44;54;01;04;391;Moutiers;1568;23;1591;54391
44;54;04;10;392;Moutrot;312;2;314;54392
44;54;02;09;393;Moyen;539;6;545;54393
44;54;01;17;394;Murville;251;6;257;54394
44;54;03;99;395;Nancy;105058;1446;106504;54395
44;54;02;01;396;Neufmaisons;227;8;235;54396
44;54;03;15;397;Neuves-Maisons;6633;55;6688;54397
44;54;02;01;398;Neuviller-lès-Badonviller;97;2;99;54398
44;54;03;10;399;Neuviller-sur-Moselle;248;1;249;54399
44;54;03;02;400;Nomeny;1150;22;1172;54400
44;54;02;01;401;Nonhigny;127;5;132;54401
44;54;01;17;402;Norroy-le-Sec;413;11;424;54402
44;54;03;18;403;Norroy-lès-Pont-Ã -Mousson;1190;34;1224;54403
44;54;04;16;404;Noviant-aux-Prés;264;5;269;54404
44;54;04;10;405;Ochey;522;0;522;54405
44;54;02;01;406;Ogéviller;279;7;286;54406
44;54;03;10;407;Ognéville;96;3;99;54407
44;54;01;04;408;Olley;231;3;234;54408
44;54;03;10;409;Omelmont;188;0;188;54409
44;54;01;18;410;Onville;519;2;521;54410
44;54;03;10;411;Ormes-et-Ville;218;2;220;54411
44;54;01;11;412;Othe;38;3;41;54412
44;54;01;17;413;Ozerailles;151;1;152;54413
44;54;04;20;414;Pagney-derrière-Barine;660;8;668;54414
44;54;03;18;415;Pagny-sur-Moselle;4105;52;4157;54415
44;54;04;16;416;Pannes;180;3;183;54416
44;54;03;10;417;Parey-Saint-Césaire;240;7;247;54417
44;54;02;01;418;Parroy;171;1;172;54418
44;54;02;01;419;Parux;73;0;73;54419
44;54;01;11;420;Petit-Failly;87;1;88;54420
44;54;02;01;421;Petitmont;317;4;321;54421
44;54;02;01;422;Pettonville;70;0;70;54422
44;54;02;01;423;Pexonne;348;10;358;54423
44;54;03;02;424;Phlin;43;1;44;54424
44;54;01;17;425;Piennes;2539;28;2567;54425
44;54;04;20;426;Pierre-la-Treiche;480;6;486;54426
44;54;02;01;427;Pierre-Percée;94;1;95;54427
44;54;01;11;428;Pierrepont;863;9;872;54428
44;54;03;10;429;Pierreville;300;2;302;54429
44;54;03;21;430;Pompey;4870;56;4926;54430
44;54;03;18;431;Pont-Ã -Mousson;14497;187;14684;54431
44;54;03;15;432;Pont-Saint-Vincent;1844;38;1882;54432
44;54;03;02;433;Port-sur-Seille;229;7;236;54433
44;54;03;10;434;Praye;252;2;254;54434
44;54;03;18;435;Prény;362;4;366;54435
44;54;01;17;436;Preutin-Higny;146;4;150;54436
44;54;03;15;437;Pulligny;1151;20;1171;54437
44;54;04;10;438;Pulney;56;0;56;54438
44;54;03;03;439;Pulnoy;5077;62;5139;54439
44;54;01;04;440;Puxe;121;0;121;54440
44;54;01;04;441;Puxieux;234;5;239;54441
44;54;03;10;442;Quevilloncourt;97;2;99;54442
44;54;02;01;443;Raon-lès-Leau;37;0;37;54443
44;54;03;02;444;Raucourt;222;2;224;54444
44;54;02;08;445;Raville-sur-Sânon;102;0;102;54445
44;54;02;01;446;Réchicourt-la-Petite;65;2;67;54446
44;54;02;01;447;Réclonville;76;1;77;54447
44;54;02;09;449;Rehainviller;1048;15;1063;54449
44;54;02;01;450;Reherrey;141;1;142;54450
44;54;01;07;451;Réhon;3809;76;3885;54451
44;54;02;01;452;Reillon;78;2;80;54452
44;54;04;16;453;Rembercourt-sur-Mad;161;1;162;54453
44;54;02;09;455;Remenoville;158;4;162;54455
44;54;03;03;456;Réméréville;584;8;592;54456
44;54;02;01;457;Remoncourt;44;0;44;54457
44;54;02;01;458;Repaix;105;1;106;54458
44;54;03;15;459;Richardménil;2329;25;2354;54459
44;54;04;16;460;Rogéville;156;3;159;54460
44;54;02;09;461;Romain;70;2;72;54461
44;54;03;09;462;Rosières-aux-Salines;2870;28;2898;54462
44;54;04;16;463;Rosières-en-Haye;235;2;237;54463
44;54;03;02;464;Rouves;105;0;105;54464
44;54;03;10;465;Roville-devant-Bayon;769;11;780;54465
44;54;04;16;466;Royaumeix;390;5;395;54466
44;54;02;09;467;Rozelieures;191;5;196;54467
44;54;03;09;468;Saffais;113;2;115;54468
44;54;01;04;469;Saint-Ail;418;5;423;54469
44;54;04;16;470;Saint-Baussant;74;2;76;54470
44;54;02;09;471;Saint-Boingt;71;3;74;54471
44;54;02;01;472;Saint-Clément;854;16;870;54472
44;54;03;10;473;Saint-Firmin;280;6;286;54473
44;54;03;02;474;Sainte-Geneviève;192;0;192;54474
44;54;02;09;475;Saint-Germain;155;6;161;54475
44;54;01;11;476;Saint-Jean-lès-Longuyon;416;11;427;54476
44;54;01;04;477;Saint-Julien-lès-Gorze;162;3;165;54477
44;54;01;04;478;Saint-Marcel;149;1;150;54478
44;54;02;09;479;Saint-Mard;95;1;96;54479
44;54;02;01;480;Saint-Martin;56;1;57;54480
44;54;02;01;481;Saint-Maurice-aux-Forges;98;3;101;54481
44;54;03;19;482;Saint-Max;10019;110;10129;54482
44;54;03;05;483;Saint-Nicolas-de-Port;7417;73;7490;54483
44;54;02;01;484;Sainte-Pôle;186;3;189;54484
44;54;01;11;485;Saint-Pancré;310;6;316;54485
44;54;03;10;486;Saint-Remimont;355;5;360;54486
44;54;02;09;487;Saint-Rémy-aux-Bois;64;0;64;54487
44;54;02;01;488;Saint-Sauveur;35;0;35;54488
44;54;01;11;489;Saint-Supplet;148;4;152;54489
44;54;03;16;490;Saizerais;1473;23;1496;54490
44;54;01;17;491;Sancy;315;7;322;54491
44;54;04;16;492;Sanzey;152;2;154;54492
44;54;01;23;493;Saulnes;2415;39;2454;54493
44;54;04;10;494;Saulxerotte;101;0;101;54494
44;54;03;03;495;Saulxures-lès-Nancy;4221;59;4280;54495
44;54;04;10;496;Saulxures-lès-Vannes;368;4;372;54496
44;54;03;10;497;Saxon-Sion;106;3;109;54497
44;54;03;03;498;Seichamps;5069;66;5135;54498
44;54;04;16;499;Seicheprey;112;4;116;54499
44;54;04;10;500;Selaincourt;183;3;186;54500
44;54;02;09;501;Seranville;101;0;101;54501
44;54;02;08;502;Serres;243;1;244;54502
44;54;01;23;504;Serrouville;668;16;684;54504
44;54;04;15;505;Sexey-aux-Forges;714;8;722;54505
44;54;02;08;507;Sionviller;103;2;105;54507
44;54;03;02;508;Sivry;245;4;249;54508
44;54;02;08;509;Sommerviller;994;4;998;54509
44;54;03;03;510;Sornéville;312;6;318;54510
44;54;01;04;511;Sponville;112;4;116;54511
44;54;02;01;512;Tanconville;106;2;108;54512
44;54;03;10;513;Tantonville;646;4;650;54513
44;54;01;11;514;Tellancourt;601;15;616;54514
44;54;03;10;515;Thélod;250;0;250;54515
44;54;03;10;516;They-sous-Vaudemont;17;1;18;54516
44;54;03;02;517;Thézey-Saint-Martin;203;2;205;54517
44;54;04;16;518;Thiaucourt-Regniéville;1110;10;1120;54518
44;54;02;01;519;Thiaville-sur-Meurthe;587;8;595;54519
44;54;02;01;520;Thiébauménil;381;9;390;54520
44;54;01;23;521;Thil;1950;30;1980;54521
44;54;03;10;522;Thorey-Lyautey;142;3;145;54522
44;54;04;10;523;Thuilley-aux-Groseilles;424;2;426;54523
44;54;01;17;524;Thumeréville;84;2;86;54524
44;54;01;23;525;Tiercelet;664;12;676;54525
44;54;03;19;526;Tomblaine;8856;289;9145;54526
44;54;03;09;527;Tonnoy;675;26;701;54527
44;54;04;20;528;Toul;15633;265;15898;54528
44;54;04;10;529;Tramont-Emy;28;0;28;54529
44;54;04;10;530;Tramont-Lassus;86;2;88;54530
44;54;04;10;531;Tramont-Saint-André;56;1;57;54531
44;54;04;16;532;Tremblecourt;165;3;168;54532
44;54;01;17;533;Trieux;2605;33;2638;54533
44;54;04;16;534;Trondes;530;21;551;54534
44;54;01;04;535;Tronville;200;2;202;54535
44;54;01;17;536;Tucquegnieux;2438;24;2462;54536
44;54;01;11;537;Ugny;690;29;719;54537
44;54;04;10;538;Uruffe;381;3;384;54538
44;54;02;01;539;Vacqueville;234;13;247;54539
44;54;02;01;540;Val-et-Châtillon;578;6;584;54540
44;54;02;08;541;Valhey;165;2;167;54541
44;54;01;04;542;Valleroy;2322;35;2357;54542
44;54;02;09;543;Vallois;158;2;160;54543
44;54;04;18;544;Vandelainville;140;2;142;54544
44;54;04;10;545;Vandeléville;211;5;216;54545
44;54;03;18;546;Vandières;930;9;939;54546
44;54;03;22;547;VandÅ“uvre-lès-Nancy;29942;281;30223;54547
44;54;04;10;548;Vannes-le-Châtel;538;8;546;54548
44;54;03;08;549;Varangéville;3594;42;3636;54549
44;54;02;09;550;Vathiménil;322;8;330;54550
44;54;02;01;551;Vaucourt;60;2;62;54551
44;54;03;10;552;Vaudémont;62;2;64;54552
44;54;03;10;553;Vaudeville;150;4;154;54553
44;54;03;10;554;Vaudigny;77;1;78;54554
44;54;02;01;555;Vaxainville;88;0;88;54555
44;54;02;01;556;Vého;107;3;110;54556
44;54;04;16;557;Bois-de-Haye;2306;96;2402;54557
44;54;03;03;558;Velaine-sous-Amance;280;5;285;54558
44;54;02;09;559;Velle-sur-Moselle;302;2;304;54559
44;54;02;01;560;Veney;52;0;52;54560
44;54;02;09;561;Vennezey;47;1;48;54561
44;54;02;01;562;Verdenal;159;7;166;54562
44;54;03;10;563;Vézelise;1392;17;1409;54563
44;54;04;16;564;Viéville-en-Haye;141;4;145;54564
44;54;02;09;565;Vigneulles;235;2;237;54565
44;54;04;16;566;Vilcey-sur-Trey;154;1;155;54566
44;54;02;09;567;Villacourt;366;13;379;54567
44;54;01;11;568;Ville-au-Montois;271;3;274;54568
44;54;03;02;569;Ville-au-Val;191;4;195;54569
44;54;01;18;570;Villecey-sur-Mad;340;7;347;54570
44;54;03;05;571;Ville-en-Vermois;594;8;602;54571
44;54;01;11;572;Ville-Houdlémont;683;5;688;54572
44;54;04;16;573;Villers-en-Haye;170;0;170;54573
44;54;01;11;574;Villers-la-Chèvre;551;19;570;54574
44;54;01;23;575;Villers-la-Montagne;1525;37;1562;54575
44;54;01;11;576;Villers-le-Rond;117;1;118;54576
44;54;03;02;577;Villers-lès-Moivrons;143;1;144;54577
44;54;03;06;578;Villers-lès-Nancy;14525;302;14827;54578
44;54;03;18;579;Villers-sous-Prény;339;7;346;54579
44;54;01;23;580;Villerupt;10003;108;10111;54580
44;54;01;04;581;Ville-sur-Yron;297;9;306;54581
44;54;01;11;582;Villette;183;1;184;54582
44;54;04;20;583;Villey-le-Sec;415;8;423;54583
44;54;04;16;584;Villey-Saint-Etienne;1032;22;1054;54584
44;54;02;09;585;Virecourt;491;6;497;54585
44;54;03;10;586;Viterne;741;7;748;54586
44;54;03;10;587;Vitrey;195;3;198;54587
44;54;02;08;588;Vitrimont;395;9;404;54588
44;54;03;18;589;Vittonville;128;6;134;54589
44;54;01;11;590;Viviers-sur-Chiers;665;19;684;54590
44;54;03;10;591;Voinémont;330;12;342;54591
44;54;03;10;592;Vroncourt;260;3;263;54592
44;54;01;18;593;Waville;428;5;433;54593
44;54;04;16;594;Xammes;159;1;160;54594
44;54;02;09;595;Xermaménil;561;7;568;54595
44;54;03;10;596;Xeuilley;966;7;973;54596
44;54;03;10;597;Xirocourt;443;3;446;54597
44;54;01;17;598;Xivry-Circourt;270;7;277;54598
44;54;01;04;599;Xonville;112;0;112;54599
44;54;02;01;600;Xousse;129;1;130;54600
44;54;02;01;601;Xures;103;1;104;54601
44;54;01;11;602;Han-devant-Pierrepont;148;0;148;54602
44;55;02;10;001;Abainville;290;10;300;55001
44;55;03;04;002;Abaucourt-Hautecourt;103;3;106;55002
44;55;03;14;004;Aincreville;77;0;77;55004
44;55;02;10;005;Amanty;36;1;37;55005
44;55;03;08;007;Ambly-sur-Meuse;241;2;243;55007
44;55;03;05;008;Amel-sur-l'Etang;146;5;151;55008
44;55;03;08;009;Ancemont;538;19;557;55009
44;55;01;01;010;Ancerville;2662;73;2735;55010
44;55;01;12;011;Andernay;257;3;260;55011
44;55;02;13;012;Apremont-la-Forêt;414;8;422;55012
44;55;03;05;013;Arrancy-sur-Crusne;474;8;482;55013
44;55;03;06;014;Aubréville;361;7;368;55014
44;55;01;01;015;Aulnois-en-Perthois;498;12;510;55015
44;55;01;08;017;Autrécourt-sur-Aire;118;5;123;55017
44;55;03;14;018;Autréville-Saint-Lambert;40;2;42;55018
44;55;03;09;021;Avillers-Sainte-Croix;62;2;64;55021
44;55;03;11;022;Avioth;151;4;155;55022
44;55;03;06;023;Avocourt;116;1;117;55023
44;55;03;11;024;Azannes-et-Soumazannes;162;3;165;55024
44;55;03;14;025;Baâlon;277;3;280;55025
44;55;02;10;026;Badonvilliers-Gérauvilliers;132;5;137;55026
44;55;02;08;027;Bannoncourt;159;3;162;55027
44;55;03;06;028;Bantheville;113;3;116;55028
44;55;01;98;029;Bar-le-Duc;14625;596;15221;55029
44;55;01;01;031;Baudonvilliers;378;6;384;55031
44;55;02;08;032;Baudrémont;45;1;46;55032
44;55;03;06;033;Baulny;18;1;19;55033
44;55;03;11;034;Bazeilles-sur-Othain;115;3;118;55034
44;55;01;01;035;Bazincourt-sur-Saulx;147;6;153;55035
44;55;03;14;036;Beauclair;92;1;93;55036
44;55;03;14;037;Beaufort-en-Argonne;145;2;147;55037
44;55;01;08;038;Beaulieu-en-Argonne;38;2;40;55038
44;55;03;04;039;Beaumont-en-Verdunois;0;0;0;55039
44;55;01;08;040;Beausite;253;6;259;55040
44;55;01;03;041;Behonne;608;16;624;55041
44;55;03;17;042;Belleray;525;12;537;55042
44;55;03;04;043;Belleville-sur-Meuse;3040;53;3093;55043
44;55;02;08;044;Belrain;33;3;36;55044
44;55;03;17;045;Belrupt-en-Verdunois;558;8;566;55045
44;55;02;13;046;Beney-en-WoÃ«vre;128;4;132;55046
44;55;03;06;047;Béthelainville;161;6;167;55047
44;55;03;06;048;Béthincourt;34;2;36;55048
44;55;01;12;049;Beurey-sur-Saulx;421;0;421;55049
44;55;03;04;050;Bezonvaux;0;0;0;55050
44;55;01;10;051;Biencourt-sur-Orge;125;3;128;55051
44;55;03;05;053;Billy-sous-Mangiennes;369;2;371;55053
44;55;02;13;054;Bislée;61;5;66;55054
44;55;03;04;055;Blanzée;13;1;14;55055
44;55;03;09;057;Boinville-en-WoÃ«vre;78;2;80;55057
44;55;02;07;058;Boncourt-sur-Meuse;326;10;336;55058
44;55;02;10;059;Bonnet;191;8;199;55059
44;55;03;09;060;Bonzée;346;14;360;55060
44;55;01;10;061;Le Bouchon-sur-Saulx;239;6;245;55061
44;55;02;13;062;Bouconville-sur-Madt;114;1;115;55062
44;55;03;05;063;Bouligny;2464;39;2503;55063
44;55;02;08;064;Bouquemont;104;0;104;55064
44;55;03;06;065;Boureuilles;119;0;119;55065
44;55;02;15;066;Bovée-sur-Barboure;131;4;135;55066
44;55;02;15;067;Boviolles;100;2;102;55067
44;55;03;06;068;Brabant-en-Argonne;111;3;114;55068
44;55;01;12;069;Brabant-le-Roi;229;3;232;55069
44;55;03;06;070;Brabant-sur-Meuse;120;6;126;55070
44;55;03;11;071;Brandeville;182;5;187;55071
44;55;03;09;072;Braquis;109;1;110;55072
44;55;03;04;073;Bras-sur-Meuse;691;50;741;55073
44;55;01;10;075;Brauvilliers;174;4;178;55075
44;55;03;11;076;Bréhéville;168;1;169;55076
44;55;03;11;077;Breux;263;9;272;55077
44;55;03;14;078;Brieulles-sur-Meuse;305;9;314;55078
44;55;01;01;079;Brillon-en-Barrois;696;21;717;55079
44;55;02;15;080;Brixey-aux-Chanoines;80;4;84;55080
44;55;01;08;081;Brizeaux;58;1;59;55081
44;55;03;06;082;Brocourt-en-Argonne;46;1;47;55082
44;55;03;14;083;Brouennes;153;4;157;55083
44;55;02;15;084;Broussey-en-Blois;57;2;59;55084
44;55;02;13;085;Broussey-Raulecourt;288;4;292;55085
44;55;01;10;087;Bure;81;8;89;55087
44;55;02;15;088;Burey-en-Vaux;152;4;156;55088
44;55;02;15;089;Burey-la-Côte;88;1;89;55089
44;55;02;13;093;Buxières-sous-les-Côtes;290;3;293;55093
44;55;03;09;094;Buzy-Darmont;549;11;560;55094
44;55;03;14;095;Cesse;104;4;108;55095
44;55;02;13;096;Chaillon;112;1;113;55096
44;55;02;15;097;Chalaines;312;6;318;55097
44;55;03;04;099;Champneuville;121;1;122;55099
44;55;02;15;100;Champougny;79;8;87;55100
44;55;01;03;101;Chardogne;298;8;306;55101
44;55;03;04;102;Charny-sur-Meuse;524;19;543;55102
44;55;03;06;103;Charpentry;21;2;23;55103
44;55;02;10;104;Chassey-Beaupré;81;3;84;55104
44;55;03;04;105;Châtillon-sous-les-Côtes;178;4;182;55105
44;55;03;06;106;Chattancourt;179;5;184;55106
44;55;03;11;107;Chaumont-devant-Damvillers;47;1;48;55107
44;55;01;12;108;Chaumont-sur-Aire;124;4;128;55108
44;55;03;11;109;Chauvency-le-Château;237;7;244;55109
44;55;03;11;110;Chauvency-Saint-Hubert;226;7;233;55110
44;55;02;13;111;Chauvoncourt;444;20;464;55111
44;55;03;06;113;Cheppy;156;1;157;55113
44;55;02;07;114;Chonville-Malaumont;206;4;210;55114
44;55;03;06;115;Cierges-sous-Montfaucon;46;0;46;55115
44;55;03;06;116;Le Claon;55;2;57;55116
44;55;03;06;117;Clermont-en-Argonne;1453;34;1487;55117
44;55;03;14;118;Cléry-le-Grand;96;2;98;55118
44;55;03;14;119;Cléry-le-Petit;190;1;191;55119
44;55;01;02;120;Combles-en-Barrois;785;23;808;55120
44;55;03;09;121;Combres-sous-les-Côtes;119;5;124;55121
44;55;02;07;122;Commercy;5386;235;5621;55122
44;55;01;12;123;Les Hauts-de-Chée;712;15;727;55123
44;55;03;06;124;Consenvoye;309;4;313;55124
44;55;01;12;125;Contrisson;797;19;816;55125
44;55;02;08;127;Courcelles-en-Barrois;41;0;41;55127
44;55;01;12;128;Courcelles-sur-Aire;41;1;42;55128
44;55;02;08;129;Courouvre;37;1;38;55129
44;55;01;01;132;Cousances-les-Forges;1680;29;1709;55132
44;55;01;10;133;Couvertpuis;87;5;92;55133
44;55;01;12;134;Couvonges;153;4;157;55134
44;55;03;06;137;Cuisy;48;0;48;55137
44;55;01;15;138;Culey;133;3;136;55138
44;55;03;04;139;Cumières-le-Mort-Homme;0;0;0;55139
44;55;03;06;140;Cunel;17;0;17;55140
44;55;02;15;141;Dagonville;83;0;83;55141
44;55;02;10;142;Dainville-Bertheléville;121;6;127;55142
44;55;03;04;143;Damloup;127;8;135;55143
44;55;01;10;144;Dammarie-sur-Saulx;385;13;398;55144
44;55;03;11;145;Damvillers;626;74;700;55145
44;55;03;06;146;Dannevoux;207;11;218;55146
44;55;02;10;148;Delouze-Rosières;112;4;116;55148
44;55;03;11;149;Delut;122;0;122;55149
44;55;02;10;150;Demange-Baudignécourt;521;13;534;55150
44;55;03;04;153;Dieppe-sous-Douaumont;195;2;197;55153
44;55;03;08;154;Dieue-sur-Meuse;1441;47;1488;55154
44;55;03;06;155;Dombasle-en-Argonne;397;7;404;55155
44;55;03;11;156;Dombras;138;4;142;55156
44;55;03;09;157;Dommartin-la-Montagne;52;0;52;55157
44;55;03;05;158;Dommary-Baroncourt;731;8;739;55158
44;55;02;08;159;Dompcevrin;338;3;341;55159
44;55;02;13;160;Dompierre-aux-Bois;38;0;38;55160
44;55;03;05;162;Domremy-la-Canne;35;0;35;55162
44;55;03;09;163;Doncourt-aux-Templiers;56;3;59;55163
44;55;03;14;165;Doulcon;426;12;438;55165
44;55;03;17;166;Dugny-sur-Meuse;1311;24;1335;55166
44;55;03;14;167;Dun-sur-Meuse;660;10;670;55167
44;55;03;05;168;Duzey;44;0;44;55168
44;55;03;11;169;Ecouviez;514;6;520;55169
44;55;03;11;170;Ecurey-en-Verdunois;118;1;119;55170
44;55;03;04;171;Eix;256;4;260;55171
44;55;03;09;172;Les Eparges;63;1;64;55172
44;55;02;15;173;Epiez-sur-Meuse;40;3;43;55173
44;55;03;06;174;Epinonville;77;0;77;55174
44;55;01;02;175;Erize-la-Brûlée;189;5;194;55175
44;55;01;12;177;Erize-la-Petite;46;4;50;55177
44;55;01;02;178;Erize-Saint-Dizier;184;6;190;55178
44;55;02;15;179;Erneville-aux-Bois;153;3;156;55179
44;55;03;06;180;Esnes-en-Argonne;136;11;147;55180
44;55;03;09;181;Etain;3507;74;3581;55181
44;55;03;05;182;Eton;208;3;211;55182
44;55;03;11;183;Etraye;37;1;38;55183
44;55;02;07;184;Euville;1651;32;1683;55184
44;55;01;08;185;Evres;89;5;94;55185
44;55;01;03;186;Fains-Véel;2109;58;2167;55186
44;55;03;11;188;Flassigny;44;1;45;55188
44;55;03;04;189;Fleury-devant-Douaumont;0;0;0;55189
44;55;03;05;191;Foameix-Ornel;232;5;237;55191
44;55;03;14;192;Fontaines-Saint-Clair;44;1;45;55192
44;55;03;06;193;Forges-sur-Meuse;123;2;125;55193
44;55;01;08;194;Foucaucourt-sur-Thabas;58;0;58;55194
44;55;01;10;195;Fouchères-aux-Bois;127;4;131;55195
44;55;02;07;196;Frémeréville-sous-les-Côtes;128;1;129;55196
44;55;02;08;197;Fresnes-au-Mont;167;4;171;55197
44;55;03;09;198;Fresnes-en-WoÃ«vre;652;9;661;55198
44;55;03;06;199;Froidos;91;2;93;55199
44;55;03;06;200;Fromeréville-les-Vallons;206;4;210;55200
44;55;03;09;201;Fromezey;59;0;59;55201
44;55;03;06;202;Futeau;149;3;152;55202
44;55;03;08;204;Génicourt-sur-Meuse;293;5;298;55204
44;55;03;06;206;Gercourt-et-Drillancourt;98;4;102;55206
44;55;01;02;207;Géry;53;1;54;55207
44;55;03;06;208;Gesnes-en-Argonne;60;2;62;55208
44;55;02;08;210;Gimécourt;40;0;40;55210
44;55;03;04;211;Gincrey;65;1;66;55211
44;55;02;07;212;Girauvoisin;81;0;81;55212
44;55;01;10;214;Givrauval;279;21;300;55214
44;55;02;10;215;Gondrecourt-le-Château;1074;17;1091;55215
44;55;03;05;216;Gouraincourt;63;0;63;55216
44;55;02;15;217;Goussaincourt;115;6;121;55217
44;55;03;11;218;Gremilly;39;0;39;55218
44;55;03;04;219;Grimaucourt-en-WoÃ«vre;102;2;104;55219
44;55;02;07;220;Grimaucourt-près-Sampigny;78;0;78;55220
44;55;01;01;221;Guerpont;245;6;251;55221
44;55;03;09;222;Gussainville;32;2;34;55222
44;55;01;01;224;Haironville;583;13;596;55224
44;55;03;14;225;Halles-sous-les-Côtes;143;7;150;55225
44;55;03;11;226;Han-lès-Juvigny;123;1;124;55226
44;55;03;09;228;Hannonville-sous-les-Côtes;552;11;563;55228
44;55;02;13;229;Han-sur-Meuse;272;3;275;55229
44;55;03;09;232;Harville;114;0;114;55232
44;55;03;17;236;Haudainville;941;24;965;55236
44;55;03;09;237;Haudiomont;227;1;228;55237
44;55;03;04;239;Haumont-près-Samogneux;0;0;0;55239
44;55;03;08;241;Heippes;78;3;81;55241
44;55;03;09;242;Hennemont;111;4;115;55242
44;55;03;09;243;Herbeuville;181;5;186;55243
44;55;03;09;244;Herméville-en-WoÃ«vre;232;3;235;55244
44;55;02;13;245;Heudicourt-sous-les-Côtes;165;2;167;55245
44;55;01;10;246;Hévilliers;150;1;151;55246
44;55;02;10;247;Horville-en-Ornois;51;5;56;55247
44;55;02;10;248;Houdelaincourt;285;7;292;55248
44;55;03;14;250;Inor;182;8;190;55250
44;55;01;08;251;Ippécourt;103;3;106;55251
44;55;03;11;252;Iré-le-Sec;154;2;156;55252
44;55;03;06;253;Les Islettes;715;13;728;55253
44;55;01;08;254;Les Trois-Domaines;123;3;126;55254
44;55;03;11;255;Jametz;260;6;266;55255
44;55;02;13;256;Jonville-en-WoÃ«vre;148;0;148;55256
44;55;03;06;257;Jouy-en-Argonne;43;0;43;55257
44;55;02;07;258;Geville;617;17;634;55258
44;55;03;08;260;Julvécourt;54;2;56;55260
44;55;01;01;261;Juvigny-en-Perthois;142;2;144;55261
44;55;03;11;262;Juvigny-sur-Loison;266;2;268;55262
44;55;02;08;263;KÅ“ur-la-Grande;158;4;162;55263
44;55;02;08;264;KÅ“ur-la-Petite;266;5;271;55264
44;55;03;09;265;Labeuville;138;5;143;55265
44;55;03;06;266;Lachalade;50;0;50;55266
44;55;02;13;267;Lachaussée;272;8;280;55267
44;55;02;13;268;Lacroix-sur-Meuse;712;17;729;55268
44;55;02;08;269;Lahaymeix;74;0;74;55269
44;55;02;13;270;Lahayville;28;1;29;55270
44;55;01;12;271;Laheycourt;378;6;384;55271
44;55;01;12;272;Laimont;441;17;458;55272
44;55;02;13;274;Lamorville;290;6;296;55274
44;55;03;14;275;Lamouilly;87;4;91;55275
44;55;03;08;276;Landrecourt-Lempire;215;2;217;55276
44;55;02;15;278;Laneuville-au-Rupt;194;3;197;55278
44;55;03;14;279;Laneuville-sur-Meuse;445;8;453;55279
44;55;03;05;280;Lanhères;59;0;59;55280
44;55;03;09;281;Latour-en-WoÃ«vre;95;0;95;55281
44;55;02;08;282;Lavallée;95;3;98;55282
44;55;01;01;284;Lavincourt;72;0;72;55284
44;55;01;08;285;Lavoye;153;4;157;55285
44;55;03;08;286;Lemmes;241;1;242;55286
44;55;02;07;288;Lérouville;1416;16;1432;55288
44;55;02;08;289;Levoncourt;60;1;61;55289
44;55;02;08;290;Lignières-sur-Aire;54;2;56;55290
44;55;01;10;291;Ligny-en-Barrois;4018;135;4153;55291
44;55;03;14;292;Liny-devant-Dun;189;7;196;55292
44;55;03;14;293;Lion-devant-Dun;168;4;172;55293
44;55;01;12;295;Lisle-en-Barrois;31;1;32;55295
44;55;01;01;296;L'Isle-en-Rigault;477;8;485;55296
44;55;03;11;297;Lissey;111;1;112;55297
44;55;01;15;298;Loisey;295;9;304;55298
44;55;03;05;299;Loison;120;3;123;55299
44;55;01;10;300;Longeaux;224;7;231;55300
44;55;02;08;301;Longchamps-sur-Aire;121;8;129;55301
44;55;01;02;302;Longeville-en-Barrois;1129;35;1164;55302
44;55;02;13;303;Loupmont;72;4;76;55303
44;55;01;12;304;Louppy-le-Château;159;6;165;55304
44;55;03;11;306;Louppy-sur-Loison;113;1;114;55306
44;55;03;04;307;Louvemont-Côte-du-Poivre;0;0;0;55307
44;55;03;14;310;Luzy-Saint-Martin;113;4;117;55310
44;55;03;09;311;Maizeray;29;1;30;55311
44;55;02;13;312;Maizey;165;6;171;55312
44;55;03;06;313;Malancourt;67;2;69;55313
44;55;01;10;315;Mandres-en-Barrois;117;5;122;55315
44;55;03;05;316;Mangiennes;400;7;407;55316
44;55;03;09;317;Manheulles;142;7;149;55317
44;55;03;09;320;Marchéville-en-WoÃ«vre;67;2;69;55320
44;55;03;06;321;Marre;162;7;169;55321
44;55;02;15;322;Marson-sur-Barboure;46;1;47;55322
44;55;03;14;323;Martincourt-sur-Meuse;68;1;69;55323
44;55;03;11;324;Marville;517;13;530;55324
44;55;03;04;325;Maucourt-sur-Orne;51;1;52;55325
44;55;01;01;326;Maulan;111;3;114;55326
44;55;02;10;327;Mauvages;251;2;253;55327
44;55;02;15;328;Maxey-sur-Vaise;288;6;294;55328
44;55;02;07;329;Mécrin;223;2;225;55329
44;55;02;15;330;Méligny-le-Grand;90;2;92;55330
44;55;02;15;331;Méligny-le-Petit;78;0;78;55331
44;55;01;10;332;Menaucourt;238;5;243;55332
44;55;02;08;333;Ménil-aux-Bois;41;0;41;55333
44;55;02;15;334;Ménil-la-Horgne;167;3;170;55334
44;55;01;10;335;Ménil-sur-Saulx;252;9;261;55335
44;55;03;11;336;Merles-sur-Loison;151;2;153;55336
44;55;03;14;338;Milly-sur-Bradon;149;5;154;55338
44;55;03;04;339;Mogeville;78;1;79;55339
44;55;01;12;340;Mognéville;377;11;388;55340
44;55;03;11;341;Moirey-Flabas-Crépion;126;2;128;55341
44;55;03;06;343;Montblainville;60;2;62;55343
44;55;02;15;344;Montbras;22;0;22;55344
44;55;03;14;345;Mont-devant-Sassey;102;3;105;55345
44;55;03;06;346;Montfaucon-d'Argonne;296;7;303;55346
44;55;03;08;347;Les Monthairons;350;3;353;55347
44;55;01;10;348;Montiers-sur-Saulx;373;4;377;55348
44;55;03;14;349;Montigny-devant-Sassey;111;6;117;55349
44;55;02;15;350;Montigny-lès-Vaucouleurs;74;0;74;55350
44;55;03;11;351;Montmédy;2052;85;2137;55351
44;55;01;01;352;Montplonne;143;18;161;55352
44;55;02;13;353;Montsec;81;0;81;55353
44;55;03;06;355;Montzéville;155;1;156;55355
44;55;03;04;356;Moranville;105;1;106;55356
44;55;03;05;357;Morgemoulin;108;3;111;55357
44;55;01;10;358;Chanteraine;189;5;194;55358
44;55;01;10;359;Morley;206;2;208;55359
44;55;03;09;360;Mouilly;110;1;111;55360
44;55;03;04;361;Moulainville;127;0;127;55361
44;55;03;14;362;Moulins-Saint-Hubert;178;3;181;55362
44;55;03;09;363;Moulotte;93;1;94;55363
44;55;03;14;364;Mouzay;667;29;696;55364
44;55;03;14;365;Murvaux;142;4;146;55365
44;55;01;12;366;Val-d'Ornain;993;34;1027;55366
44;55;03;05;367;Muzeray;136;4;140;55367
44;55;02;15;368;Naives-en-Blois;144;9;153;55368
44;55;01;02;369;Naives-Rosières;803;21;824;55369
44;55;01;10;370;Naix-aux-Forges;225;2;227;55370
44;55;02;15;371;Nançois-le-Grand;74;4;78;55371
44;55;01;15;372;Nançois-sur-Ornain;373;12;385;55372
44;55;01;01;373;Nant-le-Grand;83;5;88;55373
44;55;01;01;374;Nant-le-Petit;75;1;76;55374
44;55;03;06;375;Nantillois;64;1;65;55375
44;55;01;10;376;Nantois;86;4;90;55376
44;55;03;14;377;Nepvant;90;1;91;55377
44;55;01;12;378;Nettancourt;244;3;247;55378
44;55;03;06;379;Le Neufour;71;2;73;55379
44;55;02;08;380;Neuville-en-Verdunois;54;1;55;55380
44;55;02;15;381;Neuville-lès-Vaucouleurs;174;8;182;55381
44;55;01;12;382;Neuville-sur-Ornain;362;9;371;55382
44;55;03;06;383;Neuvilly-en-Argonne;216;2;218;55383
44;55;02;08;384;Nicey-sur-Aire;123;4;127;55384
44;55;03;08;385;Nixéville-Blercourt;491;16;507;55385
44;55;02;13;386;Nonsard-Lamarche;219;5;224;55386
44;55;03;05;387;Nouillonpont;239;4;243;55387
44;55;01;12;388;Noyers-Auzécourt;278;4;282;55388
44;55;01;08;389;Nubécourt;250;6;256;55389
44;55;03;14;391;Olizy-sur-Chiers;197;6;203;55391
44;55;03;04;394;Ornes;6;0;6;55394
44;55;03;08;395;Osches;56;3;59;55395
44;55;02;15;396;Ourches-sur-Meuse;226;5;231;55396
44;55;02;15;397;Pagny-la-Blanche-Côte;238;4;242;55397
44;55;02;15;398;Pagny-sur-Meuse;1016;17;1033;55398
44;55;03;09;399;Pareid;117;0;117;55399
44;55;03;09;400;Parfondrupt;43;0;43;55400
44;55;02;13;401;Les Paroches;413;11;424;55401
44;55;03;11;403;Peuvillers;60;1;61;55403
44;55;02;08;404;Pierrefitte-sur-Aire;326;11;337;55404
44;55;03;05;405;Pillon;256;4;260;55405
44;55;03;09;406;Pintheville;110;4;114;55406
44;55;02;07;407;Pont-sur-Meuse;127;6;133;55407
44;55;03;14;408;Pouilly-sur-Meuse;173;8;181;55408
44;55;01;08;409;Pretz-en-Argonne;65;2;67;55409
44;55;03;11;410;Quincy-Landzécourt;134;6;140;55410
44;55;03;08;411;Rambluzin-et-Benoite-Vaux;107;1;108;55411
44;55;02;13;412;Rambucourt;187;5;192;55412
44;55;01;12;414;Rancourt-sur-Ornain;184;1;185;55414
44;55;02;13;415;Ranzières;86;1;87;55415
44;55;03;06;416;Rarécourt;224;7;231;55416
44;55;03;06;419;Récicourt;161;4;165;55419
44;55;03;08;420;Récourt-le-Creux;77;0;77;55420
44;55;02;15;421;Reffroy;77;4;81;55421
44;55;03;06;422;Regnéville-sur-Meuse;51;0;51;55422
44;55;01;12;423;Rembercourt-Sommaisne;330;8;338;55423
44;55;01;12;424;Remennecourt;50;0;50;55424
44;55;03;11;425;Remoiville;134;0;134;55425
44;55;01;02;426;Resson;387;15;402;55426
44;55;01;12;427;Revigny-sur-Ornain;2802;51;2853;55427
44;55;03;11;428;Réville-aux-Bois;123;1;124;55428
44;55;03;09;429;Riaville;47;0;47;55429
44;55;01;10;430;Ribeaucourt;65;1;66;55430
44;55;02;13;431;Richecourt;58;0;58;55431
44;55;02;15;433;Rigny-la-Salle;358;13;371;55433
44;55;02;15;434;Rigny-Saint-Martin;50;2;52;55434
44;55;01;12;435;Robert-Espagne;782;24;806;55435
44;55;02;10;436;Les Roises;29;0;29;55436
44;55;03;11;437;Romagne-sous-les-Côtes;122;3;125;55437
44;55;03;06;438;Romagne-sous-Montfaucon;185;4;189;55438
44;55;03;09;439;Ronvaux;89;5;94;55439
44;55;01;02;442;Raival;248;3;251;55442
44;55;03;05;443;Rouvres-en-WoÃ«vre;592;6;598;55443
44;55;02;13;444;Rouvrois-sur-Meuse;221;0;221;55444
44;55;03;05;445;Rouvrois-sur-Othain;189;8;197;55445
44;55;01;02;446;Rumont;85;4;89;55446
44;55;01;01;447;Rupt-aux-Nonains;372;7;379;55447
44;55;02;08;448;Rupt-devant-Saint-Mihiel;48;1;49;55448
44;55;03;08;449;Rupt-en-WoÃ«vre;289;4;293;55449
44;55;03;11;450;Rupt-sur-Othain;45;2;47;55450
44;55;01;10;452;Saint-Amand-sur-Ornain;49;2;51;55452
44;55;03;08;453;Saint-André-en-Barrois;65;1;66;55453
44;55;02;15;454;Saint-Aubin-sur-Aire;166;1;167;55454
44;55;02;15;456;Saint-Germain-sur-Meuse;232;8;240;55456
44;55;03;09;457;Saint-Hilaire-en-WoÃ«vre;181;5;186;55457
44;55;03;09;458;Saint-Jean-lès-Buzy;375;0;375;55458
44;55;02;10;459;Saint-Joire;239;3;242;55459
44;55;02;07;460;Saint-Julien-sous-les-Côtes;139;2;141;55460
44;55;03;05;461;Saint-Laurent-sur-Othain;472;16;488;55461
44;55;02;13;462;Saint-Maurice-sous-les-Côtes;340;11;351;55462
44;55;02;13;463;Saint-Mihiel;4039;71;4110;55463
44;55;03;05;464;Saint-Pierrevillers;155;8;163;55464
44;55;03;09;465;Saint-Remy-la-Calonne;104;0;104;55465
44;55;01;15;466;Salmagne;294;8;302;55466
44;55;02;08;467;Sampigny;689;14;703;55467
44;55;03;04;468;Samogneux;98;0;98;55468
44;55;03;14;469;Sassey-sur-Meuse;90;0;90;55469
44;55;01;01;470;Saudrupt;193;2;195;55470
44;55;03;14;471;Saulmory-Villefranche;83;1;84;55471
44;55;02;15;472;Saulvaux;116;6;122;55472
44;55;03;09;473;Saulx-lès-Champlon;113;12;125;55473
44;55;02;15;474;Sauvigny;230;7;237;55474
44;55;02;15;475;Sauvoy;60;1;61;55475
44;55;01;02;476;Savonnières-devant-Bar;471;13;484;55476
44;55;01;01;477;Savonnières-en-Perthois;405;15;420;55477
44;55;01;02;479;Seigneulles;163;3;166;55479
44;55;03;05;481;Senon;336;2;338;55481
44;55;03;08;482;Senoncourt-les-Maujouy;101;2;103;55482
44;55;03;06;484;Septsarges;47;1;48;55484
44;55;02;15;485;Sepvigny;72;3;75;55485
44;55;02;13;487;Seuzey;97;2;99;55487
44;55;01;01;488;Silmont;150;5;155;55488
44;55;03;16;489;Sivry-la-Perche;274;7;281;55489
44;55;03;06;490;Sivry-sur-Meuse;332;11;343;55490
44;55;03;08;492;Sommedieue;989;13;1002;55492
44;55;01;12;493;Sommeilles;190;5;195;55493
44;55;01;01;494;Sommelonne;428;21;449;55494
44;55;03;05;495;Sorbey;252;1;253;55495
44;55;02;15;496;Sorcy-Saint-Martin;1066;30;1096;55496
44;55;03;08;497;Les Souhesmes-Rampont;327;3;330;55497
44;55;03;08;498;Souilly;465;5;470;55498
44;55;03;05;500;Spincourt;832;12;844;55500
44;55;01;01;501;Stainville;385;10;395;55501
44;55;03;14;502;Stenay;2507;129;2636;55502
44;55;02;15;503;Taillancourt;124;2;126;55503
44;55;01;01;504;Tannois;414;11;425;55504
44;55;03;04;505;Thierville-sur-Meuse;3165;97;3262;55505
44;55;02;08;506;Thillombois;31;0;31;55506
44;55;03;09;507;Thillot;219;2;221;55507
44;55;03;11;508;Thonne-la-Long;348;2;350;55508
44;55;03;11;509;Thonne-le-Thil;274;6;280;55509
44;55;03;11;510;Thonne-les-Près;131;3;134;55510
44;55;03;11;511;Thonnelle;120;3;123;55511
44;55;03;08;512;Tilly-sur-Meuse;279;4;283;55512
44;55;01;02;514;Trémont-sur-Saulx;605;10;615;55514
44;55;03;09;515;Trésauvaux;69;1;70;55515
44;55;02;10;516;Tréveray;559;6;565;55516
44;55;01;08;517;Seuil-d'Argonne;513;6;519;55517
44;55;02;15;518;Cousances-lès-Triconville;143;2;145;55518
44;55;01;01;519;Tronville-en-Barrois;1353;29;1382;55519
44;55;02;15;520;Troussey;461;11;472;55520
44;55;02;13;521;Troyon;244;1;245;55521
44;55;02;15;522;Ugny-sur-Meuse;111;3;114;55522
44;55;03;04;523;Vacherauville;189;4;193;55523
44;55;03;08;525;Vadelaincourt;75;0;75;55525
44;55;02;07;526;Vadonville;263;4;267;55526
44;55;03;06;527;Varennes-en-Argonne;639;11;650;55527
44;55;02;13;528;Varnéville;51;0;51;55528
44;55;02;13;530;Valbois;93;1;94;55530
44;55;01;12;531;Vassincourt;280;27;307;55531
44;55;01;12;532;Vaubecourt;310;5;315;55532
44;55;02;15;533;Vaucouleurs;1939;23;1962;55533
44;55;02;10;534;Vaudeville-le-Haut;53;0;53;55534
44;55;03;05;535;Vaudoncourt;96;0;96;55535
44;55;03;06;536;Vauquois;17;3;20;55536
44;55;03;04;537;Douaumont-Vaux;80;0;80;55537
44;55;02;13;540;Vaux-lès-Palameix;60;1;61;55540
44;55;01;03;541;Vavincourt;525;9;534;55541
44;55;01;01;543;Velaines;948;21;969;55543
44;55;03;11;544;Velosnes;151;2;153;55544
44;55;03;99;545;Verdun;16942;964;17906;55545
44;55;03;11;546;Verneuil-Grand;206;8;214;55546
44;55;03;11;547;Verneuil-Petit;117;4;121;55547
44;55;03;06;549;Véry;89;1;90;55549
44;55;02;13;551;Vigneulles-lès-Hattonchâtel;1555;94;1649;55551
44;55;03;11;552;Vigneul-sous-Montmédy;82;4;86;55552
44;55;02;07;553;Vignot;1309;36;1345;55553
44;55;03;11;554;Villécloye;267;15;282;55554
44;55;02;08;555;Ville-devant-Belrain;33;1;34;55555
44;55;03;11;556;Ville-devant-Chaumont;49;1;50;55556
44;55;03;09;557;Ville-en-WoÃ«vre;120;2;122;55557
44;55;02;15;559;Villeroy-sur-Méholle;46;2;48;55559
44;55;01;12;560;Villers-aux-Vents;131;4;135;55560
44;55;03;14;561;Villers-devant-Dun;51;5;56;55561
44;55;01;10;562;Villers-le-Sec;125;2;127;55562
44;55;03;05;563;Villers-lès-Mangiennes;80;4;84;55563
44;55;03;09;565;Villers-sous-Pareid;79;3;82;55565
44;55;03;08;566;Villers-sur-Meuse;306;3;309;55566
44;55;03;08;567;Ville-sur-Cousances;142;2;144;55567
44;55;01;01;568;Ville-sur-Saulx;280;5;285;55568
44;55;01;12;569;Villotte-devant-Louppy;165;5;170;55569
44;55;02;08;570;Villotte-sur-Aire;208;7;215;55570
44;55;03;06;571;Vilosnes-Haraumont;226;8;234;55571
44;55;03;11;572;Vittarville;87;1;88;55572
44;55;02;15;573;Void-Vacon;1629;30;1659;55573
44;55;02;10;574;Vouthon-Bas;44;2;46;55574
44;55;02;10;575;Vouthon-Haut;86;0;86;55575
44;55;01;08;577;Waly;59;2;61;55577
44;55;03;09;578;Warcq;184;7;191;55578
44;55;03;09;579;Watronville;102;0;102;55579
44;55;03;11;580;Wavrille;51;3;54;55580
44;55;01;15;581;Willeroncourt;106;3;109;55581
44;55;03;14;582;Wiseppe;91;1;92;55582
44;55;03;09;583;WoÃ«l;201;4;205;55583
44;55;02;08;584;Woimbey;123;2;125;55584
44;55;02;13;586;Xivray-et-Marvoisin;107;3;110;55586
53;56;03;04;001;Allaire;3886;128;4014;56001
53;56;03;11;002;Ambon;1961;52;2013;56002
53;56;03;20;003;Arradon;5392;175;5567;56003
53;56;03;11;004;Arzal;1682;31;1713;56004
53;56;03;18;005;Arzon;2198;35;2233;56005
53;56;03;04;006;Augan;1526;31;1557;56006
53;56;01;01;007;Auray;14141;423;14564;56007
53;56;03;20;008;Baden;4396;121;4517;56008
53;56;01;17;009;Bangor;1012;20;1032;56009
53;56;02;15;010;Baud;6234;192;6426;56010
53;56;03;04;011;Béganne;1395;27;1422;56011
53;56;03;04;012;Beignon;1962;42;2004;56012
53;56;01;17;013;Belz;3760;61;3821;56013
53;56;02;02;014;Berné;1544;137;1681;56014
53;56;03;16;015;Berric;2026;30;2056;56015
53;56;02;10;017;Bignan;2774;63;2837;56017
53;56;03;11;018;Billiers;1008;27;1035;56018
53;56;02;10;019;Billio;336;10;346;56019
53;56;03;10;020;Bohal;855;15;870;56020
53;56;01;14;021;Brandérion;1459;27;1486;56021
53;56;03;03;022;Brandivy;1300;27;1327;56022
53;56;01;14;023;Brech;6660;282;6942;56023
53;56;02;03;024;Bréhan;2289;35;2324;56024
53;56;02;13;025;Brignac;192;4;196;56025
53;56;01;05;026;Bubry;2317;59;2376;56026
53;56;02;10;027;Buléon;540;8;548;56027
53;56;03;16;028;Caden;1589;37;1626;56028
53;56;01;05;029;Calan;1233;24;1257;56029
53;56;03;11;030;CamoÃ«l;1039;16;1055;56030
53;56;01;14;031;Camors;3066;61;3127;56031
53;56;02;13;032;Campénéac;1888;53;1941;56032
53;56;03;04;033;Carentoir;3074;58;3132;56033
53;56;01;17;034;Carnac;4236;126;4362;56034
53;56;03;10;035;Caro;1149;31;1180;56035
53;56;01;07;036;Caudan;6920;202;7122;56036
53;56;02;03;039;La Chapelle-Neuve;979;21;1000;56039
53;56;01;05;040;Cléguer;3298;61;3359;56040
53;56;02;02;041;Cléguérec;2828;90;2918;56041
53;56;03;03;042;Colpo;2192;36;2228;56042
53;56;02;13;043;Concoret;737;10;747;56043
53;56;03;04;044;Cournon;786;30;816;56044
53;56;03;16;045;Le Cours;672;10;682;56045
53;56;01;01;046;Crach;3394;81;3475;56046
53;56;02;03;047;Crédin;1520;47;1567;56047
53;56;02;02;048;Le Croisty;708;17;725;56048
53;56;02;15;049;Croixanvec;173;4;177;56049
53;56;02;13;050;La Croix-Helléan;885;32;917;56050
53;56;02;13;051;Cruguel;655;5;660;56051
53;56;03;11;052;Damgan;1839;26;1865;56052
53;56;03;16;053;Elven;6261;119;6380;56053
53;56;01;17;054;Erdeven;3853;97;3950;56054
53;56;01;17;055;Etel;2054;180;2234;56055
53;56;02;13;056;Evriguet;199;4;203;56056
53;56;02;02;057;Le FaouÃ«t;2793;58;2851;56057
53;56;03;11;058;Férel;3318;62;3380;56058
53;56;03;04;060;Les Fougerêts;951;35;986;56060
53;56;03;04;061;La Gacilly;3962;80;4042;56061
53;56;01;14;062;Gâvres;680;20;700;56062
53;56;01;05;063;Gestel;2637;90;2727;56063
53;56;02;13;065;Gourhel;721;25;746;56065
53;56;02;02;066;Gourin;3779;150;3929;56066
53;56;03;03;067;Grand-Champ;5552;139;5691;56067
53;56;02;13;068;La Grée-Saint-Laurent;322;3;325;56068
53;56;01;09;069;Groix;2234;53;2287;56069
53;56;02;13;070;Guégon;2272;51;2323;56070
53;56;02;10;071;Guéhenno;800;12;812;56071
53;56;02;15;072;Gueltas;514;10;524;56072
53;56;02;02;073;Guémené-sur-Scorff;1060;17;1077;56073
53;56;02;15;074;Guénin;1822;37;1859;56074
53;56;03;04;075;Guer;6091;300;6391;56075
53;56;02;15;076;Guern;1313;38;1351;56076
53;56;03;11;077;Le Guerno;999;17;1016;56077
53;56;01;05;078;Guidel;11767;309;12076;56078
53;56;02;13;079;Guillac;1343;41;1384;56079
53;56;02;13;080;Guilliers;1305;143;1448;56080
53;56;02;02;081;Guiscriff;2083;60;2143;56081
53;56;02;13;082;Helléan;384;7;391;56082
53;56;01;06;083;Hennebont;16062;405;16467;56083
53;56;03;18;084;Le Hézo;852;13;865;56084
53;56;01;17;085;HÅ“dic;94;6;100;56085
53;56;01;17;086;ÃŽle-d'Houat;216;6;222;56086
53;56;03;20;087;ÃŽle-aux-Moines;620;18;638;56087
53;56;03;20;088;ÃŽle-d'Arz;227;8;235;56088
53;56;01;05;089;Inguiniel;2185;58;2243;56089
53;56;01;05;090;Inzinzac-Lochrist;6548;135;6683;56090
53;56;02;13;091;Josselin;2482;95;2577;56091
53;56;02;15;092;Kerfourn;833;15;848;56092
53;56;02;02;093;Kergrist;720;26;746;56093
53;56;01;06;094;Kervignac;6786;216;7002;56094
53;56;01;14;096;Landaul;2392;51;2443;56096
53;56;01;14;097;Landévant;3961;70;4031;56097
53;56;01;07;098;Lanester;23124;475;23599;56098
53;56;02;02;099;LangoÃ«lan;378;6;384;56099
53;56;02;02;100;Langonnet;1724;58;1782;56100
53;56;01;06;101;Languidic;8064;151;8215;56101
53;56;02;13;102;Forges de Lanouée;2165;49;2214;56102
53;56;02;13;103;Lantillac;299;4;303;56103
53;56;01;05;104;Lanvaudan;801;11;812;56104
53;56;02;02;105;Lanvénégen;1144;23;1167;56105
53;56;03;20;106;Larmor-Baden;874;18;892;56106
53;56;01;12;107;Larmor-Plage;8319;243;8562;56107
53;56;03;16;108;Larré;1067;21;1088;56108
53;56;03;16;109;Lauzach;1167;27;1194;56109
53;56;02;02;110;Lignol;846;21;867;56110
53;56;03;16;111;Limerzel;1312;22;1334;56111
53;56;03;10;112;Lizio;736;15;751;56112
53;56;02;02;113;Locmalo;903;20;923;56113
53;56;01;17;114;Locmaria;931;30;961;56114
53;56;03;03;115;Locmaria-Grand-Champ;1708;39;1747;56115
53;56;01;01;116;Locmariaquer;1552;45;1597;56116
53;56;02;03;117;Locminé;4505;238;4743;56117
53;56;01;06;118;Locmiquélic;4039;112;4151;56118
53;56;01;17;119;Locoal-Mendon;3464;63;3527;56119
53;56;03;03;120;Locqueltas;1885;40;1925;56120
53;56;01;98;121;Lorient;57246;1486;58732;56121
53;56;02;13;122;Loyat;1621;42;1663;56122
53;56;03;16;123;Malansac;2195;43;2238;56123
53;56;03;10;124;Malestroit;2470;78;2548;56124
53;56;02;02;125;Malguénac;1841;66;1907;56125
53;56;03;11;126;Marzan;2421;28;2449;56126
53;56;02;13;127;Mauron;3145;71;3216;56127
53;56;02;15;128;Melrand;1521;27;1548;56128
53;56;02;13;129;Ménéac;1532;36;1568;56129
53;56;01;14;130;Merlevenez;3238;70;3308;56130
53;56;02;02;131;Meslan;1417;31;1448;56131
53;56;03;21;132;Meucon;2262;53;2315;56132
53;56;03;10;133;Missiriac;1155;27;1182;56133
53;56;02;13;134;Mohon;979;11;990;56134
53;56;03;16;135;Molac;1605;29;1634;56135
53;56;03;04;136;Monteneuf;756;15;771;56136
53;56;03;21;137;Monterblanc;3299;78;3377;56137
53;56;02;13;139;Montertelot;360;10;370;56139
53;56;02;10;140;Moréac;3733;94;3827;56140
53;56;02;03;141;Moustoir-Ac;1733;37;1770;56141
53;56;03;11;143;Muzillac;5066;126;5192;56143
53;56;02;03;144;Evellys;3483;63;3546;56144
53;56;02;13;145;Néant-sur-Yvel;1109;27;1136;56145
53;56;02;02;146;Neulliac;1390;49;1439;56146
53;56;03;11;147;Nivillac;4677;85;4762;56147
53;56;01;14;148;Nostang;1576;32;1608;56148
53;56;03;11;149;Noyal-Muzillac;2520;52;2572;56149
53;56;02;15;151;Noyal-Pontivy;3605;116;3721;56151
53;56;01;17;152;Le Palais;2544;54;2598;56152
53;56;03;11;153;Péaule;2712;43;2755;56153
53;56;03;04;154;Peillac;1847;50;1897;56154
53;56;03;11;155;Pénestin;2019;26;2045;56155
53;56;02;02;156;Persquen;351;6;357;56156
53;56;03;03;157;Plaudren;1953;55;2008;56157
53;56;03;20;158;Plescop;6145;178;6323;56158
53;56;03;10;159;Pleucadeuc;1820;43;1863;56159
53;56;02;03;160;Pleugriffet;1297;22;1319;56160
53;56;01;17;161;Ploemel;2988;89;3077;56161
53;56;01;12;162;Ploemeur;17778;639;18417;56162
53;56;02;02;163;PloÃ«rdut;1209;26;1235;56163
53;56;03;20;164;Ploeren;6635;222;6857;56164
53;56;02;13;165;PloÃ«rmel;9791;564;10355;56165
53;56;01;05;166;Plouay;5792;128;5920;56166
53;56;03;20;167;Plougoumelen;2522;82;2604;56167
53;56;01;17;168;Plouharnel;2214;48;2262;56168
53;56;01;14;169;Plouhinec;5386;125;5511;56169
53;56;02;02;170;Plouray;1062;32;1094;56170
53;56;03;16;171;Pluherlin;1532;26;1558;56171
53;56;02;10;172;Plumelec;2679;79;2758;56172
53;56;02;15;173;Pluméliau-Bieuzy;4355;97;4452;56173
53;56;02;03;174;Plumelin;2770;70;2840;56174
53;56;01;01;175;Plumergat;4178;94;4272;56175
53;56;01;01;176;Pluneret;5905;140;6045;56176
53;56;01;14;177;Pluvigner;7676;141;7817;56177
53;56;02;15;178;Pontivy;15064;934;15998;56178
53;56;01;05;179;Pont-Scorff;3844;85;3929;56179
53;56;03;04;180;Porcaro;729;16;745;56180
53;56;01;06;181;Port-Louis;2654;100;2754;56181
53;56;02;02;182;Priziac;967;181;1148;56182
53;56;03;16;184;Questembert;7862;274;8136;56184
53;56;01;12;185;Quéven;8770;238;9008;56185
53;56;01;17;186;Quiberon;4658;91;4749;56186
53;56;01;05;188;Quistinic;1416;23;1439;56188
53;56;02;03;189;Radenac;1067;16;1083;56189
53;56;02;03;190;Réguiny;1964;52;2016;56190
53;56;03;04;191;Réminiac;411;10;421;56191
53;56;01;06;193;Riantec;5821;144;5965;56193
53;56;03;04;194;Rieux;2865;74;2939;56194
53;56;03;11;195;La Roche-Bernard;701;11;712;56195
53;56;03;16;196;Rochefort-en-Terre;641;13;654;56196
53;56;02;10;197;Val d'Oust;2758;75;2833;56197
53;56;02;03;198;Rohan;1636;44;1680;56198
53;56;02;02;199;Roudouallec;705;14;719;56199
53;56;03;10;200;Ruffiac;1385;34;1419;56200
53;56;02;02;201;Le Saint;579;11;590;56201
53;56;03;10;202;Saint-Abraham;529;14;543;56202
53;56;02;02;203;Saint-Aignan;631;14;645;56203
53;56;02;10;204;Saint-Allouestre;632;8;640;56204
53;56;03;18;205;Saint-Armel;873;18;891;56205
53;56;03;21;206;Saint-Avé;11895;303;12198;56206
53;56;02;15;207;Saint-Barthélemy;1160;17;1177;56207
53;56;02;13;208;Saint-Brieuc-de-Mauron;304;10;314;56208
53;56;02;02;209;Sainte-Brigitte;179;7;186;56209
53;56;02;02;210;Saint-Caradec-Trégomel;480;6;486;56210
53;56;03;10;211;Saint-Congard;795;17;812;56211
53;56;03;11;212;Saint-Dolay;2539;42;2581;56212
53;56;02;15;213;Saint-Gérand;1144;30;1174;56213
53;56;03;18;214;Saint-Gildas-de-Rhuys;1531;24;1555;56214
53;56;02;15;215;Saint-Gonnery;1106;25;1131;56215
53;56;03;04;216;Saint-Gorgon;393;4;397;56216
53;56;03;16;218;Saint-Gravé;716;5;721;56218
53;56;03;10;219;Saint-Guyomard;1389;22;1411;56219
53;56;01;14;220;Sainte-Hélène;1262;30;1292;56220
53;56;03;04;221;Saint-Jacut-les-Pins;1747;83;1830;56221
53;56;02;10;222;Saint-Jean-Brévelay;2836;140;2976;56222
53;56;03;04;223;Saint-Jean-la-Poterie;1469;59;1528;56223
53;56;03;10;224;Saint-Laurent-sur-Oust;381;10;391;56224
53;56;02;13;225;Saint-Léry;202;8;210;56225
53;56;03;04;226;Saint-Malo-de-Beignon;532;23;555;56226
53;56;02;13;227;Saint-Malo-des-Trois-Fontaines;584;14;598;56227
53;56;03;10;228;Saint-Marcel;1106;48;1154;56228
53;56;03;04;229;Saint-Martin-sur-Oust;1294;19;1313;56229
53;56;03;10;230;Saint-Nicolas-du-Tertre;470;11;481;56230
53;56;03;21;231;Saint-Nolff;3847;123;3970;56231
53;56;03;04;232;Saint-Perreux;1074;41;1115;56232
53;56;01;01;233;Saint-Philibert;1495;43;1538;56233
53;56;01;17;234;Saint-Pierre-Quiberon;2056;39;2095;56234
53;56;02;13;236;Saint-Servant;812;18;830;56236
53;56;02;15;237;Saint-Thuriau;1865;77;1942;56237
53;56;02;02;238;Saint-Tugdual;369;9;378;56238
53;56;03;04;239;Saint-Vincent-sur-Oust;1563;42;1605;56239
53;56;03;18;240;Sarzeau;8791;177;8968;56240
53;56;01;17;241;Sauzon;996;24;1020;56241
53;56;02;02;242;Séglien;652;18;670;56242
53;56;03;18;243;Séné;8900;255;9155;56243
53;56;03;10;244;Sérent;3066;40;3106;56244
53;56;02;02;245;Silfiac;463;14;477;56245
53;56;02;15;246;Le Sourn;2104;44;2148;56246
53;56;03;16;247;Sulniac;3756;90;3846;56247
53;56;03;18;248;Surzur;4724;96;4820;56248
53;56;02;13;249;Taupont;2191;87;2278;56249
53;56;03;04;250;Théhillac;604;5;609;56250
53;56;03;18;251;Theix-Noyalo;8251;236;8487;56251
53;56;03;18;252;Le Tour-du-Parc;1210;8;1218;56252
53;56;03;04;253;Tréal;640;25;665;56253
53;56;03;16;254;Trédion;1308;19;1327;56254
53;56;03;21;255;Treffléan;2406;56;2462;56255
53;56;02;13;256;Tréhorenteuc;116;0;116;56256
53;56;02;13;257;La Trinité-PorhoÃ«t;671;17;688;56257
53;56;01;17;258;La Trinité-sur-Mer;1622;47;1669;56258
53;56;03;18;259;La Trinité-Surzur;1687;22;1709;56259
53;56;03;99;260;Vannes;53719;1973;55692;56260
53;56;03;16;261;La Vraie-Croix;1489;30;1519;56261
53;56;03;20;262;Bono;2533;43;2576;56262
53;56;01;01;263;Sainte-Anne-d'Auray;2770;126;2896;56263
53;56;02;02;264;Kernascléden;384;10;394;56264
44;57;07;14;001;Aboncourt;330;3;333;57001
44;57;05;23;002;Aboncourt-sur-Seille;70;1;71;57002
44;57;05;17;003;Abreschviller;1400;20;1420;57003
44;57;05;23;004;Achain;79;1;80;57004
44;57;06;02;006;Achen;991;28;1019;57006
44;57;03;07;007;Adaincourt;124;2;126;57007
44;57;03;07;008;Adelange;204;7;211;57008
44;57;05;23;009;Ajoncourt;104;1;105;57009
44;57;05;23;010;Alaincourt-la-Côte;156;2;158;57010
44;57;05;23;011;Albestroff;618;23;641;57011
44;57;07;01;012;Algrange;6120;56;6176;57012
44;57;03;25;013;Alsting;2535;51;2586;57013
44;57;03;20;014;Altrippe;370;7;377;57014
44;57;03;19;015;Altviller;577;7;584;57015
44;57;03;04;016;Alzing;389;8;397;57016
44;57;09;18;017;Amanvillers;2098;23;2121;57017
44;57;05;23;018;Amelécourt;132;8;140;57018
44;57;09;18;019;Amnéville;10416;72;10488;57019
44;57;09;07;020;Ancerville;305;3;308;57020
44;57;09;05;021;Ancy-Dornot;1518;30;1548;57021
44;57;07;01;022;Angevillers;1253;29;1282;57022
44;57;09;16;024;Antilly;184;0;184;57024
44;57;03;04;025;Anzeling;527;7;534;57025
44;57;07;04;026;Apach;1070;18;1088;57026
44;57;03;07;027;Arraincourt;126;3;129;57027
44;57;09;16;028;Argancy;1339;39;1378;57028
44;57;03;07;029;Arriance;215;3;218;57029
44;57;09;05;030;Arry;565;3;568;57030
44;57;09;16;031;Ars-Laquenexy;899;15;914;57031
44;57;09;05;032;Ars-sur-Moselle;4704;53;4757;57032
44;57;05;17;033;Arzviller;537;15;552;57033
44;57;05;17;034;Aspach;35;1;36;57034
44;57;05;21;035;Assenoncourt;117;3;120;57035
44;57;05;23;036;Attilloncourt;103;0;103;57036
44;57;09;07;037;Aube;269;5;274;57037
44;57;07;01;038;Audun-le-Tiche;7048;63;7111;57038
44;57;09;05;039;Augny;2165;34;2199;57039
44;57;05;23;040;Aulnois-sur-Seille;278;2;280;57040
44;57;07;01;041;Aumetz;2351;33;2384;57041
44;57;05;21;042;Avricourt;593;12;605;57042
44;57;09;16;043;Ay-sur-Moselle;1469;31;1500;57043
44;57;05;21;044;Azoudange;123;5;128;57044
44;57;05;23;045;Bacourt;109;1;110;57045
44;57;06;02;046;Baerenthal;763;14;777;57046
44;57;03;07;047;Bambiderstroff;1055;20;1075;57047
44;57;03;03;048;Bannay;73;2;75;57048
44;57;09;15;049;Le Ban-Saint-Martin;4517;72;4589;57049
44;57;05;17;050;Barchain;112;2;114;57050
44;57;03;20;051;Baronville;368;4;372;57051
44;57;03;09;052;Barst;576;9;585;57052
44;57;05;23;053;Bassing;111;6;117;57053
44;57;05;23;054;Baudrecourt;188;0;188;57054
44;57;09;16;055;Bazoncourt;536;3;539;57055
44;57;05;21;056;Bébing;194;5;199;57056
44;57;09;07;057;Béchy;608;6;614;57057
44;57;03;25;058;Behren-lès-Forbach;6562;65;6627;57058
44;57;05;23;059;Bellange;51;2;53;57059
44;57;05;23;060;Bénestroff;532;7;539;57060
44;57;03;09;061;Béning-lès-Saint-Avold;1152;26;1178;57061
44;57;07;27;062;Berg-sur-Moselle;432;14;446;57062
44;57;03;20;063;Bérig-Vintrange;216;8;224;57063
44;57;05;17;064;Berling;261;4;265;57064
44;57;05;23;065;Bermering;220;6;226;57065
44;57;05;21;066;Berthelming;514;8;522;57066
44;57;07;14;067;Bertrange;2801;59;2860;57067
44;57;03;04;069;Berviller-en-Moselle;463;7;470;57069
44;57;03;03;070;Bettange;248;2;250;57070
44;57;05;21;071;Bettborn;387;5;392;57071
44;57;07;14;072;Bettelainville;622;8;630;57072
44;57;03;09;073;Betting;870;16;886;57073
44;57;06;02;074;Bettviller;824;17;841;57074
44;57;09;07;075;Beux;293;3;296;57075
44;57;07;27;076;Beyren-lès-Sierck;508;17;525;57076
44;57;05;23;077;Bezange-la-Petite;97;3;100;57077
44;57;03;04;079;Bibiche;445;9;454;57079
44;57;05;21;080;Bickenholtz;83;0;83;57080
44;57;05;23;081;Bidestroff;131;1;132;57081
44;57;03;20;082;Biding;331;7;338;57082
44;57;06;02;083;Bining;1211;26;1237;57083
44;57;05;23;084;Bioncourt;303;2;305;57084
44;57;03;03;085;Bionville-sur-Nied;384;2;386;57085
44;57;05;21;086;Belles-Forêts;235;5;240;57086
44;57;03;03;087;Bisten-en-Lorraine;248;4;252;57087
44;57;03;20;088;Bistroff;313;7;320;57088
44;57;06;02;089;Bitche;4951;101;5052;57089
44;57;05;23;090;Blanche-Eglise;111;2;113;57090
44;57;06;22;091;Bliesbruck;1010;21;1031;57091
44;57;06;22;092;Blies-Ebersing;619;8;627;57092
44;57;06;22;093;Blies-Guersviller;646;12;658;57093
44;57;03;07;095;Boucheporn;578;9;587;57095
44;57;07;01;096;Boulange;2476;25;2501;57096
44;57;03;03;097;Boulay-Moselle;5580;71;5651;57097
44;57;05;23;098;Bourgaltroff;239;13;252;57098
44;57;05;23;099;Bourdonnay;230;5;235;57099
44;57;05;17;100;Bourscheid;174;5;179;57100
44;57;03;25;101;Bousbach;1248;24;1272;57101
44;57;07;14;102;Bousse;3205;48;3253;57102
44;57;06;02;103;Bousseviller;125;4;129;57103
44;57;07;27;104;Boust;1180;28;1208;57104
44;57;03;20;105;Boustroff;150;1;151;57105
44;57;03;04;106;Bouzonville;3926;78;4004;57106
44;57;05;23;107;Bréhain;106;0;106;57107
44;57;06;02;108;Breidenbach;318;5;323;57108
44;57;07;27;109;Breistroff-la-Grande;761;12;773;57109
44;57;03;04;110;Brettnach;430;2;432;57110
44;57;09;18;111;Bronvaux;525;3;528;57111
44;57;03;03;112;Brouck;85;1;86;57112
44;57;05;17;113;Brouderdorff;972;22;994;57113
44;57;05;17;114;Brouviller;425;15;440;57114
44;57;03;20;115;Brulange;96;4;100;57115
44;57;09;07;116;Buchy;95;1;96;57116
44;57;07;14;117;Buding;588;5;593;57117
44;57;07;14;118;Budling;167;6;173;57118
44;57;05;21;119;Buhl-Lorraine;1191;31;1222;57119
44;57;05;23;120;Burlioncourt;123;3;126;57120
44;57;09;16;121;Burtoncourt;212;5;217;57121
44;57;03;09;122;Cappel;685;11;696;57122
44;57;03;19;123;Carling;3415;44;3459;57123
44;57;07;27;124;Cattenom;2628;34;2662;57124
44;57;09;16;125;Chailly-lès-Ennery;420;7;427;57125
44;57;05;23;126;Chambrey;325;10;335;57126
44;57;09;07;127;Chanville;147;1;148;57127
44;57;09;16;128;Charleville-sous-Bois;321;3;324;57128
44;57;09;16;129;Charly-Oradour;672;21;693;57129
44;57;05;23;130;Château-Bréhain;75;1;76;57130
44;57;03;04;131;Château-Rouge;286;11;297;57131
44;57;05;23;132;Château-Salins;2357;244;2601;57132
44;57;05;23;133;Château-Voué;96;0;96;57133
44;57;09;05;134;Châtel-Saint-Germain;1916;193;2109;57134
44;57;03;04;136;Chémery-les-Deux;570;17;587;57136
44;57;09;07;137;Cheminot;812;14;826;57137
44;57;05;23;138;Chenois;83;3;86;57138
44;57;09;07;139;Chérisey;291;6;297;57139
44;57;09;16;140;Chesny;577;10;587;57140
44;57;05;23;141;Chicourt;91;0;91;57141
44;57;09;16;142;Chieulles;423;7;430;57142
44;57;07;10;143;Clouange;3374;33;3407;57143
44;57;03;08;144;Cocheren;3380;42;3422;57144
44;57;09;16;145;Coincy;326;5;331;57145
44;57;09;05;146;Coin-lès-Cuvry;796;19;815;57146
44;57;09;05;147;Coin-sur-Seille;338;14;352;57147
44;57;09;16;148;Colligny-Maizery;567;11;578;57148
44;57;03;04;149;Colmen;200;4;204;57149
44;57;03;03;150;Condé-Northen;691;8;699;57150
44;57;05;23;151;Conthil;153;2;155;57151
44;57;07;04;152;Contz-les-Bains;510;10;520;57152
44;57;09;05;153;Corny-sur-Moselle;2185;39;2224;57153
44;57;03;03;154;Coume;634;19;653;57154
44;57;09;16;155;Courcelles-Chaussy;3006;325;3331;57155
44;57;09;16;156;Courcelles-sur-Nied;1172;11;1183;57156
44;57;05;23;158;Craincourt;246;1;247;57158
44;57;03;07;159;Créhange;3871;56;3927;57159
44;57;03;03;160;Creutzwald;13042;216;13258;57160
44;57;05;23;161;Cutting;116;1;117;57161
44;57;09;05;162;Cuvry;864;14;878;57162
44;57;05;17;163;Dabo;2430;47;2477;57163
44;57;03;04;165;Dalem;690;9;699;57165
44;57;05;23;166;Dalhain;107;2;109;57166
44;57;03;04;167;Dalstein;371;6;377;57167
44;57;05;17;168;Danne-et-Quatre-Vents;679;16;695;57168
44;57;05;17;169;Dannelbourg;497;16;513;57169
44;57;05;23;171;Delme;1148;9;1157;57171
44;57;03;03;172;Denting;282;1;283;57172
44;57;05;21;173;Desseling;101;3;104;57173
44;57;03;20;174;Destry;96;1;97;57174
44;57;05;21;175;Diane-Capelle;221;6;227;57175
44;57;03;25;176;Diebling;1680;41;1721;57176
44;57;05;23;177;Dieuze;2800;232;3032;57177
44;57;03;20;178;Diffembach-lès-Hellimer;346;6;352;57178
44;57;07;14;179;Distroff;1828;33;1861;57179
44;57;05;21;180;Dolving;345;7;352;57180
44;57;05;23;181;Domnom-lès-Dieuze;78;1;79;57181
44;57;05;23;182;Donjeux;96;3;99;57182
44;57;05;23;183;Donnelay;189;2;191;57183
44;57;03;04;186;Ebersviller;954;11;965;57186
44;57;03;03;187;Eblange;367;6;373;57187
44;57;06;02;188;Eguelshardt;419;77;496;57188
44;57;03;20;189;Eincheville;222;2;224;57189
44;57;03;07;190;Elvange;418;4;422;57190
44;57;07;14;191;Elzange;705;8;713;57191
44;57;06;02;192;Enchenberg;1239;33;1272;57192
44;57;09;16;193;Ennery;2157;25;2182;57193
44;57;07;27;194;Entrange;1242;37;1279;57194
44;57;06;02;195;Epping;572;15;587;57195
44;57;06;02;196;Erching;420;11;431;57196
44;57;06;20;197;Ernestviller;513;5;518;57197
44;57;03;20;198;Erstroff;193;3;196;57198
44;57;07;27;199;Escherange;686;15;701;57199
44;57;09;16;200;Les Etangs;399;10;409;57200
44;57;06;02;201;Etting;725;13;738;57201
44;57;03;25;202;Etzling;1161;17;1178;57202
44;57;07;27;203;Evrange;228;4;232;57203
44;57;09;16;204;Failly;530;10;540;57204
44;57;03;04;205;Falck;2506;31;2537;57205
44;57;07;06;206;Fameck;14442;157;14599;57206
44;57;03;09;207;Farébersviller;5493;56;5549;57207
44;57;03;25;208;Farschviller;1355;34;1389;57208
44;57;03;07;209;Faulquemont;5154;84;5238;57209
44;57;05;21;210;Fénétrange;686;17;703;57210
44;57;09;18;211;Fèves;1179;12;1191;57211
44;57;09;05;212;Féy;730;9;739;57212
44;57;03;04;213;Filstroff;773;14;787;57213
44;57;07;27;214;Fixem;414;7;421;57214
44;57;07;04;215;Flastroff;324;4;328;57215
44;57;05;21;216;Fleisheim;144;5;149;57216
44;57;03;07;217;Flétrange;900;18;918;57217
44;57;09;07;218;Fleury;1286;30;1316;57218
44;57;09;16;219;Flévy;546;6;552;57219
44;57;09;07;220;Flocourt;119;2;121;57220
44;57;07;06;221;Florange;11972;93;12065;57221
44;57;03;25;222;Folkling;1325;38;1363;57222
44;57;03;19;224;Folschviller;3949;69;4018;57224
44;57;05;23;225;Fonteny;140;0;140;57225
44;57;07;01;226;Fontoy;3095;40;3135;57226
44;57;03;08;227;Forbach;21597;290;21887;57227
44;57;05;23;228;Fossieux;200;5;205;57228
44;57;05;21;229;Foulcrey;156;3;159;57229
44;57;03;07;230;Fouligny;195;2;197;57230
44;57;09;23;231;Foville;99;0;99;57231
44;57;05;23;232;Francaltroff;776;12;788;57232
44;57;05;17;233;Fraquelfing;85;1;86;57233
44;57;06;22;234;Frauenberg;597;8;605;57234
44;57;03;04;235;Freistroff;1037;20;1057;57235
44;57;05;23;236;Frémery;84;0;84;57236
44;57;03;20;237;Frémestroff;304;7;311;57237
44;57;05;23;238;Fresnes-en-Saulnois;190;6;196;57238
44;57;03;20;239;Freybouse;432;6;438;57239
44;57;03;09;240;Freyming-Merlebach;12725;120;12845;57240
44;57;05;21;241;Fribourg;166;8;174;57241
44;57;07;10;242;Gandrange;3028;35;3063;57242
44;57;05;17;244;Garrebourg;491;11;502;57244
44;57;07;27;245;Gavisse;570;9;579;57245
44;57;05;23;246;Gelucourt;215;4;219;57246
44;57;05;23;247;Gerbécourt;80;3;83;57247
44;57;05;23;248;Givrycourt;87;1;88;57248
44;57;09;16;249;Glatigny;259;7;266;57249
44;57;06;02;250;Goetzenbruck;1494;40;1534;57250
44;57;09;07;251;Goin;339;2;341;57251
44;57;03;03;252;Gomelange;480;10;490;57252
44;57;05;21;253;Gondrexange;501;3;504;57253
44;57;09;05;254;Gorze;1157;10;1167;57254
44;57;05;21;255;Gosselming;575;23;598;57255
44;57;09;05;256;Gravelotte;827;4;831;57256
44;57;05;23;257;Grémecey;105;0;105;57257
44;57;03;20;258;Gréning;118;1;119;57258
44;57;07;04;259;Grindorff-Bizing;319;7;326;57259
44;57;06;22;260;Grosbliederstroff;3296;53;3349;57260
44;57;06;02;261;Gros-Réderching;1350;40;1390;57261
44;57;03;20;262;Grostenquin;647;7;654;57262
44;57;06;20;263;Grundviller;642;19;661;57263
44;57;06;20;264;Guebenhouse;411;6;417;57264
44;57;05;23;265;Guébestroff;58;4;62;57265
44;57;05;23;266;Guéblange-lès-Dieuze;150;4;154;57266
44;57;06;20;267;Le Val-de-Guéblange;850;18;868;57267
44;57;05;23;268;Guébling;123;4;127;57268
44;57;07;14;269;Guénange;7559;67;7626;57269
44;57;05;23;270;Val-de-Bride;583;13;596;57270
44;57;03;09;271;Guenviller;667;17;684;57271
44;57;05;21;272;Guermange;88;5;93;57272
44;57;03;04;273;Guerstling;395;9;404;57273
44;57;03;03;274;Guerting;856;20;876;57274
44;57;03;20;275;Guessling-Hémering;919;12;931;57275
44;57;03;07;276;Guinglange;328;5;333;57276
44;57;03;03;277;Guinkirchen;149;6;155;57277
44;57;05;23;278;Guinzeling;66;0;66;57278
44;57;05;17;280;Guntzviller;370;20;390;57280
44;57;05;23;281;Haboudange;246;5;251;57281
44;57;07;27;282;Hagen;357;4;361;57282
44;57;09;24;283;Hagondange;9287;105;9392;57283
44;57;03;07;284;Hallering;113;5;118;57284
44;57;07;04;286;Halstroff;305;9;314;57286
44;57;07;14;287;Basse-Ham;2226;44;2270;57287
44;57;03;03;288;Ham-sous-Varsberg;2848;40;2888;57288
44;57;06;22;289;Hambach;2875;67;2942;57289
44;57;05;23;290;Hampont;180;2;182;57290
44;57;05;17;291;Hangviller;263;4;267;57291
44;57;05;23;292;Hannocourt;20;0;20;57292
44;57;03;07;293;Han-sur-Nied;258;6;264;57293
44;57;06;02;294;Hanviller;198;8;206;57294
44;57;05;23;295;Haraucourt-sur-Seille;106;1;107;57295
44;57;03;04;296;Hargarten-aux-Mines;1096;20;1116;57296
44;57;03;20;297;Harprich;183;6;189;57297
44;57;05;17;298;Harreberg;382;7;389;57298
44;57;05;17;299;Hartzviller;917;16;933;57299
44;57;05;17;300;Haselbourg;330;7;337;57300
44;57;06;02;301;Haspelschiedt;304;12;316;57301
44;57;05;17;302;Hattigny;189;1;190;57302
44;57;09;24;303;Hauconcourt;599;9;608;57303
44;57;05;21;304;Haut-Clocher;355;11;366;57304
44;57;07;01;305;Havange;451;8;459;57305
44;57;07;10;306;Hayange;16005;186;16191;57306
44;57;09;16;307;Hayes;249;5;254;57307
44;57;06;20;308;Hazembourg;149;5;154;57308
44;57;03;04;309;Heining-lès-Bouzonville;483;9;492;57309
44;57;05;21;310;Hellering-lès-Fénétrange;190;4;194;57310
44;57;03;20;311;Hellimer;527;9;536;57311
44;57;03;03;312;Helstroff;506;8;514;57312
44;57;03;07;313;Hémilly;141;3;144;57313
44;57;05;17;314;Héming;496;3;499;57314
44;57;05;17;315;Henridorff;712;15;727;57315
44;57;03;09;316;Henriville;744;16;760;57316
44;57;05;17;317;Hérange;108;4;112;57317
44;57;05;17;318;Hermelange;215;5;220;57318
44;57;03;07;319;Herny;521;5;526;57319
44;57;05;21;320;Hertzing;183;3;186;57320
44;57;05;17;321;Hesse;563;19;582;57321
44;57;03;04;322;Hestroff;466;6;472;57322
44;57;07;27;323;Hettange-Grande;7779;167;7946;57323
44;57;05;21;324;Hilbesheim;617;22;639;57324
44;57;06;20;325;Hilsprich;832;17;849;57325
44;57;03;03;326;Hinckange;333;4;337;57326
44;57;03;07;328;Holacourt;89;2;91;57328
44;57;03;04;329;Holling;433;11;444;57329
44;57;06;20;330;Holving;1283;21;1304;57330
44;57;07;14;331;Hombourg-Budange;543;10;553;57331
44;57;03;09;332;Hombourg-Haut;6283;61;6344;57332
44;57;05;21;333;Hommarting;827;23;850;57333
44;57;05;17;334;Hommert;324;10;334;57334
44;57;05;23;335;Honskirch;221;4;225;57335
44;57;03;19;336;L'Hôpital;5229;56;5285;57336
44;57;03;09;337;Hoste;593;17;610;57337
44;57;06;02;338;Hottviller;515;6;521;57338
44;57;05;17;339;Hultehouse;367;6;373;57339
44;57;06;22;340;Hundling;1345;20;1365;57340
44;57;07;04;341;Hunting;707;16;723;57341
44;57;05;21;342;Ibigny;96;1;97;57342
44;57;07;27;343;Illange;1835;31;1866;57343
44;57;05;21;344;Imling;734;9;743;57344
44;57;07;14;345;Inglange;422;31;453;57345
44;57;05;23;346;Insming;590;23;613;57346
44;57;05;23;347;Insviller;174;3;177;57347
44;57;06;22;348;Ippling;797;17;814;57348
44;57;05;23;349;Jallaucourt;154;3;157;57349
44;57;09;05;350;Jouy-aux-Arches;1438;20;1458;57350
44;57;09;16;351;Jury;1223;19;1242;57351
44;57;09;05;352;Jussy;445;15;460;57352
44;57;05;23;353;Juvelize;72;1;73;57353
44;57;05;23;354;Juville;122;5;127;57354
44;57;06;22;355;Kalhausen;806;17;823;57355
44;57;07;27;356;Kanfen;1198;22;1220;57356
44;57;06;20;357;Kappelkinger;404;2;406;57357
44;57;07;14;358;Kédange-sur-Canner;1080;22;1102;57358
44;57;07;14;359;Kemplich;170;4;174;57359
44;57;03;25;360;Kerbach;1199;33;1232;57360
44;57;07;04;361;Kerling-lès-Sierck;598;17;615;57361
44;57;05;21;362;Kerprich-aux-Bois;174;3;177;57362
44;57;07;04;364;Kirsch-lès-Sierck;312;7;319;57364
44;57;07;04;365;Kirschnaumen;474;11;485;57365
44;57;06;20;366;Kirviller;139;2;141;57366
44;57;07;14;367;Klang;225;4;229;57367
44;57;07;01;368;Knutange;3192;59;3251;57368
44;57;07;14;370;KÅ“nigsmacker;2256;39;2295;57370
44;57;07;04;371;Haute-Kontz;584;7;591;57371
44;57;07;14;372;Kuntzig;1357;15;1372;57372
44;57;03;19;373;Lachambre;932;27;959;57373
44;57;05;17;374;Lafrimbolle;198;6;204;57374
44;57;05;23;375;Lagarde;186;1;187;57375
44;57;06;02;376;Lambach;504;6;510;57376
44;57;05;17;377;Landange;243;4;247;57377
44;57;03;20;379;Landroff;273;2;275;57379
44;57;05;17;380;Laneuveville-lès-Lorquin;106;3;109;57380
44;57;05;23;381;Laneuveville-en-Saulnois;292;6;298;57381
44;57;05;21;382;Langatte;557;6;563;57382
44;57;05;21;383;Languimberg;164;6;170;57383
44;57;03;20;384;Laning;620;18;638;57384
44;57;09;16;385;Laquenexy;1220;22;1242;57385
44;57;03;07;386;Laudrefang;345;7;352;57386
44;57;07;04;387;Laumesfeld;290;1;291;57387
44;57;07;04;388;Launstroff;267;4;271;57388
44;57;03;20;389;Lelling;471;12;483;57389
44;57;06;02;390;Lemberg;1432;38;1470;57390
44;57;05;23;391;Lemoncourt;65;1;66;57391
44;57;09;07;392;Lemud;527;4;531;57392
44;57;06;02;393;Lengelsheim;206;3;209;57393
44;57;05;23;394;Léning;340;12;352;57394
44;57;05;23;395;Lesse;204;4;208;57395
44;57;09;05;396;Lessy;736;28;764;57396
44;57;05;23;397;Ley;102;1;103;57397
44;57;03;20;398;Leyviller;502;8;510;57398
44;57;05;23;399;Lezey;94;8;102;57399
44;57;05;23;401;Lidrezing;85;1;86;57401
44;57;06;02;402;Liederschiedt;120;4;124;57402
44;57;09;07;403;Liéhon;123;0;123;57403
44;57;05;23;404;Lindre-Basse;209;7;216;57404
44;57;05;23;405;Lindre-Haute;53;1;54;57405
44;57;05;23;406;Liocourt;138;7;145;57406
44;57;05;17;407;Lixheim;591;6;597;57407
44;57;06;22;408;Lixing-lès-Rouhling;877;19;896;57408
44;57;03;20;409;Lixing-lès-Saint-Avold;673;15;688;57409
44;57;05;23;410;Lhor;137;3;140;57410
44;57;07;01;411;Lommerange;334;1;335;57411
44;57;09;15;412;Longeville-lès-Metz;3955;64;4019;57412
44;57;03;07;413;Longeville-lès-Saint-Avold;3651;84;3735;57413
44;57;05;17;414;Lorquin;1147;26;1173;57414
44;57;09;05;415;Lorry-lès-Metz;1748;76;1824;57415
44;57;09;05;416;Lorry-Mardigny;657;17;674;57416
44;57;05;23;417;Lostroff;68;0;68;57417
44;57;05;23;418;Loudrefing;322;4;326;57418
44;57;06;20;419;Loupershouse;904;23;927;57419
44;57;06;02;421;Loutzviller;153;3;156;57421
44;57;09;07;422;Louvigny;880;11;891;57422
44;57;05;23;423;Lubécourt;75;0;75;57423
44;57;05;23;424;Lucy;233;2;235;57424
44;57;09;07;425;Luppy;573;4;577;57425
44;57;07;14;426;Luttange;896;8;904;57426
44;57;05;17;427;Lutzelbourg;568;10;578;57427
44;57;03;19;428;Macheren;2753;67;2820;57428
44;57;03;07;430;Mainvillers;330;5;335;57430
44;57;09;16;431;Maizeroy;401;3;404;57431
44;57;09;24;433;Maizières-lès-Metz;11668;127;11795;57433
44;57;05;23;434;Maizières-lès-Vic;488;9;497;57434
44;57;05;23;436;Malaucourt-sur-Seille;127;6;133;57436
44;57;07;04;437;Malling;631;15;646;57437
44;57;09;16;438;Malroy;348;5;353;57438
44;57;07;04;439;Manderen-Ritzing;602;13;615;57439
44;57;05;23;440;Manhoué;142;3;145;57440
44;57;07;27;441;Manom;2915;59;2974;57441
44;57;03;07;442;Many;242;2;244;57442
44;57;09;18;443;Marange-Silvange;6458;57;6515;57443
44;57;03;07;444;Marange-Zondrange;351;2;353;57444
44;57;09;05;445;Marieulles;701;9;710;57445
44;57;05;23;446;Marimont-lès-Bénestroff;41;1;42;57446
44;57;09;15;447;Marly;10108;231;10339;57447
44;57;05;23;448;Marsal;257;6;263;57448
44;57;09;16;449;Marsilly;598;6;604;57449
44;57;05;23;451;Marthille;168;3;171;57451
44;57;09;24;452;La Maxe;1011;16;1027;57452
44;57;03;20;453;Maxstadt;298;10;308;57453
44;57;09;16;454;Mécleuves;1139;24;1163;57454
44;57;03;03;455;Mégange;149;3;152;57455
44;57;06;02;456;Meisenthal;674;24;698;57456
44;57;03;04;457;Menskirch;139;2;141;57457
44;57;07;04;459;Merschweiller;286;2;288;57459
44;57;03;04;460;Merten;1481;26;1507;57460
44;57;05;17;461;Métairies-Saint-Quirin;273;8;281;57461
44;57;05;17;462;Metting;419;7;426;57462
44;57;09;98;463;Metz;118489;1846;120335;57463
44;57;07;14;464;Metzeresche;968;28;996;57464
44;57;07;14;465;Metzervisse;2264;53;2317;57465
44;57;03;25;466;Metzing;659;10;669;57466
44;57;09;16;467;Mey;294;2;296;57467
44;57;05;17;468;Mittelbronn;689;10;699;57468
44;57;05;21;469;Mittersheim;603;5;608;57469
44;57;05;23;470;Molring;5;0;5;57470
44;57;03;03;471;Momerstroff;297;3;300;57471
44;57;09;23;472;Moncheux;148;0;148;57472
44;57;05;23;473;Moncourt;67;2;69;57473
44;57;07;06;474;Mondelange;5631;77;5708;57474
44;57;07;27;475;Mondorff;525;14;539;57475
44;57;07;14;476;Monneren;410;6;416;57476
44;57;06;02;477;Montbronn;1621;43;1664;57477
44;57;05;23;478;Montdidier;87;0;87;57478
44;57;07;04;479;Montenach;465;12;477;57479
44;57;09;15;480;Montigny-lès-Metz;21879;357;22236;57480
44;57;09;18;481;Montois-la-Montagne;2732;18;2750;57481
44;57;09;16;482;Ogy-Montoy-Flanville;1759;31;1790;57482
44;57;03;20;483;Morhange;3408;84;3492;57483
44;57;03;08;484;Morsbach;2684;29;2713;57484
44;57;05;23;485;Morville-lès-Vic;124;2;126;57485
44;57;05;23;486;Morville-sur-Nied;117;1;118;57486
44;57;09;05;487;Moulins-lès-Metz;5007;61;5068;57487
44;57;05;21;488;Moussey;562;9;571;57488
44;57;06;02;489;Mouterhouse;302;6;308;57489
44;57;05;23;490;Moyenvic;345;4;349;57490
44;57;07;10;491;Moyeuvre-Grande;7506;65;7571;57491
44;57;07;10;492;Moyeuvre-Petite;451;8;459;57492
44;57;05;23;493;Mulcey;211;5;216;57493
44;57;05;23;494;Munster;239;0;239;57494
44;57;03;03;495;Narbéfontaine;116;1;117;57495
44;57;05;23;496;Nébing;335;5;340;57496
44;57;06;20;497;Nelling;263;9;272;57497
44;57;07;01;498;Neufchef;2590;52;2642;57498
44;57;06;22;499;Neufgrange;1357;30;1387;57499
44;57;05;17;500;Neufmoulins;43;0;43;57500
44;57;05;23;501;Neufvillage;36;0;36;57501
44;57;03;04;502;Neunkirchen-lès-Bouzonville;330;12;342;57502
44;57;05;17;504;Niderhoff;280;4;284;57504
44;57;05;17;505;Niderviller;1211;22;1233;57505
44;57;05;21;506;Niederstinzel;252;1;253;57506
44;57;03;03;507;Niedervisse;266;2;268;57507
44;57;07;01;508;Nilvange;4515;53;4568;57508
44;57;05;17;509;Nitting;479;10;489;57509
44;57;09;16;510;Noisseville;1072;10;1082;57510
44;57;09;18;511;Norroy-le-Veneur;1033;21;1054;57511
44;57;09;16;512;Nouilly;716;11;727;57512
44;57;06;02;513;Nousseviller-lès-Bitche;150;1;151;57513
44;57;03;25;514;Nousseviller-Saint-Nabor;1194;25;1219;57514
44;57;09;05;515;Novéant-sur-Moselle;1823;24;1847;57515
44;57;03;04;516;Oberdorff;337;10;347;57516
44;57;06;02;517;Obergailbach;283;4;287;57517
44;57;05;21;518;Oberstinzel;331;9;340;57518
44;57;03;03;519;Obervisse;160;3;163;57519
44;57;05;23;520;Obreck;33;2;35;57520
44;57;03;08;521;Å’ting;2706;53;2759;57521
44;57;05;23;524;Ommeray;128;1;129;57524
44;57;05;23;525;Oriocourt;55;1;56;57525
44;57;06;02;526;Ormersviller;383;1;384;57526
44;57;09;07;527;Orny;356;4;360;57527
44;57;05;23;528;Oron;101;1;102;57528
44;57;07;01;529;Ottange;3099;65;3164;57529
44;57;03;03;530;Ottonville;442;6;448;57530
44;57;07;14;531;Oudrenne;743;13;756;57531
44;57;09;07;532;Pagny-lès-Goin;229;3;232;57532
44;57;09;16;533;Pange;874;18;892;57533
44;57;09;16;534;Peltre;1842;124;1966;57534
44;57;06;02;535;Petit-Réderching;1443;36;1479;57535
44;57;03;20;536;Petit-Tenquin;221;5;226;57536
44;57;03;08;537;Petite-Rosselle;6298;98;6396;57537
44;57;05;23;538;Pettoncourt;295;2;297;57538
44;57;05;23;539;Pévange;46;3;49;57539
44;57;05;17;540;Phalsbourg;4729;240;4969;57540
44;57;06;02;541;Philippsbourg;593;17;610;57541
44;57;03;03;542;Piblange;974;11;985;57542
44;57;09;18;543;Pierrevillers;1498;24;1522;57543
44;57;05;17;544;Plaine-de-Walsch;615;16;631;57544
44;57;09;15;545;Plappeville;2021;57;2078;57545
44;57;09;18;546;Plesnois;811;31;842;57546
44;57;09;07;547;Pommérieux;699;9;708;57547
44;57;09;07;548;Pontoy;543;7;550;57548
44;57;03;07;549;Pontpierre;733;14;747;57549
44;57;03;19;550;Porcelette;2478;65;2543;57550
44;57;05;21;551;Postroff;213;1;214;57551
44;57;09;05;552;Pouilly;627;8;635;57552
44;57;09;05;553;Pournoy-la-Chétive;630;4;634;57553
44;57;09;07;554;Pournoy-la-Grasse;694;21;715;57554
44;57;05;23;555;Prévocourt;111;0;111;57555
44;57;06;20;556;Puttelange-aux-Lacs;3089;45;3134;57556
44;57;07;27;557;Puttelange-lès-Thionville;1009;24;1033;57557
44;57;05;23;558;Puttigny;80;0;80;57558
44;57;05;23;559;Puzieux;176;0;176;57559
44;57;03;20;560;Racrange;624;13;637;57560
44;57;06;02;561;Rahling;737;19;756;57561
44;57;07;10;562;Ranguevaux;847;18;865;57562
44;57;09;16;563;Raville;256;2;258;57563
44;57;05;21;564;Réchicourt-le-Château;557;15;572;57564
44;57;07;01;565;Rédange;995;20;1015;57565
44;57;05;21;566;Réding;2358;64;2422;57566
44;57;03;04;567;Rémelfang;147;1;148;57567
44;57;06;22;568;Rémelfing;1397;28;1425;57568
44;57;07;04;569;Rémeling;320;6;326;57569
44;57;03;04;570;Rémering;423;5;428;57570
44;57;06;20;571;Rémering-lès-Puttelange;1049;31;1080;57571
44;57;09;07;572;Rémilly;2006;101;2107;57572
44;57;05;23;573;Réning;135;3;138;57573
44;57;07;27;574;Basse-Rentgen;512;13;525;57574
44;57;09;16;575;Retonfey;1357;29;1386;57575
44;57;07;04;576;Rettel;770;65;835;57576
44;57;06;02;577;Reyersviller;375;7;382;57577
44;57;09;05;578;Rezonville-Vionville;496;6;502;57578
44;57;05;21;579;Rhodes;128;1;129;57579
44;57;05;23;580;Riche;187;2;189;57580
44;57;06;20;581;Richeling;351;7;358;57581
44;57;07;06;582;Richemont;2092;42;2134;57582
44;57;05;21;583;Richeval;136;2;138;57583
44;57;06;02;584;Rimling;652;17;669;57584
44;57;07;01;586;Rochonvillers;186;2;188;57586
44;57;05;23;587;Rodalbe;250;5;255;57587
44;57;07;27;588;Rodemack;1265;32;1297;57588
44;57;06;02;589;Rohrbach-lès-Bitche;2313;49;2362;57589
44;57;06;02;590;Rolbing;256;6;262;57590
44;57;09;18;591;Rombas;9861;99;9960;57591
44;57;05;21;592;Romelfing;348;2;350;57592
44;57;09;18;593;Roncourt;1018;10;1028;57593
44;57;06;02;594;Roppeviller;98;3;101;57594
44;57;05;23;595;Rorbach-lès-Dieuze;50;1;51;57595
44;57;03;08;596;Rosbruck;747;11;758;57596
44;57;07;10;597;Rosselange;2650;20;2670;57597
44;57;06;22;598;Rouhling;2005;52;2057;57598
44;57;03;03;599;Roupeldange;362;9;371;57599
44;57;07;27;600;Roussy-le-Village;1408;24;1432;57600
44;57;09;05;601;Rozérieulles;1343;42;1385;57601
44;57;07;14;602;Rurange-lès-Thionville;2431;54;2485;57602
44;57;07;01;603;Russange;1273;17;1290;57603
44;57;07;04;604;Rustroff;624;6;630;57604
44;57;09;23;605;Sailly-Achâtel;299;2;301;57605
44;57;03;19;606;Saint-Avold;15415;352;15767;57606
44;57;09;16;607;Sainte-Barbe;761;10;771;57607
44;57;05;23;609;Saint-Epvre;174;2;176;57609
44;57;03;04;610;Saint-François-Lacroix;303;6;309;57610
44;57;05;21;611;Saint-Georges;191;6;197;57611
44;57;09;16;612;Saint-Hubert;240;5;245;57612
44;57;05;21;613;Saint-Jean-de-Bassel;357;3;360;57613
44;57;05;17;614;Saint-Jean-Kourtzerode;709;4;713;57614
44;57;06;20;615;Saint-Jean-Rohrbach;968;19;987;57615
44;57;09;16;616;Saint-Julien-lès-Metz;3373;84;3457;57616
44;57;09;23;617;Saint-Jure;284;6;290;57617
44;57;05;17;618;Saint-Louis;653;20;673;57618
44;57;06;02;619;Saint-Louis-lès-Bitche;472;10;482;57619
44;57;09;18;620;Sainte-Marie-aux-Chênes;4350;61;4411;57620
44;57;05;23;621;Saint-Médard;109;1;110;57621
44;57;09;18;622;Saint-Privat-la-Montagne;1909;21;1930;57622
44;57;05;17;623;Saint-Quirin;711;50;761;57623
44;57;09;05;624;Sainte-Ruffine;584;31;615;57624
44;57;05;23;625;Salonnes;178;2;180;57625
44;57;09;16;626;Sanry-lès-Vigy;531;8;539;57626
44;57;09;16;627;Sanry-sur-Nied;324;4;328;57627
44;57;06;20;628;Sarralbe;4485;94;4579;57628
44;57;05;21;629;Sarraltroff;777;6;783;57629
44;57;05;21;630;Sarrebourg;12449;312;12761;57630
44;57;06;22;631;Sarreguemines;20635;470;21105;57631
44;57;06;22;633;Sarreinsming;1262;31;1293;57633
44;57;09;18;634;Saulny;1507;39;1546;57634
44;57;05;21;635;Schalbach;364;7;371;57635
44;57;06;02;636;Schmittviller;316;12;328;57636
44;57;05;17;637;Schneckenbusch;304;9;313;57637
44;57;03;08;638;SchÅ“neck;2491;40;2531;57638
44;57;06;02;639;Schorbach;540;9;549;57639
44;57;03;04;640;Schwerdorff;479;14;493;57640
44;57;06;02;641;Schweyen;303;4;307;57641
44;57;09;15;642;Scy-Chazelles;2675;53;2728;57642
44;57;09;23;643;Secourt;199;6;205;57643
44;57;03;09;644;Seingbouse;1753;42;1795;57644
44;57;09;24;645;Semécourt;1021;9;1030;57645
44;57;07;10;647;Serémange-Erzange;4163;57;4220;57647
44;57;09;16;648;Servigny-lès-Raville;493;5;498;57648
44;57;09;16;649;Servigny-lès-Sainte-Barbe;475;4;479;57649
44;57;07;04;650;Sierck-les-Bains;1776;13;1789;57650
44;57;06;02;651;Siersthal;648;6;654;57651
44;57;09;07;652;Sillegny;552;6;558;57652
44;57;09;07;653;Silly-en-Saulnois;33;2;35;57653
44;57;09;16;654;Silly-sur-Nied;693;11;704;57654
44;57;09;07;655;Solgne;1119;57;1176;57655
44;57;09;16;656;Sorbey;382;7;389;57656
44;57;05;23;657;Sotzeling;19;0;19;57657
44;57;06;02;658;Soucht;1053;20;1073;57658
44;57;03;25;659;Spicheren;3232;56;3288;57659
44;57;03;25;660;Stiring-Wendel;11178;126;11304;57660
44;57;06;02;661;Sturzelbronn;174;3;177;57661
44;57;03;20;662;Suisse;100;5;105;57662
44;57;09;24;663;Talange;7781;187;7968;57663
44;57;05;23;664;Tarquimpol;61;2;63;57664
44;57;03;25;665;Tenteling;1060;19;1079;57665
44;57;07;26;666;Terville;7134;90;7224;57666
44;57;03;03;667;Téterchen;790;8;798;57667
44;57;03;07;668;Teting-sur-Nied;1280;35;1315;57668
44;57;03;25;669;Théding;2473;44;2517;57669
44;57;03;07;670;Thicourt;135;1;136;57670
44;57;09;07;671;Thimonville;154;0;154;57671
44;57;07;99;672;Thionville;40778;756;41534;57672
44;57;03;07;673;Thonville;47;0;47;57673
44;57;05;23;674;Tincry;174;5;179;57674
44;57;05;23;675;Torcheville;115;1;116;57675
44;57;09;07;676;Tragny;93;1;94;57676
44;57;09;16;677;Trémery;1047;18;1065;57677
44;57;07;01;678;Tressange;2220;35;2255;57678
44;57;03;07;679;Tritteling-Redlach;533;4;537;57679
44;57;05;17;680;Troisfontaines;1256;28;1284;57680
44;57;03;04;681;Tromborn;338;5;343;57681
44;57;05;17;682;Turquestein-Blancrupt;11;0;11;57682
44;57;07;06;683;Uckange;6926;47;6973;57683
44;57;03;20;684;Vahl-Ebersing;513;10;523;57684
44;57;05;23;685;Vahl-lès-Bénestroff;151;2;153;57685
44;57;03;07;686;Vahl-lès-Faulquemont;250;2;252;57686
44;57;03;20;687;Vallerange;213;4;217;57687
44;57;07;14;689;Valmestroff;314;5;319;57689
44;57;03;19;690;Valmont;3019;66;3085;57690
44;57;03;03;691;Valmunster;86;4;90;57691
44;57;05;23;692;Vannecourt;74;0;74;57692
44;57;09;16;693;Vantoux;823;19;842;57693
44;57;09;16;694;Vany;438;11;449;57694
44;57;03;03;695;Varize-Vaudoncourt;521;9;530;57695
44;57;03;03;696;Varsberg;961;26;987;57696
44;57;05;17;697;Vasperviller;315;9;324;57697
44;57;03;07;698;Vatimont;317;6;323;57698
44;57;03;04;700;Vaudreching;504;8;512;57700
44;57;09;05;701;Vaux;810;26;836;57701
44;57;05;23;702;Vaxy;168;0;168;57702
44;57;05;21;703;Veckersviller;233;17;250;57703
44;57;07;14;704;Veckring;650;15;665;57704
44;57;03;03;705;Velving;207;5;212;57705
44;57;05;23;706;Vergaville;549;14;563;57706
44;57;09;05;707;Vernéville;652;6;658;57707
44;57;09;07;708;Verny;1953;43;1996;57708
44;57;05;17;709;Vescheim;310;7;317;57709
44;57;05;23;711;Vibersviller;418;7;425;57711
44;57;05;23;712;Vic-sur-Seille;1283;105;1388;57712
44;57;05;21;713;Vieux-Lixheim;248;8;256;57713
44;57;03;07;714;Haute-Vigneulles;431;9;440;57714
44;57;09;23;715;Vigny;377;11;388;57715
44;57;09;16;716;Vigy;1741;34;1775;57716
44;57;03;20;717;Viller;186;3;189;57717
44;57;09;07;718;Villers-Stoncourt;218;1;219;57718
44;57;05;23;719;Villers-sur-Nied;79;3;82;57719
44;57;03;04;720;Villing;495;12;507;57720
44;57;05;17;721;Vilsberg;346;9;355;57721
44;57;05;23;723;Virming;293;6;299;57723
44;57;07;10;724;Vitry-sur-Orne;3021;35;3056;57724
44;57;05;23;725;Vittersbourg;348;7;355;57725
44;57;03;07;726;Vittoncourt;382;4;386;57726
44;57;05;23;727;Viviers;122;1;123;57727
44;57;03;07;728;Voimhaut;253;3;256;57728
44;57;03;03;730;Volmerange-lès-Boulay;566;12;578;57730
44;57;07;27;731;Volmerange-les-Mines;2269;40;2309;57731
44;57;06;02;732;Volmunster;777;21;798;57732
44;57;07;14;733;Volstroff;2034;29;2063;57733
44;57;05;17;734;Voyer;458;11;469;57734
44;57;09;16;736;Vry;614;8;622;57736
44;57;09;23;737;Vulmont;31;2;33;57737
44;57;06;02;738;Waldhouse;405;6;411;57738
44;57;07;04;739;Waldweistroff;504;2;506;57739
44;57;07;04;740;Waldwisse;807;12;819;57740
44;57;06;02;741;Walschbronn;438;13;451;57741
44;57;05;17;742;Walscheid;1499;41;1540;57742
44;57;05;17;743;Waltembourg;243;7;250;57743
44;57;06;22;745;Wiesviller;931;21;952;57745
44;57;06;22;746;Willerwald;1548;36;1584;57746
44;57;05;17;747;Wintersbourg;269;7;276;57747
44;57;06;22;748;Wittring;765;17;782;57748
44;57;03;04;749;VÅ“lfling-lès-Bouzonville;156;6;162;57749
44;57;06;22;750;WÅ“lfling-lès-Sarreguemines;718;26;744;57750
44;57;09;24;751;Woippy;14014;137;14151;57751
44;57;06;20;752;Woustviller;2986;51;3037;57752
44;57;05;23;753;Wuisse;60;1;61;57753
44;57;05;23;754;Xanrey;111;1;112;57754
44;57;05;23;755;Xocourt;98;1;99;57755
44;57;05;17;756;Xouaxange;310;3;313;57756
44;57;07;27;757;Yutz;17143;265;17408;57757
44;57;05;23;759;Zarbeling;63;1;64;57759
44;57;06;22;760;Zetting;844;20;864;57760
44;57;05;17;761;Zilling;267;4;271;57761
44;57;03;07;762;Zimming;707;6;713;57762
44;57;05;23;763;Zommange;46;2;48;57763
44;57;07;27;764;Zoufftgen;1245;14;1259;57764
44;57;03;19;765;Diesen;1057;16;1073;57765
44;57;07;14;767;Stuckange;1308;34;1342;57767
27;58;01;02;001;Achun;160;0;160;58001
27;58;04;05;002;Alligny-Cosne;905;13;918;58002
27;58;01;02;003;Alligny-en-Morvan;607;7;614;58003
27;58;01;02;004;Alluy;377;9;386;58004
27;58;02;03;005;Amazy;224;1;225;58005
27;58;03;08;006;Anlezy;244;3;247;58006
27;58;04;15;007;Annay;340;5;345;58007
27;58;02;04;008;Anthien;169;5;174;58008
27;58;04;01;009;Arbourse;128;1;129;58009
27;58;01;02;010;Arleuf;683;12;695;58010
27;58;02;03;011;Armes;283;5;288;58011
27;58;04;15;012;Arquian;574;11;585;58012
27;58;04;01;013;Arthel;97;1;98;58013
27;58;04;01;014;Arzembouy;67;1;68;58014
27;58;02;04;015;Asnan;120;3;123;58015
27;58;02;03;016;Asnois;141;3;144;58016
27;58;01;02;017;Aunay-en-Bazois;226;7;233;58017
27;58;02;04;018;Authiou;47;0;47;58018
27;58;01;10;019;Avrée;83;3;86;58019
27;58;03;16;020;Avril-sur-Loire;253;4;257;58020
27;58;03;16;021;Azy-le-Vif;204;5;209;58021
27;58;01;04;023;Bazoches;175;3;178;58023
27;58;03;08;024;Bazolles;280;11;291;58024
27;58;03;09;025;Béard;162;7;169;58025
27;58;02;04;026;Beaulieu;141;9;150;58026
27;58;04;01;027;Beaumont-la-Ferrière;121;3;124;58027
27;58;03;08;028;Beaumont-Sardolles;117;3;120;58028
27;58;02;04;029;Beuvron;81;0;81;58029
27;58;01;02;030;Biches;284;11;295;58030
27;58;03;08;031;Billy-Chevannes;299;3;302;58031
27;58;02;03;032;Billy-sur-Oisy;361;6;367;58032
27;58;04;15;033;Bitry;296;8;304;58033
27;58;01;02;034;Blismes;183;6;189;58034
27;58;03;08;035;Bona;302;2;304;58035
27;58;04;15;036;Bouhy;464;9;473;58036
27;58;01;04;037;Brassy;592;36;628;58037
27;58;02;03;038;Breugnon;160;5;165;58038
27;58;02;03;039;Brèves;236;3;239;58039
27;58;01;02;040;Brinay;144;3;147;58040
27;58;02;04;041;Brinon-sur-Beuvron;171;5;176;58041
27;58;04;15;042;Bulcy;136;2;138;58042
27;58;02;04;043;Bussy-la-Pesle;54;0;54;58043
27;58;04;05;044;La Celle-sur-Loire;813;10;823;58044
27;58;04;01;045;La Celle-sur-Nièvre;158;1;159;58045
27;58;01;10;046;Cercy-la-Tour;1713;25;1738;58046
27;58;02;04;047;Cervon;661;16;677;58047
27;58;04;15;048;Cessy-les-Bois;107;5;112;58048
27;58;01;04;049;Chalaux;83;2;85;58049
27;58;02;04;050;Challement;45;2;47;58050
27;58;03;13;051;Challuy;1526;133;1659;58051
27;58;02;04;052;Champallement;45;2;47;58052
27;58;04;01;053;Champlemy;325;7;332;58053
27;58;02;01;054;Champlin;39;1;40;58054
27;58;03;06;055;Champvert;761;15;776;58055
27;58;04;01;056;Champvoux;297;7;304;58056
27;58;03;16;057;Chantenay-Saint-Imbert;1152;19;1171;58057
27;58;02;03;058;La Chapelle-Saint-André;300;5;305;58058
27;58;04;01;059;La Charité-sur-Loire;4742;57;4799;58059
27;58;01;10;060;Charrin;619;9;628;58060
27;58;04;01;061;Chasnay;122;1;123;58061
27;58;01;02;062;Château-Chinon (Ville);1932;384;2316;58062
27;58;01;02;063;Château-Chinon (Campagne);546;10;556;58063
27;58;04;15;064;Châteauneuf-Val-de-Bargis;499;15;514;58064
27;58;01;02;065;Châtillon-en-Bazois;905;16;921;58065
27;58;01;02;066;Châtin;84;0;84;58066
27;58;04;01;067;Chaulgnes;1503;23;1526;58067
27;58;01;02;068;Chaumard;209;5;214;58068
27;58;02;04;069;Chaumot;160;4;164;58069
27;58;02;04;070;Chazeuil;57;2;59;58070
27;58;02;04;071;Chevannes-Changy;138;7;145;58071
27;58;03;16;072;Chevenon;618;10;628;58072
27;58;02;03;073;Chevroches;122;6;128;58073
27;58;01;10;074;Chiddes;339;5;344;58074
27;58;02;04;075;Chitry-les-Mines;215;4;219;58075
27;58;01;02;076;Chougny;79;0;79;58076
27;58;04;15;077;Ciez;374;6;380;58077
27;58;03;08;078;Cizely;54;0;54;58078
27;58;02;03;079;Clamecy;3590;183;3773;58079
27;58;02;04;080;La Collancelle;169;1;170;58080
27;58;04;15;081;Colméry;276;4;280;58081
27;58;01;02;082;Corancy;285;4;289;58082
27;58;02;04;083;Corbigny;1440;109;1549;58083
27;58;02;04;084;Corvol-d'Embernard;85;4;89;58084
27;58;02;03;085;Corvol-l'Orgueilleux;753;13;766;58085
27;58;04;05;086;Cosne-Cours-sur-Loire;9589;238;9827;58086
27;58;03;06;087;Cossaye;706;8;714;58087
27;58;03;11;088;Coulanges-lès-Nevers;3724;87;3811;58088
27;58;04;15;089;Couloutre;189;7;196;58089
27;58;02;03;090;Courcelles;219;1;220;58090
27;58;03;08;092;Crux-la-Ville;395;9;404;58092
27;58;02;03;093;Cuncy-lès-Varzy;127;2;129;58093
27;58;04;15;094;Dampierre-sous-Bouhy;448;4;452;58094
27;58;03;06;095;Decize;5233;175;5408;58095
27;58;03;06;096;Devay;495;9;504;58096
27;58;03;08;097;Diennes-Aubigny;92;1;93;58097
27;58;02;03;098;Dirol;112;4;116;58098
27;58;01;02;099;Dommartin;164;3;167;58099
27;58;04;01;101;Dompierre-sur-Nièvre;190;2;192;58101
27;58;04;15;102;Donzy;1575;27;1602;58102
27;58;02;03;103;Dornecy;470;8;478;58103
27;58;03;16;104;Dornes;1466;24;1490;58104
27;58;03;09;105;Druy-Parigny;308;6;314;58105
27;58;01;04;106;Dun-les-Places;353;4;357;58106
27;58;01;02;107;Dun-sur-Grandry;144;2;146;58107
27;58;01;04;108;Empury;85;1;86;58108
27;58;02;03;109;Entrains-sur-Nohain;748;14;762;58109
27;58;02;04;110;Epiry;245;2;247;58110
27;58;01;02;111;Fâchin;106;0;106;58111
27;58;03;08;112;La Fermeté;632;7;639;58112
27;58;03;08;113;Fertrève;98;3;101;58113
27;58;01;10;114;Fléty;93;4;97;58114
27;58;03;16;115;Fleury-sur-Loire;227;6;233;58115
27;58;02;03;116;Flez-Cuzy;131;5;136;58116
27;58;03;07;117;Fourchambault;4125;53;4178;58117
27;58;01;10;118;Fours;642;7;649;58118
27;58;03;08;119;Frasnay-Reugny;82;3;85;58119
27;58;02;04;120;Gâcogne;224;0;224;58120
27;58;03;07;121;Garchizy;3740;46;3786;58121
27;58;04;15;122;Garchy;425;8;433;58122
27;58;02;04;123;Germenay;129;9;138;58123
27;58;03;07;124;Germigny-sur-Loire;769;9;778;58124
27;58;01;02;125;Gien-sur-Cure;95;2;97;58125
27;58;03;13;126;Gimouille;450;7;457;58126
27;58;04;01;127;Giry;188;3;191;58127
27;58;01;02;128;Glux-en-Glenne;91;0;91;58128
27;58;01;02;129;Gouloux;176;5;181;58129
27;58;02;04;130;Grenois;95;2;97;58130
27;58;03;08;131;Guérigny;2510;40;2550;58131
27;58;02;04;132;Guipy;227;11;238;58132
27;58;02;04;133;Héry;73;2;75;58133
27;58;03;09;134;Imphy;3202;38;3240;58134
27;58;01;10;135;Isenay;102;0;102;58135
27;58;03;08;136;Jailly;68;2;70;58136
27;58;03;06;137;Lamenay-sur-Loire;68;0;68;58137
27;58;03;16;138;Langeron;357;10;367;58138
27;58;01;10;139;Lanty;116;0;116;58139
27;58;01;10;140;Larochemillay;231;5;236;58140
27;58;01;02;141;Lavault-de-Frétoy;71;0;71;58141
27;58;01;02;142;Limanton;239;4;243;58142
27;58;03;08;143;Limon;144;5;149;58143
27;58;03;16;144;Livry;698;6;704;58144
27;58;01;04;145;Lormes;1273;29;1302;58145
27;58;03;06;146;Lucenay-lès-Aix;978;19;997;58146
27;58;04;01;147;Lurcy-le-Bourg;278;5;283;58147
27;58;03;16;148;Luthenay-Uxeloup;615;11;626;58148
27;58;01;10;149;Luzy;1988;38;2026;58149
27;58;02;03;150;Lys;110;6;116;58150
27;58;03;09;151;La Machine;3240;53;3293;58151
27;58;03;12;152;Magny-Cours;1395;27;1422;58152
27;58;02;04;153;Magny-Lormes;71;2;73;58153
27;58;02;03;154;La Maison-Dieu;117;1;118;58154
27;58;04;01;155;La Marche;561;17;578;58155
27;58;02;03;156;Marcy;145;2;147;58156
27;58;01;04;157;Marigny-l'Eglise;282;16;298;58157
27;58;03;16;158;Mars-sur-Allier;306;6;312;58158
27;58;02;04;159;Marigny-sur-Yonne;197;3;200;58159
27;58;03;07;160;Marzy;3724;201;3925;58160
27;58;01;10;161;Maux;144;0;144;58161
27;58;04;15;162;Menestreau;110;1;111;58162
27;58;02;03;163;Menou;185;3;188;58163
27;58;04;15;164;Mesves-sur-Loire;667;28;695;58164
27;58;02;03;165;Metz-le-Comte;160;7;167;58165
27;58;02;04;166;Mhère;231;2;233;58166
27;58;01;10;168;Millay;441;5;446;58168
27;58;02;03;169;Moissy-Moulinot;15;3;18;58169
27;58;02;03;170;Monceaux-le-Comte;122;2;124;58170
27;58;01;02;171;Montapas;289;2;291;58171
27;58;01;10;172;Montambert;122;2;124;58172
27;58;01;10;173;Montaron;158;0;158;58173
27;58;04;01;174;Montenoison;120;2;122;58174
27;58;01;02;175;Mont-et-Marré;157;1;158;58175
27;58;03;08;176;Montigny-aux-Amognes;634;23;657;58176
27;58;01;02;177;Montigny-en-Morvan;281;1;282;58177
27;58;01;10;178;Montigny-sur-Canne;153;2;155;58178
27;58;02;02;179;Montreuillon;259;7;266;58179
27;58;01;02;180;Montsauche-les-Settons;513;3;516;58180
27;58;02;04;181;Moraches;145;5;150;58181
27;58;01;10;182;Moulins-Engilbert;1445;24;1469;58182
27;58;02;04;183;Mouron-sur-Yonne;97;1;98;58183
27;58;04;01;184;Moussy;103;1;104;58184
27;58;01;02;185;Moux-en-Morvan;529;4;533;58185
27;58;04;01;186;Murlin;69;1;70;58186
27;58;04;05;187;Myennes;518;6;524;58187
27;58;04;01;188;Nannay;114;3;117;58188
27;58;04;01;189;Narcy;478;4;482;58189
27;58;02;03;190;Neuffontaines;105;2;107;58190
27;58;02;04;191;Neuilly;113;3;116;58191
27;58;03;16;192;Neuville-lès-Decize;218;9;227;58192
27;58;04;15;193;Neuvy-sur-Loire;1410;31;1441;58193
27;58;03;99;194;Nevers;33005;1064;34069;58194
27;58;01;10;195;La Nocle-Maulaix;279;1;280;58195
27;58;03;08;196;Nolay;347;3;350;58196
27;58;02;03;197;Nuars;159;1;160;58197
27;58;02;03;198;Oisy;301;5;306;58198
27;58;01;02;199;Onlay;154;4;158;58199
27;58;02;03;200;Ouagne;149;1;150;58200
27;58;02;03;201;Oudan;143;3;146;58201
27;58;01;02;202;Ougny;24;0;24;58202
27;58;04;01;203;Oulon;63;1;64;58203
27;58;03;08;204;Vaux d'Amognes;540;8;548;58204
27;58;01;02;205;Ouroux-en-Morvan;600;7;607;58205
27;58;02;03;206;Parigny-la-Rose;36;0;36;58206
27;58;03;17;207;Parigny-les-Vaux;970;32;1002;58207
27;58;02;04;208;Pazy;296;10;306;58208
27;58;04;15;209;Perroy;150;5;155;58209
27;58;01;02;210;Planchez;301;4;305;58210
27;58;01;10;211;Poil;147;3;150;58211
27;58;03;08;212;Poiseux;328;4;332;58212
27;58;04;05;213;Pougny;467;9;476;58213
27;58;03;17;214;Pougues-les-Eaux;2355;51;2406;58214
27;58;04;15;215;Pouilly-sur-Loire;1606;24;1630;58215
27;58;02;04;216;Pouques-Lormes;158;3;161;58216
27;58;02;03;217;Pousseaux;198;3;201;58217
27;58;04;01;218;Prémery;1823;27;1850;58218
27;58;01;10;219;Préporché;208;4;212;58219
27;58;04;01;220;Raveau;654;10;664;58220
27;58;01;10;221;Rémilly;150;2;152;58221
27;58;02;03;222;Rix;159;1;160;58222
27;58;03;08;223;Rouy;630;8;638;58223
27;58;02;03;224;Ruages;89;4;93;58224
27;58;03;13;225;Saincaize-Meauce;369;7;376;58225
27;58;01;02;226;Saint-Agnan;131;2;133;58226
27;58;04;15;227;Saint-Amand-en-Puisaye;1225;25;1250;58227
27;58;04;15;228;Saint-Andelain;580;4;584;58228
27;58;01;04;229;Saint-André-en-Morvan;311;5;316;58229
27;58;02;03;230;Saint-Aubin-des-Chaumes;71;0;71;58230
27;58;04;01;231;Saint-Aubin-les-Forges;392;8;400;58231
27;58;03;08;232;Saint-Benin-d'Azy;1265;20;1285;58232
27;58;03;08;233;Saint-Benin-des-Bois;166;7;173;58233
27;58;04;01;234;Saint-Bonnot;144;1;145;58234
27;58;01;02;235;Saint-Brisson;260;3;263;58235
27;58;04;15;236;Sainte-Colombe-des-Bois;135;2;137;58236
27;58;02;03;237;Saint-Didier;29;2;31;58237
27;58;03;12;238;Saint-Eloi;2221;50;2271;58238
27;58;03;08;239;Saint-Firmin;159;2;161;58239
27;58;03;08;240;Saint-Franchy;77;2;79;58240
27;58;03;06;241;Saint-Germain-Chassenay;316;4;320;58241
27;58;02;03;242;Saint-Germain-des-Bois;125;0;125;58242
27;58;01;10;243;Saint-Gratien-Savigny;116;3;119;58243
27;58;01;02;244;Saint-Hilaire-en-Morvan;217;7;224;58244
27;58;01;10;245;Saint-Hilaire-Fontaine;166;4;170;58245
27;58;01;10;246;Saint-Honoré-les-Bains;714;13;727;58246
27;58;03;08;247;Saint-Jean-aux-Amognes;484;7;491;58247
27;58;04;15;248;Saint-Laurent-l'Abbaye;214;5;219;58248
27;58;01;02;249;Saint-Léger-de-Fougeret;352;2;354;58249
27;58;03;06;250;Saint-Léger-des-Vignes;1863;46;1909;58250
27;58;04;05;251;Saint-Loup;474;7;481;58251
27;58;04;15;252;Saint-Malo-en-Donziois;127;3;130;58252
27;58;03;08;253;Sainte-Marie;78;5;83;58253
27;58;03;08;254;Saint-Martin-d'Heuille;570;13;583;58254
27;58;01;04;255;Saint-Martin-du-Puy;279;5;284;58255
27;58;04;15;256;Saint-Martin-sur-Nohain;376;13;389;58256
27;58;03;08;257;Saint-Maurice;64;0;64;58257
27;58;03;09;258;Saint-Ouen-sur-Loire;561;6;567;58258
27;58;03;16;259;Saint-Parize-en-Viry;144;3;147;58259
27;58;03;16;260;Saint-Parize-le-Châtel;1246;27;1273;58260
27;58;04;05;261;Saint-Père;1059;20;1079;58261
27;58;01;02;262;Saint-Péreuse;212;7;219;58262
27;58;02;03;263;Saint-Pierre-du-Mont;170;2;172;58263
27;58;03;16;264;Saint-Pierre-le-Moûtier;1879;26;1905;58264
27;58;04;15;265;Saint-Quentin-sur-Nohain;94;3;97;58265
27;58;02;04;266;Saint-Révérien;155;0;155;58266
27;58;03;08;267;Saint-Saulge;724;80;804;58267
27;58;01;10;268;Saint-Seine;196;5;201;58268
27;58;03;08;269;Saint-Sulpice;413;10;423;58269
27;58;04;15;270;Saint-Vérain;351;6;357;58270
27;58;02;03;271;Saizy;187;3;190;58271
27;58;02;04;272;Sardy-lès-Epiry;108;4;112;58272
27;58;03;09;273;Sauvigny-les-Bois;1434;40;1474;58273
27;58;01;10;274;Savigny-Poil-Fol;115;3;118;58274
27;58;03;08;275;Saxi-Bourdon;297;4;301;58275
27;58;01;10;276;Sémelay;221;3;224;58276
27;58;01;10;277;Sermages;191;7;198;58277
27;58;03;12;278;Sermoise-sur-Loire;1482;68;1550;58278
27;58;04;01;279;Sichamps;180;6;186;58279
27;58;03;09;280;Sougy-sur-Loire;598;16;614;58280
27;58;04;15;281;Suilly-la-Tour;596;14;610;58281
27;58;02;03;282;Surgy;333;11;344;58282
27;58;02;04;283;Taconnay;74;2;76;58283
27;58;02;03;284;Talon;38;2;40;58284
27;58;01;02;285;Tamnay-en-Bazois;160;5;165;58285
27;58;02;03;286;Tannay;575;10;585;58286
27;58;01;10;287;Tazilly;191;4;195;58287
27;58;02;03;288;Teigny;102;2;104;58288
27;58;01;10;289;Ternant;189;0;189;58289
27;58;01;10;290;Thaix;46;1;47;58290
27;58;03;09;291;Thianges;176;0;176;58291
27;58;01;02;292;Tintury;167;0;167;58292
27;58;03;16;293;Toury-Lurcy;416;4;420;58293
27;58;03;16;294;Toury-sur-Jour;119;2;121;58294
27;58;04;15;295;Tracy-sur-Loire;986;15;1001;58295
27;58;03;16;296;Tresnay;137;0;137;58296
27;58;03;09;297;Trois-Vèvres;243;1;244;58297
27;58;04;01;298;Tronsanges;398;9;407;58298
27;58;02;03;299;Trucy-l'Orgueilleux;219;3;222;58299
27;58;03;08;300;Urzy;1746;35;1781;58300
27;58;01;10;301;Vandenesse;298;5;303;58301
27;58;04;01;302;Varennes-lès-Narcy;928;5;933;58302
27;58;03;17;303;Varennes-Vauzelles;9201;177;9378;58303
27;58;02;03;304;Varzy;1103;200;1303;58304
27;58;02;04;305;Vauclaix;135;2;137;58305
27;58;03;06;306;Verneuil;296;9;305;58306
27;58;04;15;307;Vielmanay;179;4;183;58307
27;58;02;03;308;Vignol;62;0;62;58308
27;58;01;10;309;Villapourçon;407;8;415;58309
27;58;02;03;310;Villiers-le-Sec;48;1;49;58310
27;58;03;08;311;Ville-Langy;242;6;248;58311
27;58;02;03;312;Villiers-sur-Yonne;269;9;278;58312
27;58;02;04;313;Vitry-Laché;80;4;84;58313
32;59;02;09;001;Abancourt;469;13;482;59001
32;59;06;14;002;Abscon;4309;34;4343;59002
32;59;01;19;003;Aibes;372;6;378;59003
32;59;03;31;004;Aix-en-Pévèle;1320;14;1334;59004
32;59;05;02;005;Allennes-les-Marais;3456;59;3515;59005
32;59;01;05;006;Amfroipret;216;8;224;59006
32;59;03;31;007;Anhiers;890;9;899;59007
32;59;03;01;008;Aniche;10085;83;10168;59008
32;59;05;40;009;Villeneuve-d'Ascq;61957;656;62613;59009
32;59;02;09;010;Anneux;259;2;261;59010
32;59;05;02;011;AnnÅ“ullin;10471;112;10583;59011
32;59;01;19;012;Anor;3221;45;3266;59012
32;59;05;36;013;Anstaing;1517;16;1533;59013
32;59;06;03;014;Anzin;13329;82;13411;59014
32;59;03;01;015;Arleux;3177;27;3204;59015
32;59;04;12;016;Armbouts-Cappel;2200;47;2247;59016
32;59;05;04;017;Armentières;24909;360;25269;59017
32;59;04;41;018;Arnèke;1570;17;1587;59018
32;59;06;06;019;Artres;1061;12;1073;59019
32;59;01;30;021;Assevent;1815;18;1833;59021
32;59;05;36;022;Attiches;2261;32;2293;59022
32;59;02;09;023;Aubencheul-au-Bac;546;7;553;59023
32;59;03;01;024;Auberchicourt;4551;29;4580;59024
32;59;05;02;025;Aubers;1674;22;1696;59025
32;59;03;01;026;Aubigny-au-Bac;1166;17;1183;59026
32;59;06;06;027;Aubry-du-Hainaut;1705;15;1720;59027
32;59;03;31;028;Auby;7239;34;7273;59028
32;59;03;31;029;Auchy-lez-Orchies;1502;21;1523;59029
32;59;01;05;031;Audignies;372;4;376;59031
32;59;06;06;032;Aulnoy-lez-Valenciennes;7224;71;7295;59032
32;59;01;05;033;Aulnoye-Aymeries;8840;240;9080;59033
32;59;05;36;034;Avelin;2641;44;2685;59034
32;59;01;19;035;Avesnelles;2371;46;2417;59035
32;59;01;07;036;Avesnes-sur-Helpe;4195;138;4333;59036
32;59;02;11;037;Avesnes-les-Aubert;3630;34;3664;59037
32;59;06;14;038;Avesnes-le-Sec;1449;17;1466;59038
32;59;02;10;039;Awoingt;816;18;834;59039
32;59;01;05;041;Bachant;2291;17;2308;59041
32;59;05;36;042;Bachy;1791;29;1820;59042
32;59;04;08;043;Bailleul;15163;241;15404;59043
32;59;05;36;044;Baisieux;4777;49;4826;59044
32;59;01;19;045;Baives;167;4;171;59045
32;59;04;41;046;Bambecque;812;11;823;59046
32;59;02;10;047;Banteux;349;3;352;59047
32;59;02;09;048;Bantigny;523;11;534;59048
32;59;02;10;049;Bantouzelle;437;7;444;59049
32;59;01;19;050;Bas-Lieu;344;8;352;59050
32;59;05;02;051;La Bassée;6509;51;6560;59051
32;59;05;02;052;Bauvin;5086;44;5130;59052
32;59;01;05;053;Bavay;3264;60;3324;59053
32;59;04;41;054;Bavinchove;998;8;1006;59054
32;59;02;10;055;Bazuel;511;11;522;59055
32;59;05;28;056;Beaucamps-Ligny;851;23;874;59056
32;59;01;07;057;Beaudignies;561;14;575;59057
32;59;01;07;058;Beaufort;1014;14;1028;59058
32;59;02;10;059;Beaumont-en-Cambrésis;441;4;445;59059
32;59;02;11;060;Beaurain;234;3;237;59060
32;59;01;07;061;Beaurepaire-sur-Sambre;266;2;268;59061
32;59;01;19;062;Beaurieux;164;6;170;59062
32;59;02;11;063;Beauvois-en-Cambrésis;2004;20;2024;59063
32;59;06;06;064;Bellaing;1261;12;1273;59064
32;59;01;05;065;Bellignies;813;10;823;59065
32;59;01;19;066;Bérelles;156;5;161;59066
32;59;04;12;067;Bergues;3600;44;3644;59067
32;59;01;05;068;Berlaimont;3175;36;3211;59068
32;59;02;11;069;Bermerain;736;12;748;59069
32;59;01;05;070;Bermeries;371;4;375;59070
32;59;05;36;071;Bersée;2263;47;2310;59071
32;59;01;30;072;Bersillies;256;6;262;59072
32;59;04;08;073;Berthen;556;13;569;59073
32;59;02;10;074;Bertry;2168;36;2204;59074
32;59;02;11;075;Béthencourt;755;11;766;59075
32;59;01;30;076;Bettignies;310;5;315;59076
32;59;01;05;077;Bettrechies;257;6;263;59077
32;59;01;19;078;Beugnies;624;6;630;59078
32;59;06;03;079;Beuvrages;6809;34;6843;59079
32;59;03;31;080;Beuvry-la-Forêt;2796;31;2827;59080
32;59;02;11;081;Bévillers;572;6;578;59081
32;59;04;12;082;Bierne;1801;30;1831;59082
32;59;04;41;083;Bissezeele;253;2;255;59083
32;59;04;21;084;Blaringhem;2059;30;2089;59084
32;59;02;09;085;Blécourt;305;6;311;59085
32;59;04;08;086;Boeschepe;2155;30;2185;59086
32;59;04;21;087;BoÃ«seghem;750;13;763;59087
32;59;05;04;088;Bois-Grenier;1739;21;1760;59088
32;59;04;41;089;Bollezeele;1424;30;1454;59089
32;59;05;24;090;Bondues;9808;181;9989;59090
32;59;04;08;091;Borre;578;14;592;59091
32;59;06;14;092;Bouchain;3924;40;3964;59092
32;59;01;07;093;Boulogne-sur-Helpe;341;5;346;59093
32;59;04;20;094;Bourbourg;7152;50;7202;59094
32;59;05;36;096;Bourghelles;1661;39;1700;59096
32;59;02;09;097;Boursies;402;5;407;59097
32;59;05;22;098;Bousbecque;4804;54;4858;59098
32;59;01;07;099;Bousies;1757;14;1771;59099
32;59;06;34;100;Bousignies;348;4;352;59100
32;59;01;19;101;Bousignies-sur-Roc;387;11;398;59101
32;59;02;11;102;Boussières-en-Cambrésis;438;4;442;59102
32;59;01;05;103;Boussières-sur-Sambre;521;9;530;59103
32;59;01;30;104;Boussois;3194;22;3216;59104
32;59;03;31;105;Bouvignies;1532;25;1557;59105
32;59;05;36;106;Bouvines;756;14;770;59106
32;59;04;17;107;Bray-Dunes;4495;45;4540;59107
32;59;02;10;108;Briastre;750;4;754;59108
32;59;06;34;109;Brillon;771;9;780;59109
32;59;04;20;110;Brouckerque;1421;30;1451;59110
32;59;04;41;111;Broxeele;399;4;403;59111
32;59;06;03;112;Bruay-sur-l'Escaut;11258;40;11298;59112
32;59;03;35;113;Bruille-lez-Marchiennes;1361;6;1367;59113
32;59;06;34;114;Bruille-Saint-Amand;1667;15;1682;59114
32;59;03;01;115;Brunémont;709;4;713;59115
32;59;01;05;116;Bry;414;12;426;59116
32;59;03;01;117;Bugnicourt;1049;12;1061;59117
32;59;02;10;118;Busigny;2456;25;2481;59118
32;59;04;41;119;Buysscheure;609;9;618;59119
32;59;04;08;120;CaÃ«stre;2019;32;2051;59120
32;59;02;11;121;Cagnoncles;618;7;625;59121
32;59;02;09;122;Cambrai;32176;618;32794;59122
32;59;05;02;123;Camphin-en-Carembault;1699;23;1722;59123
32;59;05;36;124;Camphin-en-Pévèle;2499;41;2540;59124
32;59;02;10;125;Cantaing-sur-Escaut;404;9;413;59125
32;59;03;01;126;Cantin;1685;14;1699;59126
32;59;02;11;127;Capelle;145;5;150;59127
32;59;05;04;128;Capinghem;2537;30;2567;59128
32;59;05;36;129;Cappelle-en-Pévèle;2268;27;2295;59129
32;59;04;20;130;Cappelle-Brouck;1151;19;1170;59130
32;59;04;12;131;Cappelle-la-Grande;7920;74;7994;59131
32;59;02;11;132;Carnières;1020;13;1033;59132
32;59;05;02;133;Carnin;1033;19;1052;59133
32;59;01;07;134;Cartignies;1246;10;1256;59134
32;59;04;08;135;Cassel;2265;100;2365;59135
32;59;02;10;136;Le Cateau-Cambrésis;7030;141;7171;59136
32;59;02;10;137;Catillon-sur-Sambre;805;8;813;59137
32;59;02;10;138;Cattenières;682;14;696;59138
32;59;02;11;139;Caudry;14121;140;14261;59139
32;59;02;10;140;Caullery;452;10;462;59140
32;59;02;11;141;Cauroir;567;15;582;59141
32;59;01;19;142;Cerfontaine;709;5;714;59142
32;59;05;04;143;La Chapelle-d'Armentières;8577;94;8671;59143
32;59;06;34;144;Château-l'Abbaye;862;10;872;59144
32;59;05;18;145;Chemy;772;12;784;59145
32;59;05;36;146;Chéreng;2973;41;3014;59146
32;59;01;19;147;Choisies;49;2;51;59147
32;59;01;19;148;Clairfayts;361;1;362;59148
32;59;02;10;149;Clary;1088;16;1104;59149
32;59;05;36;150;Cobrieux;526;11;537;59150
32;59;01;19;151;Colleret;1617;17;1634;59151
32;59;05;22;152;Comines;12788;99;12887;59152
32;59;06;29;153;Condé-sur-l'Escaut;9515;54;9569;59153
32;59;04;12;155;Coudekerque-Branche;20851;293;21144;59155
32;59;03;15;156;Courchelettes;2842;32;2874;59156
32;59;01;19;157;Cousolre;2205;20;2225;59157
32;59;03;31;158;Coutiches;3077;45;3122;59158
32;59;04;20;159;Craywick;668;6;674;59159
32;59;06;29;160;Crespin;4495;30;4525;59160
32;59;02;10;161;CrèvecÅ“ur-sur-l'Escaut;751;45;796;59161
32;59;04;41;162;Crochte;665;21;686;59162
32;59;05;13;163;Croix;20881;276;21157;59163
32;59;01;07;164;Croix-Caluyau;247;8;255;59164
32;59;03;15;165;Cuincy;6400;98;6498;59165
32;59;06;29;166;Curgies;1337;36;1373;59166
32;59;02;09;167;Cuvillers;198;1;199;59167
32;59;05;36;168;Cysoing;4849;69;4918;59168
32;59;01;19;169;Damousies;202;4;206;59169
32;59;03;01;170;Dechy;5360;33;5393;59170
32;59;02;10;171;Dehéries;37;2;39;59171
32;59;06;14;172;Denain;19877;122;19999;59172
32;59;05;04;173;Deûlémont;1818;25;1843;59173
32;59;01;19;174;Dimechaux;330;2;332;59174
32;59;01;19;175;Dimont;310;9;319;59175
32;59;02;09;176;Doignies;326;3;329;59176
32;59;01;07;177;Dompierre-sur-Helpe;857;14;871;59177
32;59;03;15;178;Douai;39613;858;40471;59178
32;59;06;14;179;Douchy-les-Mines;10293;32;10325;59179
32;59;04;08;180;Le Doulieu;1466;19;1485;59180
32;59;01;07;181;Dourlers;551;6;557;59181
32;59;04;20;182;Drincham;266;6;272;59182
32;59;04;96;183;Dunkerque;86279;1268;87547;59183
32;59;04;21;184;Ebblinghem;658;10;668;59184
32;59;03;01;185;Ecaillon;1963;13;1976;59185
32;59;01;19;186;Eccles;80;1;81;59186
32;59;01;07;187;Eclaibes;268;5;273;59187
32;59;01;05;188;Ecuélin;140;4;144;59188
32;59;04;08;189;Eecke;1221;26;1247;59189
32;59;01;30;190;Elesmes;986;14;1000;59190
32;59;02;10;191;Elincourt;625;5;630;59191
32;59;06;14;192;Emerchicourt;847;47;894;59192
32;59;05;18;193;Emmerin;3108;25;3133;59193
32;59;01;07;194;Englefontaine;1282;23;1305;59194
32;59;05;28;195;Englos;613;9;622;59195
32;59;05;28;196;Ennetières-en-Weppes;1304;19;1323;59196
32;59;05;36;197;Ennevelin;2236;22;2258;59197
32;59;01;19;198;Eppe-Sauvage;248;0;248;59198
32;59;03;01;199;Erchin;686;11;697;59199
32;59;04;41;200;Eringhem;504;6;510;59200
32;59;05;28;201;Erquinghem-le-Sec;597;11;608;59201
32;59;05;04;202;Erquinghem-Lys;5316;40;5356;59202
32;59;03;35;203;Erre;1587;9;1596;59203
32;59;02;11;204;Escarmain;484;4;488;59204
32;59;06;14;205;Escaudain;9682;43;9725;59205
32;59;02;09;206;EscaudÅ“uvres;3218;28;3246;59206
32;59;06;03;207;Escautpont;4208;28;4236;59207
32;59;05;28;208;Escobecques;304;10;314;59208
32;59;02;10;209;Esnes;674;8;682;59209
32;59;04;41;210;Esquelbecq;2116;39;2155;59210
32;59;03;15;211;Esquerchin;906;19;925;59211
32;59;04;21;212;Estaires;6461;136;6597;59212
32;59;02;11;213;Estourmel;458;15;473;59213
32;59;03;01;214;Estrées;1103;21;1124;59214
32;59;06;29;215;Estreux;959;33;992;59215
32;59;02;09;216;Eswars;350;8;358;59216
32;59;01;05;217;Eth;346;7;353;59217
32;59;01;07;218;EtrÅ“ungt;1307;15;1322;59218
32;59;02;09;219;Estrun;712;8;720;59219
32;59;05;18;220;Faches-Thumesnil;18191;122;18313;59220
32;59;06;06;221;Famars;2545;69;2614;59221
32;59;03;31;222;Faumont;2213;45;2258;59222
32;59;01;07;223;Le Favril;504;4;508;59223
32;59;03;01;224;Féchain;1698;14;1712;59224
32;59;01;05;225;Feignies;6809;69;6878;59225
32;59;01;19;226;Felleries;1454;16;1470;59226
32;59;03;35;227;Fenain;5510;50;5560;59227
32;59;03;01;228;Férin;1458;17;1475;59228
32;59;01;19;229;Féron;564;9;573;59229
32;59;01;30;230;Ferrière-la-Grande;5273;52;5325;59230
32;59;01;19;231;Ferrière-la-Petite;1058;13;1071;59231
32;59;01;05;232;La Flamengrie;426;4;430;59232
32;59;01;19;233;Flaumont-Waudrechies;365;3;368;59233
32;59;03;15;234;Flers-en-Escrebieux;5781;43;5824;59234
32;59;02;10;236;Flesquières;261;4;265;59236
32;59;04;08;237;Flêtre;986;23;1009;59237
32;59;06;34;238;Flines-lès-Mortagne;1635;25;1660;59238
32;59;03;31;239;Flines-lez-Raches;5598;93;5691;59239
32;59;01;07;240;Floursies;127;3;130;59240
32;59;01;07;241;Floyon;520;15;535;59241
32;59;01;07;242;Fontaine-au-Bois;674;7;681;59242
32;59;02;10;243;Fontaine-au-Pire;1220;18;1238;59243
32;59;02;09;244;Fontaine-Notre-Dame;1776;31;1807;59244
32;59;01;07;246;Forest-en-Cambrésis;570;4;574;59246
32;59;05;40;247;Forest-sur-Marque;1462;18;1480;59247
32;59;01;19;249;Fourmies;11563;191;11754;59249
32;59;05;02;250;Fournes-en-Weppes;2231;105;2336;59250
32;59;01;05;251;Frasnoy;376;4;380;59251
32;59;05;04;252;Frelinghien;2447;20;2467;59252
32;59;06;03;253;Fresnes-sur-Escaut;7499;41;7540;59253
32;59;03;01;254;Fressain;880;12;892;59254
32;59;02;09;255;Fressies;571;8;579;59255
32;59;05;36;256;Fretin;3290;33;3323;59256
32;59;05;02;257;Fromelles;1041;15;1056;59257
32;59;05;36;258;Genech;2827;642;3469;59258
32;59;01;07;259;Ghissignies;511;20;531;59259
32;59;04;17;260;Ghyvelde;4131;60;4191;59260
32;59;01;19;261;Glageon;1758;29;1787;59261
32;59;04;08;262;Godewaersvelde;2086;38;2124;59262
32;59;03;01;263;GÅ“ulzin;1049;26;1075;59263
32;59;01;30;264;Gognies-Chaussée;730;11;741;59264
32;59;01;05;265;Gommegnies;2308;36;2344;59265
32;59;05;18;266;Gondecourt;4031;42;4073;59266
32;59;02;10;267;Gonnelieu;302;4;306;59267
32;59;04;21;268;La Gorgue;5639;49;5688;59268
32;59;02;10;269;Gouzeaucourt;1475;25;1500;59269
32;59;01;07;270;Grand-Fayt;482;7;489;59270
32;59;04;20;271;Grande-Synthe;22522;209;22731;59271
32;59;04;20;272;Grand-Fort-Philippe;5130;47;5177;59272
32;59;04;20;273;Gravelines;11014;188;11202;59273
32;59;02;10;274;La Groise;482;4;486;59274
32;59;05;36;275;Gruson;1267;36;1303;59275
32;59;03;01;276;Guesnain;4689;34;4723;59276
32;59;01;05;277;Gussignies;332;4;336;59277
32;59;05;28;278;Hallennes-lez-Haubourdin;4676;37;4713;59278
32;59;05;37;279;Halluin;20743;114;20857;59279
32;59;03;01;280;Hamel;788;10;798;59280
32;59;05;02;281;Hantay;1281;12;1293;59281
32;59;04;41;282;Hardifort;407;11;418;59282
32;59;01;05;283;Hargnies;613;10;623;59283
32;59;06;34;284;Hasnon;3918;31;3949;59284
32;59;06;06;285;Haspres;2680;20;2700;59285
32;59;05;18;286;Haubourdin;14725;115;14840;59286
32;59;02;10;287;Haucourt-en-Cambrésis;193;4;197;59287
32;59;06;06;288;Haulchin;2340;26;2366;59288
32;59;02;11;289;Haussy;1521;33;1554;59289
32;59;01;07;290;Haut-Lieu;394;1;395;59290
32;59;01;07;291;Hautmont;14517;97;14614;59291
32;59;06;06;292;Haveluy;3304;6;3310;59292
32;59;04;21;293;Haverskerque;1413;18;1431;59293
32;59;02;09;294;Haynecourt;314;7;321;59294
32;59;04;21;295;Hazebrouck;21408;457;21865;59295
32;59;01;07;296;Hecq;354;10;364;59296
32;59;06;34;297;Hélesmes;1979;9;1988;59297
32;59;05;13;299;Hem;18636;174;18810;59299
32;59;02;09;300;Hem-Lenglet;548;9;557;59300
32;59;06;29;301;Hergnies;4433;27;4460;59301
32;59;06;06;302;Hérin;4127;29;4156;59302
32;59;05;02;303;Herlies;2393;27;2420;59303
32;59;05;18;304;Herrin;418;8;426;59304
32;59;04;41;305;Herzeele;1649;34;1683;59305
32;59;01;19;306;Hestrud;292;3;295;59306
32;59;04;41;307;Holque;903;5;908;59307
32;59;04;08;308;Hondeghem;934;24;958;59308
32;59;04;41;309;Hondschoote;4060;82;4142;59309
32;59;01;05;310;Hon-Hergies;867;10;877;59310
32;59;02;10;311;Honnechy;561;7;568;59311
32;59;02;10;312;Honnecourt-sur-Escaut;760;17;777;59312
32;59;06;14;313;Hordain;1423;9;1432;59313
32;59;03;35;314;Hornaing;3562;21;3583;59314
32;59;01;05;315;Houdain-lez-Bavay;886;12;898;59315
32;59;05;18;316;Houplin-Ancoisne;3337;47;3384;59316
32;59;05;04;317;Houplines;7782;94;7876;59317
32;59;04;41;318;Houtkerque;984;8;992;59318
32;59;04;41;319;Hoymille;3194;202;3396;59319
32;59;05;02;320;Illies;1635;12;1647;59320
32;59;02;10;321;Inchy;676;5;681;59321
32;59;02;11;322;Iwuy;3371;31;3402;59322
32;59;01;05;323;Jenlain;1145;26;1171;59323
32;59;01;30;324;Jeumont;10344;111;10455;59324
32;59;01;07;325;Jolimetz;854;16;870;59325
32;59;04;41;326;Killem;1163;21;1184;59326
32;59;03;35;327;Lallaing;6364;39;6403;59327
32;59;05;22;328;Lambersart;27400;435;27835;59328
32;59;03;15;329;Lambres-lez-Douai;5007;84;5091;59329
32;59;03;31;330;Landas;2392;42;2434;59330
32;59;01;07;331;Landrecies;3482;107;3589;59331
32;59;05;13;332;Lannoy;1819;7;1826;59332
32;59;01;07;333;Larouillies;249;9;258;59333
32;59;03;15;334;Lauwin-Planque;1621;23;1644;59334
32;59;06;34;335;Lecelles;2847;55;2902;59335
32;59;03;01;336;Lécluse;1372;13;1385;59336
32;59;04;41;337;Lederzeele;683;21;704;59337
32;59;04;41;338;Ledringhem;651;27;678;59338
32;59;05;33;339;Leers;9378;80;9458;59339
32;59;04;17;340;Leffrinckoucke;4207;97;4304;59340
32;59;02;10;341;Lesdain;435;7;442;59341
32;59;01;19;342;Lez-Fontaine;225;4;229;59342
32;59;05;36;343;Lesquin;9012;85;9097;59343
32;59;01;05;344;Leval;2516;10;2526;59344
32;59;03;01;345;Lewarde;2430;23;2453;59345
32;59;05;26;346;Lezennes;3050;21;3071;59346
32;59;01;19;347;Liessies;537;16;553;59347
32;59;06;14;348;Lieu-Saint-Amand;1426;15;1441;59348
32;59;02;10;349;Ligny-en-Cambrésis;1916;30;1946;59349
32;59;05;97;350;Lille;234475;1925;236400;59350
32;59;01;07;351;Limont-Fontaine;550;7;557;59351
32;59;05;22;352;Linselles;8275;97;8372;59352
32;59;01;07;353;Locquignol;326;7;333;59353
32;59;03;01;354;Loffre;714;13;727;59354
32;59;05;22;356;Lompret;2230;48;2278;59356
32;59;01;05;357;La Longueville;2082;33;2115;59357
32;59;04;20;358;Looberghe;1190;23;1213;59358
32;59;04;20;359;Loon-Plage;6085;76;6161;59359
32;59;05;28;360;Loos;22866;241;23107;59360
32;59;06;14;361;Lourches;3952;18;3970;59361
32;59;01;07;363;Louvignies-Quesnoy;931;19;950;59363
32;59;05;36;364;Louvil;869;12;881;59364
32;59;01;30;365;Louvroil;6371;39;6410;59365
32;59;04;21;366;Lynde;775;15;790;59366
32;59;05;13;367;Lys-lez-Lannoy;13643;151;13794;59367
32;59;05;23;368;La Madeleine;21856;188;22044;59368
32;59;06;06;369;Maing;4066;40;4106;59369
32;59;01;30;370;Mairieux;711;11;722;59370
32;59;05;02;371;Le Maisnil;639;15;654;59371
32;59;02;10;372;Malincourt;489;6;495;59372
32;59;01;07;374;Marbaix;473;4;477;59374
32;59;03;35;375;Marchiennes;4584;63;4647;59375
32;59;02;10;377;Marcoing;1900;25;1925;59377
32;59;05;24;378;Marcq-en-BarÅ“ul;38486;697;39183;59378
32;59;03;01;379;Marcq-en-Ostrevent;748;3;751;59379
32;59;01;07;381;Maresches;812;20;832;59381
32;59;02;10;382;Maretz;1444;15;1459;59382
32;59;06;29;383;Marly;12083;114;12197;59383
32;59;01;07;384;Maroilles;1428;23;1451;59384
32;59;01;30;385;Marpent;2701;21;2722;59385
32;59;05;23;386;Marquette-lez-Lille;10798;69;10867;59386
32;59;06;14;387;Marquette-en-Ostrevant;1897;12;1909;59387
32;59;05;02;388;Marquillies;1998;24;2022;59388
32;59;02;10;389;Masnières;2745;29;2774;59389
32;59;03;01;390;Masny;4109;45;4154;59390
32;59;06;14;391;Mastaing;881;5;886;59391
32;59;01;30;392;Maubeuge;29589;283;29872;59392
32;59;06;34;393;Maulde;1033;12;1045;59393
32;59;02;10;394;Maurois;403;3;406;59394
32;59;02;10;395;Mazinghien;305;4;309;59395
32;59;01;05;396;Mecquignies;720;7;727;59396
32;59;04;41;397;Merckeghem;606;12;618;59397
32;59;05;36;398;Mérignies;3199;136;3335;59398
32;59;04;08;399;Merris;1011;28;1039;59399
32;59;04;21;400;Merville;9641;89;9730;59400
32;59;04;08;401;Méteren;2307;37;2344;59401
32;59;04;41;402;Millam;837;22;859;59402
32;59;06;34;403;Millonfosse;718;12;730;59403
32;59;02;09;405;MÅ“uvres;481;3;484;59405
32;59;01;05;406;Monceau-Saint-Waast;455;6;461;59406
32;59;06;06;407;Monchaux-sur-Ecaillon;538;9;547;59407
32;59;05;36;408;Moncheaux;1632;19;1651;59408
32;59;03;01;409;Monchecourt;2521;20;2541;59409
32;59;05;25;410;Mons-en-BarÅ“ul;21277;138;21415;59410
32;59;05;36;411;Mons-en-Pévèle;2115;37;2152;59411
32;59;02;10;412;Montay;276;4;280;59412
32;59;02;10;413;Montigny-en-Cambrésis;557;9;566;59413
32;59;03;01;414;Montigny-en-Ostrevent;4793;40;4833;59414
32;59;02;11;415;Montrécourt;224;1;225;59415
32;59;04;21;416;Morbecque;2524;41;2565;59416
32;59;06;34;418;Mortagne-du-Nord;1595;7;1602;59418
32;59;05;36;419;Mouchin;1408;16;1424;59419
32;59;01;19;420;Moustier-en-Fagne;58;2;60;59420
32;59;05;24;421;Mouvaux;13121;177;13298;59421
32;59;02;11;422;Naves;630;12;642;59422
32;59;04;21;423;Neuf-Berquin;1263;19;1282;59423
32;59;01;05;424;Neuf-Mesnil;1309;5;1314;59424
32;59;01;07;425;Neuville-en-Avesnois;302;8;310;59425
32;59;05;37;426;Neuville-en-Ferrain;10264;68;10332;59426
32;59;05;36;427;La Neuville;640;10;650;59427
32;59;02;09;428;Neuville-Saint-Rémy;3782;40;3822;59428
32;59;06;14;429;Neuville-sur-Escaut;2688;16;2704;59429
32;59;02;10;430;Neuvilly;1088;12;1100;59430
32;59;04;08;431;Nieppe;7512;79;7591;59431
32;59;02;10;432;Niergnies;514;7;521;59432
32;59;04;41;433;Nieurlet;917;13;930;59433
32;59;06;34;434;Nivelle;1351;17;1368;59434
32;59;03;31;435;Nomain;2549;37;2586;59435
32;59;04;41;436;Noordpeene;788;10;798;59436
32;59;05;18;437;Noyelles-lès-Seclin;858;12;870;59437
32;59;02;10;438;Noyelles-sur-Escaut;811;13;824;59438
32;59;01;05;439;Noyelles-sur-Sambre;271;5;276;59439
32;59;06;14;440;Noyelles-sur-Selle;697;6;703;59440
32;59;01;05;441;Obies;660;6;666;59441
32;59;01;19;442;Obrechies;269;6;275;59442
32;59;04;41;443;Ochtezeele;385;5;390;59443
32;59;06;29;444;Odomez;924;11;935;59444
32;59;01;19;445;Ohain;1189;17;1206;59445
32;59;06;06;446;Oisy;649;8;657;59446
32;59;06;03;447;Onnaing;8789;64;8853;59447
32;59;04;41;448;Oost-Cappel;471;5;476;59448
32;59;03;31;449;Orchies;8633;145;8778;59449
32;59;02;10;450;Ors;640;9;649;59450
32;59;01;07;451;Orsinval;553;3;556;59451
32;59;05;02;452;Ostricourt;5454;26;5480;59452
32;59;04;41;453;Oudezeele;677;14;691;59453
32;59;04;08;454;OxelaÃ«re;517;4;521;59454
32;59;02;09;455;Paillencourt;1009;8;1017;59455
32;59;03;35;456;Pecquencourt;6088;262;6350;59456
32;59;05;04;457;Pérenchies;8542;42;8584;59457
32;59;05;36;458;Péronne-en-Mélantois;918;19;937;59458
32;59;06;06;459;Petite-Forêt;4887;37;4924;59459
32;59;01;07;461;Petit-Fayt;310;2;312;59461
32;59;05;02;462;Phalempin;4820;38;4858;59462
32;59;04;20;463;Pitgam;973;12;985;59463
32;59;01;07;464;Poix-du-Nord;2222;18;2240;59464
32;59;02;10;465;Pommereuil;776;3;779;59465
32;59;05;36;466;Pont-Ã -Marcq;2911;92;3003;59466
32;59;01;05;467;Pont-sur-Sambre;2469;27;2496;59467
32;59;01;07;468;Potelle;425;4;429;59468
32;59;04;08;469;Pradelles;412;4;416;59469
32;59;05;04;470;Prémesques;2123;24;2147;59470
32;59;06;29;471;Préseau;1993;24;2017;59471
32;59;01;07;472;Preux-au-Bois;837;10;847;59472
32;59;01;05;473;Preux-au-Sart;309;7;316;59473
32;59;01;07;474;Prisches;1036;21;1057;59474
32;59;06;06;475;Prouvy;2220;26;2246;59475
32;59;02;09;476;Proville;3124;75;3199;59476
32;59;05;02;477;Provin;4403;40;4443;59477
32;59;04;41;478;QuaÃ«dypre;1129;26;1155;59478
32;59;06;29;479;Quarouble;3077;26;3103;59479
32;59;06;06;480;Quérénaing;870;20;890;59480
32;59;01;07;481;Le Quesnoy;4870;120;4990;59481
32;59;05;22;482;Quesnoy-sur-Deûle;6931;62;6993;59482
32;59;01;19;483;Quiévelon;136;2;138;59483
32;59;06;29;484;Quiévrechain;6362;33;6395;59484
32;59;02;11;485;Quiévy;1802;21;1823;59485
32;59;03;31;486;Râches;2701;44;2745;59486
32;59;05;02;487;Radinghem-en-Weppes;1401;19;1420;59487
32;59;02;09;488;Raillencourt-Sainte-Olle;2179;40;2219;59488
32;59;03;31;489;Raimbeaucourt;4008;55;4063;59489
32;59;01;19;490;Rainsars;177;2;179;59490
32;59;06;34;491;Raismes;12324;64;12388;59491
32;59;02;09;492;Ramillies;602;7;609;59492
32;59;01;19;493;Ramousies;228;1;229;59493
32;59;01;07;494;Raucourt-au-Bois;162;1;163;59494
32;59;01;19;495;Recquignies;2446;24;2470;59495
32;59;02;10;496;Rejet-de-Beaulieu;242;1;243;59496
32;59;04;21;497;Renescure;2120;30;2150;59497
32;59;02;10;498;Reumont;352;8;360;59498
32;59;04;41;499;RexpoÃ«de;1977;33;2010;59499
32;59;02;10;500;Ribécourt-la-Tour;373;5;378;59500
32;59;03;35;501;Rieulay;1261;26;1287;59501
32;59;02;11;502;Rieux-en-Cambrésis;1432;9;1441;59502
32;59;01;07;503;Robersart;198;3;201;59503
32;59;06;14;504;RÅ“ulx;3807;21;3828;59504
32;59;06;29;505;Rombies-et-Marchipont;760;3;763;59505
32;59;02;11;506;Romeries;469;7;476;59506
32;59;05;26;507;Ronchin;19294;120;19414;59507
32;59;05;37;508;Roncq;13482;129;13611;59508
32;59;03;31;509;Roost-Warendin;6037;48;6085;59509
32;59;06;34;511;Rosult;1931;27;1958;59511
32;59;05;98;512;Roubaix;98828;466;99294;59512
32;59;03;01;513;Roucourt;456;7;463;59513
32;59;01;19;514;Rousies;4072;53;4125;59514
32;59;06;06;515;Rouvignies;655;6;661;59515
32;59;04;41;516;Rubrouck;928;19;947;59516
32;59;02;10;517;Les Rues-des-Vignes;771;14;785;59517
32;59;01;07;518;Ruesnes;459;7;466;59518
32;59;06;34;519;Rumegies;1758;33;1791;59519
32;59;02;10;520;Rumilly-en-Cambrésis;1436;25;1461;59520
32;59;02;09;521;Sailly-lez-Cambrai;443;8;451;59521
32;59;05;40;522;Sailly-lez-Lannoy;1937;38;1975;59522
32;59;05;36;523;Sainghin-en-Mélantois;2830;27;2857;59523
32;59;05;02;524;Sainghin-en-Weppes;5481;51;5532;59524
32;59;01;19;525;Sains-du-Nord;2799;25;2824;59525
32;59;06;34;526;Saint-Amand-les-Eaux;15870;164;16034;59526
32;59;05;23;527;Saint-André-lez-Lille;13151;117;13268;59527
32;59;02;11;528;Saint-Aubert;1565;17;1582;59528
32;59;01;07;529;Saint-Aubin;354;8;362;59529
32;59;06;29;530;Saint-Aybert;348;1;349;59530
32;59;02;10;531;Saint-Benin;340;3;343;59531
32;59;04;20;532;Saint-Georges-sur-l'Aa;309;8;317;59532
32;59;02;11;533;Saint-Hilaire-lez-Cambrai;1566;14;1580;59533
32;59;01;07;534;Saint-Hilaire-sur-Helpe;827;31;858;59534
32;59;04;08;535;Saint-Jans-Cappel;1706;49;1755;59535
32;59;04;08;536;Sainte-Marie-Cappel;902;22;924;59536
32;59;02;11;537;Saint-Martin-sur-Ecaillon;506;9;515;59537
32;59;04;41;538;Saint-Momelin;425;11;436;59538
32;59;04;20;539;Saint-Pierre-Brouck;985;18;1003;59539
32;59;02;11;541;Saint-Python;1027;7;1034;59541
32;59;01;05;542;Saint-Remy-Chaussée;511;12;523;59542
32;59;01;07;543;Saint-Remy-du-Nord;1095;10;1105;59543
32;59;06;39;544;Saint-Saulve;11276;159;11435;59544
32;59;02;10;545;Saint-Souplet;1216;23;1239;59545
32;59;04;08;546;Saint-Sylvestre-Cappel;1160;29;1189;59546
32;59;02;11;547;Saint-Vaast-en-Cambrésis;853;9;862;59547
32;59;01;05;548;Saint-Waast;640;8;648;59548
32;59;01;07;549;Salesches;327;3;330;59549
32;59;05;02;550;Salomé;2945;22;2967;59550
32;59;03;31;551;Saméon;1707;24;1731;59551
32;59;02;09;552;Sancourt;196;6;202;59552
32;59;05;28;553;Santes;5608;50;5658;59553
32;59;06;34;554;Sars-et-Rosières;608;15;623;59554
32;59;01;19;555;Sars-Poteries;1437;18;1455;59555
32;59;01;05;556;Sassegnies;259;3;262;59556
32;59;06;29;557;Saultain;2492;16;2508;59557
32;59;02;11;558;Saulzoir;1688;19;1707;59558
32;59;06;29;559;Sebourg;1974;32;2006;59559
32;59;05;18;560;Seclin;12463;94;12557;59560
32;59;01;19;562;Sémeries;544;7;551;59562
32;59;01;07;563;Semousies;237;3;240;59563
32;59;06;06;564;La Sentinelle;3117;16;3133;59564
32;59;01;07;565;Sepmeries;651;11;662;59565
32;59;05;28;566;Sequedin;4775;37;4812;59566
32;59;02;10;567;Séranvillers-Forenville;414;6;420;59567
32;59;04;21;568;Sercus;476;8;484;59568
32;59;03;35;569;Sin-le-Noble;15428;109;15537;59569
32;59;04;41;570;Socx;923;35;958;59570
32;59;02;11;571;Solesmes;4290;108;4398;59571
32;59;01;19;572;Solre-le-Château;1780;21;1801;59572
32;59;01;19;573;Solrinnes;139;3;142;59573
32;59;03;35;574;Somain;11934;77;12011;59574
32;59;02;11;575;Sommaing;403;4;407;59575
32;59;04;12;576;Spycker;1806;27;1833;59576
32;59;04;08;577;Staple;649;5;654;59577
32;59;04;21;578;Steenbecque;1673;30;1703;59578
32;59;04;12;579;Steene;1371;25;1396;59579
32;59;04;41;580;Steenvoorde;4429;85;4514;59580
32;59;04;08;581;Steenwerck;3672;54;3726;59581
32;59;04;08;582;Strazeele;948;23;971;59582
32;59;01;07;583;Taisnières-en-Thiérache;471;4;475;59583
32;59;01;05;584;Taisnières-sur-Hon;957;12;969;59584
32;59;05;18;585;Templemars;3465;34;3499;59585
32;59;05;36;586;Templeuve-en-Pévèle;6332;87;6419;59586
32;59;04;41;587;Terdeghem;522;14;536;59587
32;59;04;12;588;Téteghem-Coudekerque-Village;8285;220;8505;59588
32;59;06;06;589;Thiant;2999;25;3024;59589
32;59;04;21;590;Thiennes;912;14;926;59590
32;59;06;29;591;Thivencelle;836;3;839;59591
32;59;05;36;592;Thumeries;3884;33;3917;59592
32;59;02;09;593;Thun-l'Evêque;751;11;762;59593
32;59;06;34;594;Thun-Saint-Amand;1119;13;1132;59594
32;59;02;09;595;Thun-Saint-Martin;541;7;548;59595
32;59;03;35;596;Tilloy-lez-Marchiennes;509;17;526;59596
32;59;02;09;597;Tilloy-lez-Cambrai;651;23;674;59597
32;59;05;40;598;Toufflers;3911;29;3940;59598
32;59;05;99;599;Tourcoing;98656;689;99345;59599
32;59;05;36;600;Tourmignies;903;14;917;59600
32;59;01;19;601;Trélon;2771;66;2837;59601
32;59;05;36;602;Tressin;1405;30;1435;59602
32;59;06;06;603;Trith-Saint-Léger;6292;88;6380;59603
32;59;02;10;604;Troisvilles;824;7;831;59604
32;59;04;12;605;Uxem;1443;24;1467;59605
32;59;06;39;606;Valenciennes;43229;448;43677;59606
32;59;01;07;607;Vendegies-au-Bois;488;5;493;59607
32;59;02;11;608;Vendegies-sur-Ecaillon;1098;21;1119;59608
32;59;05;18;609;Vendeville;1564;21;1585;59609
32;59;06;06;610;Verchain-Maugré;1073;9;1082;59610
32;59;05;22;611;Verlinghem;2483;55;2538;59611
32;59;02;11;612;Vertain;510;10;520;59612
32;59;06;29;613;Vicq;1464;14;1478;59613
32;59;02;11;614;Viesly;1414;20;1434;59614
32;59;04;08;615;Vieux-Berquin;2512;42;2554;59615
32;59;06;29;616;Vieux-Condé;10465;51;10516;59616
32;59;01;05;617;Vieux-Mesnil;635;7;642;59617
32;59;01;30;618;Vieux-Reng;881;6;887;59618
32;59;01;05;619;Villereau;1046;15;1061;59619
32;59;03;01;620;Villers-au-Tertre;661;6;667;59620
32;59;02;11;622;Villers-en-Cauchies;1187;17;1204;59622
32;59;02;10;623;Villers-Guislain;691;4;695;59623
32;59;02;10;624;Villers-Outréaux;2142;26;2168;59624
32;59;02;10;625;Villers-Plouich;396;4;400;59625
32;59;01;07;626;Villers-Pol;1287;21;1308;59626
32;59;01;30;627;Villers-Sire-Nicole;1008;11;1019;59627
32;59;04;41;628;Volckerinckhove;563;6;569;59628
32;59;03;35;629;Vred;1338;23;1361;59629
32;59;05;02;630;Wahagnies;2636;40;2676;59630
32;59;02;10;631;Walincourt-Selvigny;2153;30;2183;59631
32;59;06;34;632;Wallers;5610;39;5649;59632
32;59;01;19;633;Wallers-en-Fagne;282;7;289;59633
32;59;04;21;634;Wallon-Cappel;794;20;814;59634
32;59;02;10;635;Wambaix;363;6;369;59635
32;59;05;23;636;Wambrechies;10608;104;10712;59636
32;59;03;35;637;Wandignies-Hamage;1319;14;1333;59637
32;59;05;36;638;Wannehain;1330;15;1345;59638
32;59;01;05;639;Wargnies-le-Grand;1102;23;1125;59639
32;59;01;05;640;Wargnies-le-Petit;767;11;778;59640
32;59;04;41;641;Warhem;1996;43;2039;59641
32;59;03;35;642;Warlaing;581;17;598;59642
32;59;05;04;643;Warneton;237;2;239;59643
32;59;06;14;645;Wasnes-au-Bac;595;4;599;59645
32;59;05;13;646;Wasquehal;20860;232;21092;59646
32;59;04;41;647;Watten;2599;29;2628;59647
32;59;05;18;648;Wattignies;15075;193;15268;59648
32;59;01;19;649;Wattignies-la-Victoire;240;5;245;59649
32;59;05;33;650;Wattrelos;40898;172;41070;59650
32;59;06;14;651;Wavrechain-sous-Denain;1637;12;1649;59651
32;59;06;14;652;Wavrechain-sous-Faulx;409;1;410;59652
32;59;05;02;653;Wavrin;7771;64;7835;59653
32;59;03;35;654;Waziers;7402;69;7471;59654
32;59;04;41;655;Wemaers-Cappel;254;4;258;59655
32;59;05;22;656;Wervicq-Sud;5353;50;5403;59656
32;59;04;41;657;West-Cappel;637;7;644;59657
32;59;05;02;658;Wicres;522;7;529;59658
32;59;01;19;659;Wignehies;2855;33;2888;59659
32;59;05;40;660;Willems;3048;40;3088;59660
32;59;01;19;661;Willies;136;2;138;59661
32;59;04;41;662;Winnezeele;1313;23;1336;59662
32;59;04;41;663;Wormhout;5672;83;5755;59663
32;59;04;41;664;Wulverdinghe;317;4;321;59664
32;59;04;41;665;Wylder;296;6;302;59665
32;59;04;41;666;Zegerscappel;1536;25;1561;59666
32;59;04;41;667;Zermezeele;228;6;234;59667
32;59;04;17;668;Zuydcoote;1601;60;1661;59668
32;59;04;41;669;Zuytpeene;518;17;535;59669
32;59;05;02;670;Don;1337;13;1350;59670
32;60;01;11;001;Abancourt;621;8;629;60001
32;60;01;04;002;Abbecourt;807;24;831;60002
32;60;02;19;003;Abbeville-Saint-Lucien;503;13;516;60003
32;60;01;11;004;Achy;405;7;412;60004
32;60;04;15;005;Acy-en-Multien;872;13;885;60005
32;60;02;18;006;Les Ageux;1155;20;1175;60006
32;60;02;05;007;Agnetz;3044;97;3141;60007
32;60;02;19;008;Airion;378;163;541;60008
32;60;01;02;009;Allonne;1622;30;1652;60009
32;60;01;12;010;Amblainville;1747;17;1764;60010
32;60;03;21;011;Amy;404;5;409;60011
32;60;01;12;012;Andeville;3286;49;3335;60012
32;60;02;18;013;Angicourt;1393;29;1422;60013
32;60;02;19;014;Angivillers;172;5;177;60014
32;60;02;14;015;Angy;1154;14;1168;60015
32;60;02;14;016;Ansacq;274;8;282;60016
32;60;02;19;017;Ansauvillers;1208;25;1233;60017
32;60;03;10;019;Antheuil-Portes;414;12;426;60019
32;60;04;15;020;Antilly;256;8;264;60020
32;60;03;17;021;Appilly;549;8;557;60021
32;60;04;03;022;Apremont;644;15;659;60022
32;60;03;07;023;Armancourt;547;17;564;60023
32;60;03;10;024;Arsy;769;8;777;60024
32;60;03;06;025;Attichy;1881;40;1921;60025
32;60;01;19;026;Auchy-la-Montagne;585;13;598;60026
32;60;04;09;027;Auger-Saint-Vincent;537;14;551;60027
32;60;04;20;028;Aumont-en-Halatte;459;25;484;60028
32;60;01;02;029;Auneuil;2836;60;2896;60029
32;60;01;02;030;Auteuil;558;9;567;60030
32;60;04;15;031;Autheuil-en-Valois;270;8;278;60031
32;60;03;06;032;Autrêches;719;14;733;60032
32;60;04;20;033;Avilly-Saint-Léonard;888;39;927;60033
32;60;02;19;034;Avrechy;1156;17;1173;60034
32;60;03;21;035;Avricourt;250;4;254;60035
32;60;02;10;036;Avrigny;384;6;390;60036
32;60;03;17;037;BabÅ“uf;509;7;516;60037
32;60;02;19;039;BacouÃ«l;487;6;493;60039
32;60;02;10;040;Bailleul-le-Soc;646;11;657;60040
32;60;01;14;041;Bailleul-sur-Thérain;2318;55;2373;60041
32;60;02;05;042;Bailleval;1469;46;1515;60042
32;60;03;21;043;Bailly;622;13;635;60043
32;60;04;13;044;Balagny-sur-Thérain;1682;24;1706;60044
32;60;04;18;045;Barbery;578;10;588;60045
32;60;04;15;046;Bargny;339;7;346;60046
32;60;04;15;047;Baron;761;16;777;60047
32;60;03;10;048;Baugy;266;5;271;60048
32;60;01;11;049;Bazancourt;114;3;117;60049
32;60;02;18;050;Bazicourt;348;9;357;60050
32;60;01;11;051;Beaudéduit;180;1;181;60051
32;60;03;17;052;Beaugies-sous-Bois;98;3;101;60052
32;60;03;21;053;Beaulieu-les-Fontaines;595;50;645;60053
32;60;01;04;054;Les Hauts-Talican;867;21;888;60054
32;60;03;17;055;Beaurains-lès-Noyon;338;5;343;60055
32;60;04;18;056;Beaurepaire;66;1;67;60056
32;60;01;98;057;Beauvais;57071;1449;58520;60057
32;60;02;19;058;Beauvoir;216;4;220;60058
32;60;03;17;059;Béhéricourt;206;6;212;60059
32;60;04;12;060;Belle-Eglise;621;10;631;60060
32;60;03;10;061;Belloy;84;5;89;60061
32;60;03;17;062;Berlancourt;319;4;323;60062
32;60;01;02;063;Berneuil-en-Bray;787;37;824;60063
32;60;03;06;064;Berneuil-sur-Aisne;991;16;1007;60064
32;60;01;04;065;Berthecourt;1633;32;1665;60065
32;60;04;09;066;Béthancourt-en-Valois;205;10;215;60066
32;60;04;09;067;Béthisy-Saint-Martin;1005;20;1025;60067
32;60;04;09;068;Béthisy-Saint-Pierre;3108;40;3148;60068
32;60;04;15;069;Betz;1120;39;1159;60069
32;60;03;06;070;Bienville;453;10;463;60070
32;60;03;10;071;Biermont;173;5;178;60071
32;60;03;06;072;Bitry;316;12;328;60072
32;60;01;11;073;Blacourt;569;6;575;60073
32;60;04;13;074;Blaincourt-lès-Précy;1185;29;1214;60074
32;60;01;19;075;Blancfossé;143;1;144;60075
32;60;01;11;076;Blargies;522;7;529;60076
32;60;01;11;077;Blicourt;356;9;365;60077
32;60;02;10;078;Blincourt;108;2;110;60078
32;60;04;15;079;Boissy-Fresnoy;982;12;994;60079
32;60;01;14;081;Bonlier;476;9;485;60081
32;60;02;19;082;Bonneuil-les-Eaux;790;17;807;60082
32;60;04;09;083;Bonneuil-en-Valois;989;23;1012;60083
32;60;01;11;084;Bonnières;187;1;188;60084
32;60;02;19;085;Bonvillers;198;2;200;60085
32;60;04;03;086;Boran-sur-Oise;2142;44;2186;60086
32;60;04;15;087;Borest;338;18;356;60087
32;60;01;12;088;Bornel;4764;73;4837;60088
32;60;01;04;089;Boubiers;409;11;420;60089
32;60;01;04;090;Bouconvillers;383;7;390;60090
32;60;04;15;091;Bouillancy;407;6;413;60091
32;60;04;15;092;Boullarre;217;5;222;60092
32;60;03;10;093;Boulogne-la-Grasse;460;9;469;60093
32;60;04;15;094;Boursonne;317;6;323;60094
32;60;01;04;095;Boury-en-Vexin;343;7;350;60095
32;60;01;04;097;Boutencourt;206;6;212;60097
32;60;01;11;098;Bouvresse;153;1;154;60098
32;60;03;10;099;Braisnes-sur-Aronde;172;3;175;60099
32;60;04;18;100;Brasseuse;112;0;112;60100
32;60;04;15;101;Brégy;653;13;666;60101
32;60;02;18;102;Brenouille;2011;40;2051;60102
32;60;01;14;103;Bresles;4022;54;4076;60103
32;60;02;19;104;Breteuil;4221;115;4336;60104
32;60;03;17;105;Brétigny;421;8;429;60105
32;60;02;05;106;Breuil-le-Sec;2667;39;2706;60106
32;60;02;05;107;Breuil-le-Vert;3116;146;3262;60107
32;60;01;11;108;Briot;288;8;296;60108
32;60;01;11;109;Brombos;255;4;259;60109
32;60;01;11;110;Broquiers;247;0;247;60110
32;60;02;19;111;Broyes;153;2;155;60111
32;60;02;19;112;Brunvillers-la-Motte;349;1;350;60112
32;60;02;19;113;Bucamps;198;2;200;60113
32;60;01;11;114;Buicourt;148;0;148;60114
32;60;02;19;115;Bulles;878;16;894;60115
32;60;02;14;116;Bury;2961;38;2999;60116
32;60;03;17;117;Bussy;314;13;327;60117
32;60;03;17;118;Caisnes;506;9;515;60118
32;60;03;21;119;Cambronne-lès-Ribécourt;1943;38;1981;60119
32;60;02;14;120;Cambronne-lès-Clermont;1198;24;1222;60120
32;60;03;17;121;Campagne;159;4;163;60121
32;60;01;11;122;Campeaux;488;9;497;60122
32;60;02;19;123;Campremy;480;0;480;60123
32;60;03;21;124;Candor;310;7;317;60124
32;60;03;10;125;Canly;765;19;784;60125
32;60;03;21;126;Cannectancourt;502;6;508;60126
32;60;03;21;127;Canny-sur-Matz;399;3;402;60127
32;60;01;11;128;Canny-sur-Thérain;226;0;226;60128
32;60;03;17;129;Carlepont;1513;20;1533;60129
32;60;02;05;130;Catenoy;1037;23;1060;60130
32;60;01;19;131;Catheux;106;2;108;60131
32;60;03;17;132;Catigny;188;3;191;60132
32;60;02;19;133;Catillon-Fumechon;543;4;547;60133
32;60;02;16;134;Cauffry;2621;25;2646;60134
32;60;01;04;135;Cauvigny;1640;39;1679;60135
32;60;01;11;136;Cempuis;501;13;514;60136
32;60;02;10;137;Cernoy;295;3;298;60137
32;60;04;20;138;Chamant;908;28;936;60138
32;60;04;12;139;Chambly;10147;133;10280;60139
32;60;01;04;140;Chambors;313;4;317;60140
32;60;04;03;141;Chantilly;10950;228;11178;60141
32;60;04;20;142;La Chapelle-en-Serval;3140;90;3230;60142
32;60;01;04;143;Chaumont-en-Vexin;3340;42;3382;60143
32;60;01;04;144;Chavençon;177;3;180;60144
32;60;03;07;145;Chelles;473;13;486;60145
32;60;02;19;146;Chepoix;455;3;458;60146
32;60;03;21;147;Chevincourt;816;34;850;60147
32;60;04;15;148;Chèvreville;416;8;424;60148
32;60;03;10;149;Chevrières;2021;68;2089;60149
32;60;03;21;150;Chiry-Ourscamp;1212;18;1230;60150
32;60;03;06;151;Choisy-au-Bac;3288;105;3393;60151
32;60;02;10;152;Choisy-la-Victoire;245;1;246;60152
32;60;01;19;153;Choqueuse-les-Bénards;102;0;102;60153
32;60;02;18;154;Cinqueux;1588;58;1646;60154
32;60;04;13;155;Cires-lès-Mello;3996;50;4046;60155
32;60;03;06;156;Clairoix;2224;46;2270;60156
32;60;02;05;157;Clermont;10163;235;10398;60157
32;60;02;10;158;Coivrel;244;2;246;60158
32;60;03;99;159;Compiègne;40615;1028;41643;60159
32;60;03;10;160;Conchy-les-Pots;725;13;738;60160
32;60;01;19;161;Conteville;72;0;72;60161
32;60;01;04;162;Corbeil-Cerf;320;8;328;60162
32;60;01;19;163;Cormeilles;406;6;412;60163
32;60;01;11;164;Le Coudray-Saint-Germer;870;10;880;60164
32;60;01;04;165;Le Coudray-sur-Thelle;533;15;548;60165
32;60;03;10;166;Coudun;1067;32;1099;60166
32;60;03;06;167;Couloisy;576;14;590;60167
32;60;02;10;168;Courcelles-Epayelles;211;2;213;60168
32;60;01;04;169;Courcelles-lès-Gisors;809;21;830;60169
32;60;04;20;170;Courteuil;569;35;604;60170
32;60;03;06;171;Courtieux;180;3;183;60171
32;60;04;03;172;Coye-la-Forêt;3976;148;4124;60172
32;60;04;13;173;Cramoisy;810;12;822;60173
32;60;03;21;174;Crapeaumesnil;211;3;214;60174
32;60;04;08;175;Creil;36169;259;36428;60175
32;60;04;09;176;Crépy-en-Valois;14788;266;15054;60176
32;60;02;10;177;Cressonsacq;445;8;453;60177
32;60;01;19;178;CrèvecÅ“ur-le-Grand;3503;123;3626;60178
32;60;02;10;179;CrèvecÅ“ur-le-Petit;150;1;151;60179
32;60;01;11;180;Crillon;502;4;506;60180
32;60;03;17;181;Crisolles;901;20;921;60181
32;60;01;19;182;Le Crocq;178;4;182;60182
32;60;01;19;183;Croissy-sur-Celle;256;3;259;60183
32;60;03;07;184;Croutoy;207;10;217;60184
32;60;04;03;185;Crouy-en-Thelle;1116;10;1126;60185
32;60;02;19;186;Cuignières;252;4;256;60186
32;60;01;11;187;Cuigy-en-Bray;970;14;984;60187
32;60;03;07;188;Cuise-la-Motte;2216;106;2322;60188
32;60;03;17;189;Cuts;981;21;1002;60189
32;60;04;15;190;Cuvergnon;297;6;303;60190
32;60;03;10;191;Cuvilly;625;5;630;60191
32;60;03;21;192;Cuy;220;5;225;60192
32;60;01;11;193;Daméraucourt;210;2;212;60193
32;60;01;11;194;Dargies;248;2;250;60194
32;60;01;04;195;Delincourt;500;11;511;60195
32;60;01;04;196;La Drenne;1017;16;1033;60196
32;60;04;12;197;Dieudonné;889;7;896;60197
32;60;03;21;198;Dives;395;6;401;60198
32;60;01;19;199;Doméliers;256;8;264;60199
32;60;02;10;200;Domfront;318;2;320;60200
32;60;02;10;201;Dompierre;241;3;244;60201
32;60;04;09;203;Duvy;426;8;434;60203
32;60;03;21;204;Ecuvilly;306;4;310;60204
32;60;01;11;205;Elencourt;51;1;52;60205
32;60;03;21;206;Elincourt-Sainte-Marguerite;857;14;871;60206
32;60;04;09;207;Eméville;288;6;294;60207
32;60;01;04;208;Enencourt-Léage;124;7;131;60208
32;60;01;04;209;La Corne-en-Vexin;540;10;550;60209
32;60;02;10;210;Epineuse;260;8;268;60210
32;60;01;04;211;Eragny-sur-Epte;599;5;604;60211
32;60;04;12;212;Ercuis;1606;27;1633;60212
32;60;04;15;213;Ermenonville;996;21;1017;60213
32;60;01;11;214;Ernemont-Boutavent;216;3;219;60214
32;60;02;05;215;Erquery;594;13;607;60215
32;60;02;19;216;Erquinvillers;184;2;186;60216
32;60;01;11;217;Escames;218;4;222;60217
32;60;01;12;218;Esches;1610;13;1623;60218
32;60;01;11;219;Escles-Saint-Pierre;167;2;169;60219
32;60;01;11;220;Espaubourg;502;5;507;60220
32;60;02;19;221;Esquennoy;711;7;718;60221
32;60;02;19;222;Essuiles;554;16;570;60222
32;60;03;10;223;Estrées-Saint-Denis;3759;54;3813;60223
32;60;04;15;224;Etavigny;151;1;152;60224
32;60;02;05;225;Etouy;808;42;850;60225
32;60;04;15;226;Eve;421;6;427;60226
32;60;03;21;227;Evricourt;227;2;229;60227
32;60;01;04;228;Fay-les-Etangs;466;8;474;60228
32;60;03;10;229;Le Fayel;227;4;231;60229
32;60;01;14;230;Le Fay-Saint-Quentin;523;14;537;60230
32;60;04;09;231;Feigneux;424;14;438;60231
32;60;02;10;232;Ferrières;473;3;476;60232
32;60;01;11;233;Feuquières;1366;21;1387;60233
32;60;02;05;234;Fitz-James;2575;28;2603;60234
32;60;01;02;235;Flavacourt;661;20;681;60235
32;60;03;17;236;Flavy-le-Meldeux;217;0;217;60236
32;60;02;19;237;Fléchy;89;1;90;60237
32;60;04;20;238;Fleurines;1886;84;1970;60238
32;60;01;04;239;Fleury;568;12;580;60239
32;60;01;19;240;Fontaine-Bonneleau;238;3;241;60240
32;60;04;15;241;Fontaine-Chaalis;336;15;351;60241
32;60;01;11;242;Fontaine-Lavaganne;505;7;512;60242
32;60;01;14;243;Fontaine-Saint-Lucien;173;6;179;60243
32;60;01;11;244;Fontenay-Torcy;139;1;140;60244
32;60;01;11;245;Formerie;2113;28;2141;60245
32;60;02;05;247;Fouilleuse;146;2;148;60247
32;60;01;11;248;Fouilloy;214;6;220;60248
32;60;04;13;249;Foulangues;199;2;201;60249
32;60;01;01;250;Fouquenies;428;14;442;60250
32;60;01;14;251;Fouquerolles;281;5;286;60251
32;60;02;19;252;Fournival;526;3;529;60252
32;60;01;19;253;Francastel;490;8;498;60253
32;60;03;10;254;Francières;549;16;565;60254
32;60;03;17;255;Fréniches;338;3;341;60255
32;60;01;04;256;Montchevreuil;1321;26;1347;60256
32;60;01;04;257;Fresne-Léguillon;438;10;448;60257
32;60;03;21;258;Fresnières;162;6;168;60258
32;60;04;12;259;Fresnoy-en-Thelle;893;23;916;60259
32;60;04;09;260;Fresnoy-la-Rivière;679;21;700;60260
32;60;04;15;261;Fresnoy-le-Luat;517;12;529;60261
32;60;02;10;262;Le Frestoy-Vaux;246;6;252;60262
32;60;03;17;263;Frétoy-le-Château;261;1;262;60263
32;60;01;02;264;Frocourt;515;15;530;60264
32;60;02;19;265;Froissy;984;13;997;60265
32;60;01;19;267;Le Gallet;177;5;182;60267
32;60;02;19;268;Gannes;338;1;339;60268
32;60;01;11;269;Gaudechart;347;5;352;60269
32;60;03;17;270;Genvry;338;85;423;60270
32;60;01;11;271;Gerberoy;85;2;87;60271
32;60;04;09;272;Gilocourt;631;19;650;60272
32;60;03;10;273;Giraumont;532;19;551;60273
32;60;04;09;274;Glaignes;377;13;390;60274
32;60;01;11;275;Glatigny;223;0;223;60275
32;60;02;10;276;Godenvillers;215;2;217;60276
32;60;01;02;277;Goincourt;1544;39;1583;60277
32;60;03;17;278;Golancourt;398;3;401;60278
32;60;04;15;279;Gondreville;200;5;205;60279
32;60;01;11;280;Gourchelles;109;0;109;60280
32;60;03;10;281;Gournay-sur-Aronde;550;14;564;60281
32;60;04;03;282;Gouvieux;8978;385;9363;60282
32;60;02;19;283;Gouy-les-Groseillers;25;0;25;60283
32;60;03;10;284;Grandfresnoy;1792;59;1851;60284
32;60;02;10;285;Grandvillers-aux-Bois;306;15;321;60285
32;60;01;11;286;Grandvilliers;2820;78;2898;60286
32;60;03;17;287;Grandrû;354;4;358;60287
32;60;01;11;288;Grémévillers;474;5;479;60288
32;60;01;11;289;Grez;265;4;269;60289
32;60;01;14;290;Guignecourt;387;4;391;60290
32;60;03;17;291;Guiscard;1805;24;1829;60291
32;60;03;21;292;Gury;237;7;244;60292
32;60;01;04;293;Hadancourt-le-Haut-Clocher;373;8;381;60293
32;60;03;10;294;Hainvillers;85;1;86;60294
32;60;01;11;295;Halloy;449;9;458;60295
32;60;01;11;296;Hannaches;138;1;139;60296
32;60;01;11;297;Le Hamel;188;2;190;60297
32;60;01;11;298;Hanvoile;645;7;652;60298
32;60;02;19;299;Hardivillers;540;8;548;60299
32;60;01;11;301;Haucourt;136;5;141;60301
32;60;01;14;302;Haudivillers;789;23;812;60302
32;60;01;11;303;Hautbos;196;1;197;60303
32;60;01;11;304;Haute-Epine;273;9;282;60304
32;60;03;07;305;Hautefontaine;334;4;338;60305
32;60;01;11;306;Hécourt;153;3;156;60306
32;60;02;14;307;Heilles;638;10;648;60307
32;60;03;10;308;Hémévillers;468;9;477;60308
32;60;01;04;309;Hénonville;873;21;894;60309
32;60;01;01;310;Herchies;628;27;655;60310
32;60;02;19;311;La Hérelle;238;2;240;60311
32;60;01;11;312;Héricourt-sur-Thérain;115;2;117;60312
32;60;01;14;313;Hermes;2509;41;2550;60313
32;60;01;11;314;Hétomesnil;324;5;329;60314
32;60;01;11;315;Hodenc-en-Bray;496;10;506;60315
32;60;01;04;316;Hodenc-l'Evêque;243;7;250;60316
32;60;02;14;317;Hondainville;719;8;727;60317
32;60;03;10;318;Houdancourt;667;13;680;60318
32;60;01;02;319;La Houssoye;608;6;614;60319
32;60;04;15;320;Ivors;258;3;261;60320
32;60;01;04;321;Ivry-le-Temple;831;7;838;60321
32;60;01;04;322;Jaméricourt;322;5;327;60322
32;60;03;06;323;Janville;650;11;661;60323
32;60;03;06;324;Jaulzy;877;11;888;60324
32;60;03;07;325;Jaux;2300;64;2364;60325
32;60;03;07;326;Jonquières;602;22;624;60326
32;60;01;04;327;Jouy-sous-Thelle;1039;16;1055;60327
32;60;01;14;328;Juvignies;309;9;318;60328
32;60;03;21;329;Laberlière;202;6;208;60329
32;60;01;04;330;Laboissière-en-Thelle;1347;26;1373;60330
32;60;01;02;331;Labosse;442;6;448;60331
32;60;02;05;332;Labruyère;710;9;719;60332
32;60;01;02;333;Lachapelle-aux-Pots;1660;37;1697;60333
32;60;01;04;334;Lachapelle-Saint-Pierre;870;14;884;60334
32;60;01;11;335;Lachapelle-sous-Gerberoy;148;1;149;60335
32;60;01;19;336;Lachaussée-du-Bois-d'Ecu;192;3;195;60336
32;60;03;07;337;Lachelle;732;29;761;60337
32;60;03;07;338;Lacroix-Saint-Ouen;4891;163;5054;60338
32;60;01;14;339;Lafraye;363;9;372;60339
32;60;03;21;340;Lagny;531;18;549;60340
32;60;04;15;341;Lagny-le-Sec;2050;55;2105;60341
32;60;02;16;342;Laigneville;4721;52;4773;60342
32;60;01;02;343;Lalande-en-Son;626;23;649;60343
32;60;01;02;344;Lalandelle;501;9;510;60344
32;60;02;05;345;Lamécourt;190;2;192;60345
32;60;04;03;346;Lamorlaye;8784;231;9015;60346
32;60;01;11;347;Lannoy-Cuillère;283;5;288;60347
32;60;03;17;348;Larbroye;514;9;523;60348
32;60;03;21;350;Lassigny;1382;24;1406;60350
32;60;03;10;351;Lataule;119;2;121;60351
32;60;01;04;352;Lattainville;163;2;165;60352
32;60;01;11;353;Lavacquerie;195;1;196;60353
32;60;01;11;354;Laverrière;35;1;36;60354
32;60;01;14;355;Laversines;1175;51;1226;60355
32;60;01;04;356;Lavilletertre;640;17;657;60356
32;60;02;10;357;Léglantiers;551;7;558;60357
32;60;04;15;358;Lévignen;1008;26;1034;60358
32;60;01;11;359;Lhéraule;196;3;199;60359
32;60;02;05;360;Liancourt;7010;65;7075;60360
32;60;01;04;361;Liancourt-Saint-Pierre;591;20;611;60361
32;60;03;17;362;Libermont;177;6;183;60362
32;60;01;04;363;Lierville;221;1;222;60363
32;60;02;19;364;Lieuvillers;705;8;713;60364
32;60;01;11;365;Lihus;422;5;427;60365
32;60;02;14;366;Litz;363;5;368;60366
32;60;01;04;367;Loconville;333;8;341;60367
32;60;03;21;368;Longueil-Annel;2604;59;2663;60368
32;60;03;10;369;Longueil-Sainte-Marie;2004;36;2040;60369
32;60;01;12;370;Lormaison;1311;14;1325;60370
32;60;01;11;371;Loueuse;151;1;152;60371
32;60;01;19;372;Luchy;662;16;678;60372
32;60;03;21;373;Machemont;777;19;796;60373
32;60;02;10;374;Maignelay-Montigny;2678;31;2709;60374
32;60;02;05;375;Maimbeville;399;10;409;60375
32;60;01;14;376;Maisoncelle-Saint-Pierre;165;1;166;60376
32;60;02;19;377;Maisoncelle-Tuilerie;290;8;298;60377
32;60;03;21;378;Marest-sur-Matz;394;5;399;60378
32;60;03;21;379;Mareuil-la-Motte;614;15;629;60379
32;60;04;15;380;Mareuil-sur-Ourcq;1604;24;1628;60380
32;60;03;21;381;Margny-aux-Cerises;256;3;259;60381
32;60;03;06;382;Margny-lès-Compiègne;8676;177;8853;60382
32;60;03;10;383;Margny-sur-Matz;538;12;550;60383
32;60;04;15;385;Marolles;668;13;681;60385
32;60;03;10;386;Marquéglise;480;8;488;60386
32;60;01;11;387;Marseille-en-Beauvaisis;1475;10;1485;60387
32;60;01;11;388;Martincourt;133;6;139;60388
32;60;03;17;389;Maucourt;245;2;247;60389
32;60;01;19;390;Maulers;327;6;333;60390
32;60;04;13;391;Maysel;230;3;233;60391
32;60;03;21;392;Mélicocq;772;17;789;60392
32;60;04;13;393;Mello;613;13;626;60393
32;60;02;10;394;Ménévillers;105;1;106;60394
32;60;01;12;395;Méru;14452;182;14634;60395
32;60;02;10;396;Méry-la-Bataille;631;5;636;60396
32;60;01;11;397;Le Mesnil-Conteville;77;1;78;60397
32;60;04;03;398;Le Mesnil-en-Thelle;2207;30;2237;60398
32;60;02;19;399;Le Mesnil-Saint-Firmin;239;18;257;60399
32;60;02;19;400;Le Mesnil-sur-Bulles;270;7;277;60400
32;60;01;04;401;Le Mesnil-Théribus;787;33;820;60401
32;60;03;07;402;Le Meux;2327;62;2389;60402
32;60;01;01;403;Milly-sur-Thérain;1814;31;1845;60403
32;60;02;16;404;Mogneville;1474;36;1510;60404
32;60;01;11;405;Moliens;1147;16;1163;60405
32;60;02;18;406;Monceaux;830;16;846;60406
32;60;01;11;407;Monceaux-l'Abbaye;218;2;220;60407
32;60;03;10;408;Monchy-Humières;787;13;800;60408
32;60;02;16;409;Monchy-Saint-Eloi;2181;39;2220;60409
32;60;03;17;410;Mondescourt;247;8;255;60410
32;60;01;04;411;Monneville;775;12;787;60411
32;60;01;04;412;Montagny-en-Vexin;677;12;689;60412
32;60;04;15;413;Montagny-Sainte-Félicité;412;9;421;60413
32;60;04;13;414;Montataire;13645;166;13811;60414
32;60;04;18;415;Montépilloy;137;9;146;60415
32;60;02;10;416;Montgérain;174;2;176;60416
32;60;02;10;418;Montiers;412;13;425;60418
32;60;01;04;420;Montjavoult;481;11;492;60420
32;60;04;20;421;Mont-l'Evêque;401;7;408;60421
32;60;04;15;422;Montlognon;199;11;210;60422
32;60;03;21;423;Montmacq;1126;26;1152;60423
32;60;03;10;424;Montmartin;264;4;268;60424
32;60;02;19;425;Montreuil-sur-Brêche;477;17;494;60425
32;60;01;04;426;Montreuil-sur-Thérain;245;2;247;60426
32;60;01;04;427;Monts;178;1;179;60427
32;60;01;01;428;Le Mont-Saint-Adrien;643;27;670;60428
32;60;04;03;429;Morangles;416;16;432;60429
32;60;04;09;430;Morienval;1088;13;1101;60430
32;60;03;17;431;Morlincourt;542;11;553;60431
32;60;04;20;432;Mortefontaine;868;29;897;60432
32;60;01;04;433;Mortefontaine-en-Thelle;987;20;1007;60433
32;60;03;10;434;Mortemer;223;6;229;60434
32;60;01;11;435;Morvillers;490;4;494;60435
32;60;02;19;436;Mory-Montcrux;76;2;78;60436
32;60;01;04;437;Mouchy-le-Châtel;82;0;82;60437
32;60;03;06;438;Moulin-sous-Touvent;196;5;201;60438
32;60;02;14;439;Mouy;5237;74;5311;60439
32;60;02;10;440;Moyenneville;609;16;625;60440
32;60;03;10;441;Moyvillers;696;7;703;60441
32;60;01;19;442;Muidorge;147;2;149;60442
32;60;03;17;443;Muirancourt;582;4;586;60443
32;60;01;11;444;Mureaumont;159;5;164;60444
32;60;03;06;445;Nampcel;317;3;320;60445
32;60;04;15;446;Nanteuil-le-Haudouin;4201;61;4262;60446
32;60;04;09;447;Néry;656;14;670;60447
32;60;04;15;448;Neufchelles;388;6;394;60448
32;60;03;10;449;Neufvy-sur-Aronde;280;4;284;60449
32;60;04;12;450;Neuilly-en-Thelle;3970;44;4014;60450
32;60;02;14;451;Neuilly-sous-Clermont;1645;28;1673;60451
32;60;01;04;452;Neuville-Bosc;490;14;504;60452
32;60;02;14;454;La Neuville-en-Hez;959;31;990;60454
32;60;02;10;456;La Neuville-Roy;927;28;955;60456
32;60;02;19;457;La Neuville-Saint-Pierre;155;2;157;60457
32;60;01;11;458;La Neuville-sur-Oudeuil;317;15;332;60458
32;60;03;10;459;La Neuville-sur-Ressons;206;3;209;60459
32;60;01;11;460;La Neuville-Vault;199;8;207;60460
32;60;01;14;461;Nivillers;189;24;213;60461
32;60;01;04;462;Noailles;2829;44;2873;60462
32;60;04;16;463;Nogent-sur-Oise;20780;362;21142;60463
32;60;02;05;464;Nointel;1092;16;1108;60464
32;60;02;19;465;Noirémont;183;6;189;60465
32;60;02;19;466;Noroy;250;3;253;60466
32;60;02;19;468;Nourard-le-Franc;311;4;315;60468
32;60;01;04;469;Novillers;363;9;372;60469
32;60;02;19;470;Noyers-Saint-Martin;890;14;904;60470
32;60;03;17;471;Noyon;13190;260;13450;60471
32;60;01;11;472;Offoy;119;1;120;60472
32;60;04;15;473;Ognes;289;1;290;60473
32;60;03;21;474;Ognolles;285;5;290;60474
32;60;01;11;476;Omécourt;199;8;207;60476
32;60;01;02;477;Ons-en-Bray;1399;23;1422;60477
32;60;04;15;478;Ormoy-le-Davien;356;9;365;60478
32;60;04;15;479;Ormoy-Villers;677;10;687;60479
32;60;01;14;480;OroÃ«r;551;17;568;60480
32;60;04;09;481;Orrouy;605;13;618;60481
32;60;04;20;482;Orry-la-Ville;3351;90;3441;60482
32;60;03;10;483;Orvillers-Sorel;528;52;580;60483
32;60;01;11;484;Oudeuil;277;6;283;60484
32;60;02;19;485;Oursel-Maison;240;5;245;60485
32;60;02;19;486;Paillart;575;10;585;60486
32;60;01;04;487;Parnes;332;15;347;60487
32;60;03;17;488;Passel;273;6;279;60488
32;60;04;15;489;Péroy-les-Gombries;1174;14;1188;60489
32;60;01;01;490;Pierrefitte-en-Beauvaisis;372;14;386;60490
32;60;03;07;491;Pierrefonds;1833;210;2043;60491
32;60;03;21;492;Pimprez;853;19;872;60492
32;60;01;11;493;Pisseleu;506;11;517;60493
32;60;04;20;494;Plailly;1882;41;1923;60494
32;60;02;19;495;Plainval;409;5;414;60495
32;60;02;19;496;Plainville;162;1;163;60496
32;60;02;19;497;Le Plessier-sur-Bulles;212;0;212;60497
32;60;02;19;498;Le Plessier-sur-Saint-Just;528;3;531;60498
32;60;03;21;499;Plessis-de-Roye;231;5;236;60499
32;60;04;15;500;Le Plessis-Belleville;3833;55;3888;60500
32;60;03;21;501;Le Plessis-Brion;1351;31;1382;60501
32;60;03;17;502;Le Plessis-Patte-d'Oie;99;4;103;60502
32;60;02;10;503;Le Ployron;112;3;115;60503
32;60;01;04;504;Ponchon;1125;16;1141;60504
32;60;04;20;505;Pontarmé;849;21;870;60505
32;60;03;17;506;Pont-l'Evêque;681;12;693;60506
32;60;03;17;507;Pontoise-lès-Noyon;451;10;461;60507
32;60;04;18;508;Pontpoint;3242;74;3316;60508
32;60;04;18;509;Pont-Sainte-Maxence;12602;122;12724;60509
32;60;01;02;510;Porcheux;645;16;661;60510
32;60;03;17;511;Porquéricourt;398;12;410;60511
32;60;01;04;512;Pouilly;159;2;161;60512
32;60;04;13;513;Précy-sur-Oise;3220;70;3290;60513
32;60;01;11;514;Prévillers;242;1;243;60514
32;60;02;10;515;Pronleroy;377;12;389;60515
32;60;01;11;516;Puiseux-en-Bray;411;3;414;60516
32;60;04;12;517;Puiseux-le-Hauberger;852;12;864;60517
32;60;02;19;518;Puits-la-Vallée;207;4;211;60518
32;60;03;17;519;Quesmy;176;5;181;60519
32;60;02;19;520;Le Quesnel-Aubry;222;8;230;60520
32;60;01;11;521;Quincampoix-Fleuzy;401;16;417;60521
32;60;02;19;522;Quinquempoix;316;3;319;60522
32;60;01;02;523;Rainvillers;918;25;943;60523
32;60;02;05;524;Rantigny;2541;23;2564;60524
32;60;04;18;525;Raray;127;5;132;60525
32;60;02;19;526;Ravenel;1071;13;1084;60526
32;60;04;15;527;Réez-Fosse-Martin;145;1;146;60527
32;60;01;04;528;Reilly;129;2;131;60528
32;60;02;05;529;Rémécourt;76;0;76;60529
32;60;02;14;530;Rémérangles;217;9;226;60530
32;60;03;10;531;Remy;1920;39;1959;60531
32;60;03;10;533;Ressons-sur-Matz;1700;28;1728;60533
32;60;03;06;534;Rethondes;630;23;653;60534
32;60;02;19;535;Reuil-sur-Brêche;331;6;337;60535
32;60;04;18;536;Rhuis;136;8;144;60536
32;60;03;21;537;Ribécourt-Dreslincourt;3705;174;3879;60537
32;60;03;10;538;Ricquebourg;306;4;310;60538
32;60;02;18;539;Rieux;1548;21;1569;60539
32;60;03;10;540;Rivecourt;625;15;640;60540
32;60;04;18;541;Roberval;356;12;368;60541
32;60;01;14;542;Rochy-Condé;992;16;1008;60542
32;60;04;09;543;Rocquemont;119;1;120;60543
32;60;02;19;544;Rocquencourt;195;1;196;60544
32;60;01;11;545;Romescamps;531;8;539;60545
32;60;04;15;546;Rosières;139;4;143;60546
32;60;02;05;547;Rosoy;627;17;644;60547
32;60;04;15;548;Rosoy-en-Multien;603;7;610;60548
32;60;01;19;549;Rotangy;220;6;226;60549
32;60;01;11;550;Rothois;222;0;222;60550
32;60;02;13;551;Rousseloy;299;7;306;60551
32;60;04;15;552;Rouville;246;9;255;60552
32;60;02;10;553;Rouvillers;273;7;280;60553
32;60;04;15;554;Rouvres-en-Multien;472;9;481;60554
32;60;02;19;555;Rouvroy-les-Merles;53;0;53;60555
32;60;02;10;556;Royaucourt;205;3;208;60556
32;60;01;11;557;Roy-Boissy;308;6;314;60557
32;60;03;21;558;Roye-sur-Matz;461;18;479;60558
32;60;02;14;559;La Rue-Saint-Pierre;829;9;838;60559
32;60;04;18;560;Rully;727;33;760;60560
32;60;04;09;561;Russy-Bémont;196;6;202;60561
32;60;02;18;562;Sacy-le-Grand;1594;27;1621;60562
32;60;02;18;563;Sacy-le-Petit;595;6;601;60563
32;60;02;10;564;Sains-Morainvillers;280;3;283;60564
32;60;02;19;565;Saint-André-Farivillers;518;4;522;60565
32;60;01;11;566;Saint-Arnoult;205;3;208;60566
32;60;01;02;567;Saint-Aubin-en-Bray;1165;29;1194;60567
32;60;02;05;568;Saint-Aubin-sous-Erquery;332;8;340;60568
32;60;03;06;569;Saint-Crépin-aux-Bois;188;9;197;60569
32;60;01;04;570;Saint-Crépin-Ibouvillers;1563;24;1587;60570
32;60;01;11;571;Saint-Deniscourt;83;3;86;60571
32;60;03;07;572;Saint-Etienne-Roilaye;296;9;305;60572
32;60;02;19;573;Sainte-Eusoye;332;2;334;60573
32;60;02;14;574;Saint-Félix;623;16;639;60574
32;60;01;04;575;Sainte-Geneviève;3344;44;3388;60575
32;60;01;01;576;Saint-Germain-la-Poterie;485;13;498;60576
32;60;01;11;577;Saint-Germer-de-Fly;1709;35;1744;60577
32;60;04;09;578;Saintines;1080;17;1097;60578
32;60;03;07;579;Saint-Jean-aux-Bois;322;7;329;60579
32;60;02;19;581;Saint-Just-en-Chaussée;6055;46;6101;60581
32;60;03;21;582;Saint-Léger-aux-Bois;771;20;791;60582
32;60;01;02;583;Saint-Léger-en-Bray;356;9;365;60583
32;60;04;13;584;Saint-Leu-d'Esserent;4678;99;4777;60584
32;60;02;10;585;Saint-Martin-aux-Bois;283;5;288;60585
32;60;01;02;586;Saint-Martin-le-NÅ“ud;1033;22;1055;60586
32;60;02;18;587;Saint-Martin-Longueau;1463;28;1491;60587
32;60;01;11;588;Saint-Maur;375;6;381;60588
32;60;04;03;589;Saint-Maximin;2847;115;2962;60589
32;60;01;11;590;Saint-Omer-en-Chaussée;1243;24;1267;60590
32;60;01;02;591;Saint-Paul;1556;63;1619;60591
32;60;01;11;592;Saint-Pierre-es-Champs;708;8;716;60592
32;60;03;06;593;Saint-Pierre-lès-Bitry;139;2;141;60593
32;60;01;11;594;Saint-Quentin-des-Prés;279;6;285;60594
32;60;02;19;595;Saint-Remy-en-l'Eau;438;3;441;60595
32;60;01;11;596;Saint-Samson-la-Poterie;247;2;249;60596
32;60;03;07;597;Saint-Sauveur;1732;32;1764;60597
32;60;01;04;598;Saint-Sulpice;1043;86;1129;60598
32;60;01;11;599;Saint-Thibault;291;5;296;60599
32;60;04;09;600;Saint-Vaast-de-Longmont;639;7;646;60600
32;60;04;13;601;Saint-Vaast-lès-Mello;1041;16;1057;60601
32;60;01;11;602;Saint-Valery;59;6;65;60602
32;60;03;17;603;Salency;897;22;919;60603
32;60;01;11;604;Sarcus;267;2;269;60604
32;60;01;11;605;Sarnois;349;6;355;60605
32;60;01;19;608;Le Saulchoy;104;1;105;60608
32;60;01;01;609;Savignies;887;23;910;60609
32;60;03;17;610;Sempigny;768;13;781;60610
32;60;01;11;611;Senantes;597;14;611;60611
32;60;04;20;612;Senlis;14760;626;15386;60612
32;60;01;04;613;Senots;344;7;351;60613
32;60;01;04;614;Serans;205;6;211;60614
32;60;02;19;615;Sérévillers;134;1;135;60615
32;60;01;02;616;Sérifontaine;2739;33;2772;60616
32;60;03;17;617;Sermaize;269;4;273;60617
32;60;04;09;618;Séry-Magneval;283;10;293;60618
32;60;04;15;619;Silly-le-Long;1166;26;1192;60619
32;60;01;04;620;Silly-Tillard;450;9;459;60620
32;60;03;21;621;Solente;142;1;143;60621
32;60;01;11;622;Sommereux;482;5;487;60622
32;60;01;11;623;Songeons;982;80;1062;60623
32;60;01;11;624;Sully;173;4;177;60624
32;60;03;17;625;Suzoy;570;12;582;60625
32;60;01;11;626;Talmontiers;669;18;687;60626
32;60;02;19;627;Tartigny;259;3;262;60627
32;60;01;14;628;Therdonne;1067;22;1089;60628
32;60;01;11;629;Thérines;196;9;205;60629
32;60;01;04;630;Thibivillers;186;3;189;60630
32;60;04;20;631;Thiers-sur-Thève;1077;24;1101;60631
32;60;03;21;632;Thiescourt;757;16;773;60632
32;60;01;11;633;Thieuloy-Saint-Antoine;418;2;420;60633
32;60;02;19;634;Thieux;437;11;448;60634
32;60;04;13;635;Thiverny;1075;10;1085;60635
32;60;03;21;636;Thourotte;4484;74;4558;60636
32;60;04;15;637;Thury-en-Valois;513;5;518;60637
32;60;02;14;638;Thury-sous-Clermont;672;9;681;60638
32;60;01;14;639;Tillé;1234;24;1258;60639
32;60;01;04;640;Tourly;172;1;173;60640
32;60;03;06;641;Tracy-le-Mont;1725;49;1774;60641
32;60;03;21;642;Tracy-le-Val;1068;32;1100;60642
32;60;02;10;643;Tricot;1371;14;1385;60643
32;60;01;04;644;Trie-Château;1935;31;1966;60644
32;60;01;04;645;Trie-la-Ville;306;5;311;60645
32;60;01;14;646;Troissereux;1308;32;1340;60646
32;60;03;06;647;Trosly-Breuil;2063;54;2117;60647
32;60;02;19;648;Troussencourt;324;4;328;60648
32;60;04;09;650;Trumilly;532;25;557;60650
32;60;04;13;651;Ully-Saint-Georges;1890;31;1921;60651
32;60;01;04;652;Valdampierre;929;10;939;60652
32;60;02;19;653;Valescourt;301;2;303;60653
32;60;03;21;654;Vandélicourt;267;5;272;60654
32;60;03;17;655;Varesnes;365;10;375;60655
32;60;04;15;656;Varinfroy;286;3;289;60656
32;60;03;17;657;Vauchelles;253;5;258;60657
32;60;04;09;658;Vauciennes;691;10;701;60658
32;60;01;04;659;Vaudancourt;171;2;173;60659
32;60;01;02;660;Le Vaumain;403;11;414;60660
32;60;04;09;661;Vaumoise;987;83;1070;60661
32;60;01;02;662;Le Vauroux;505;13;518;60662
32;60;01;14;663;Velennes;257;3;260;60663
32;60;02;19;664;Vendeuil-Caply;453;11;464;60664
32;60;03;07;665;Venette;2884;62;2946;60665
32;60;04;15;666;Ver-sur-Launette;1135;26;1161;60666
32;60;04;09;667;Verberie;3813;53;3866;60667
32;60;01;14;668;Verderel-lès-Sauqueuse;740;24;764;60668
32;60;02;05;669;Verderonne;489;13;502;60669
32;60;04;08;670;Verneuil-en-Halatte;4707;115;4822;60670
32;60;04;15;671;Versigny;360;20;380;60671
32;60;04;09;672;Vez;273;13;286;60672
32;60;01;19;673;Viefvillers;209;1;210;60673
32;60;03;07;674;Vieux-Moulin;615;31;646;60674
32;60;03;10;675;Vignemont;433;6;439;60675
32;60;03;17;676;Ville;758;16;774;60676
32;60;01;11;677;Villembray;255;4;259;60677
32;60;01;12;678;Villeneuve-les-Sablons;1165;22;1187;60678
32;60;04;15;679;La Villeneuve-sous-Thury;155;6;161;60679
32;60;04;18;680;Villeneuve-sur-Verberie;664;17;681;60680
32;60;01;02;681;Villers-Saint-Barthélemy;466;18;484;60681
32;60;04;18;682;Villers-Saint-Frambourg-Ognon;708;38;746;60682
32;60;04;15;683;Villers-Saint-Genest;394;16;410;60683
32;60;04;16;684;Villers-Saint-Paul;6434;64;6498;60684
32;60;01;04;685;Villers-Saint-Sépulcre;1012;9;1021;60685
32;60;04;13;686;Villers-sous-Saint-Leu;2318;57;2375;60686
32;60;01;11;687;Villers-sur-Auchy;372;9;381;60687
32;60;01;11;688;Villers-sur-Bonnières;161;1;162;60688
32;60;03;10;689;Villers-sur-Coudun;1390;58;1448;60689
32;60;01;11;691;Villers-Vermont;118;1;119;60691
32;60;02;19;692;Villers-Vicomte;146;2;148;60692
32;60;03;17;693;Villeselve;425;4;429;60693
32;60;04;20;695;Vineuil-Saint-Firmin;1402;50;1452;60695
32;60;01;11;697;Vrocourt;34;1;35;60697
32;60;02;10;698;Wacquemoulin;280;9;289;60698
32;60;01;11;699;Wambez;165;5;170;60699
32;60;01;02;700;Warluis;1187;21;1208;60700
32;60;02;19;701;Wavignies;1283;8;1291;60701
32;60;02;10;702;Welles-Pérennes;248;3;251;60702
32;60;01;02;703;Aux Marais;870;17;887;60703
28;61;01;97;001;Alençon;25870;752;26622;61001
28;61;01;19;002;Almenêches;669;10;679;61002
28;61;03;09;005;Appenai-sous-Bellême;281;6;287;61005
28;61;02;98;006;Argentan;13395;353;13748;61006
28;61;02;06;007;Athis-Val de Rouvre;4217;85;4302;61007
28;61;03;18;008;Aube;1268;45;1313;61008
28;61;03;21;010;Aubry-le-Panthou;120;6;126;61010
28;61;02;14;011;Aubusson;416;14;430;61011
28;61;03;20;012;Auguaise;217;5;222;61012
28;61;01;17;013;Aunay-les-Bois;136;0;136;61013
28;61;02;04;014;Aunou-le-Faucon;247;9;256;61014
28;61;01;19;015;Aunou-sur-Orne;262;7;269;61015
28;61;03;18;017;Les Authieux-du-Puits;79;0;79;61017
28;61;03;21;018;Avernes-Saint-Gourgon;62;1;63;61018
28;61;02;15;020;Avoine;214;7;221;61020
28;61;02;11;021;Avrilly;102;4;106;61021
28;61;02;05;023;Bailleul;611;24;635;61023
28;61;02;12;024;Banvou;600;14;614;61024
28;61;01;17;026;Barville;185;8;193;61026
28;61;02;06;028;Bazoches-au-Houlme;457;11;468;61028
28;61;03;16;029;Bazoches-sur-HoÃ«ne;840;23;863;61029
28;61;02;13;030;La Bazoque;272;4;276;61030
28;61;03;18;032;Beaufai;334;8;342;61032
28;61;03;20;034;Beaulieu;204;7;211;61034
28;61;01;12;035;Beauvain;274;2;276;61035
28;61;01;19;036;Belfonds;204;0;204;61036
28;61;03;16;037;Bellavilliers;132;3;135;61037
28;61;03;09;038;Bellême;1468;19;1487;61038
28;61;01;19;039;La Bellière;129;1;130;61039
28;61;02;12;040;Bellou-en-Houlme;1074;30;1104;61040
28;61;03;09;041;Bellou-le-Trichard;209;3;212;61041
28;61;03;08;043;Berd'huis;1096;21;1117;61043
28;61;02;06;044;Berjou;451;16;467;61044
28;61;03;20;046;Bizou;133;0;133;61046
28;61;03;16;048;BoÃ«cé;125;4;129;61048
28;61;01;19;049;Boissei-la-Lande;128;2;130;61049
28;61;03;08;050;Cour-Maugis sur Huisne;592;22;614;61050
28;61;01;19;051;Boitron;358;6;364;61051
28;61;03;20;052;Bonnefoi;188;4;192;61052
28;61;03;20;053;Bonsmoulins;235;7;242;61053
28;61;03;21;054;Le Bosc-Renoult;253;4;257;61054
28;61;02;15;055;Boucé;614;11;625;61055
28;61;01;19;056;Le Bouillon;166;1;167;61056
28;61;03;20;060;Brethel;166;1;167;61060
28;61;03;08;061;Bretoncelles;1478;31;1509;61061
28;61;02;04;062;Brieux;91;2;93;61062
28;61;02;06;063;Briouze;1517;41;1558;61063
28;61;01;17;064;Brullemail;93;3;96;61064
28;61;01;17;066;Buré;107;5;112;61066
28;61;01;17;067;Bures;161;4;165;61067
28;61;01;17;068;Bursard;207;1;208;61068
28;61;02;06;069;Cahan;170;7;177;61069
28;61;02;13;070;Caligny;815;26;841;61070
28;61;03;21;071;Camembert;176;7;183;61071
28;61;03;21;072;Canapville;203;4;207;61072
28;61;01;15;074;Carrouges;643;7;650;61074
28;61;01;07;075;Ceaucé;1172;26;1198;61075
28;61;01;19;076;Le Cercueil;134;6;140;61076
28;61;01;02;077;Cerisé;866;16;882;61077
28;61;02;13;078;Cerisy-Belle-Etoile;714;48;762;61078
28;61;03;09;079;Ceton;1770;24;1794;61079
28;61;01;15;080;Chahains;83;2;85;61080
28;61;01;19;081;Chailloué;889;25;914;61081
28;61;01;17;082;Le Chalange;88;4;92;61082
28;61;02;06;084;Champcerie;170;4;174;61084
28;61;01;15;085;Le Champ-de-la-Pierre;33;0;33;61085
28;61;03;21;086;Les Champeaux;107;0;107;61086
28;61;03;16;087;Champeaux-sur-Sarthe;162;4;166;61087
28;61;03;18;088;Champ-Haut;46;1;47;61088
28;61;03;21;089;Champosoult;96;0;96;61089
28;61;02;11;091;Champsecret;892;22;914;61091
28;61;03;01;092;Chandai;677;6;683;61092
28;61;02;11;093;Chanu;1259;17;1276;61093
28;61;02;13;094;La Chapelle-au-Moine;589;17;606;61094
28;61;02;13;095;La Chapelle-Biche;530;8;538;61095
28;61;01;07;096;Rives d'Andaine;3051;110;3161;61096
28;61;03;16;097;La Chapelle-Montligeon;517;15;532;61097
28;61;01;19;098;La Chapelle-près-Sées;448;31;479;61098
28;61;03;09;099;La Chapelle-SouÃ«f;247;8;255;61099
28;61;03;20;100;La Chapelle-Viel;282;17;299;61100
28;61;01;19;101;Le Château-d'Almenêches;202;9;211;61101
28;61;02;13;102;Le Châtellier;405;10;415;61102
28;61;03;21;103;Chaumont;173;1;174;61103
28;61;01;15;104;La Chaux;51;1;52;61104
28;61;03;09;105;Chemilli;186;7;193;61105
28;61;01;15;107;Ciral;393;11;404;61107
28;61;03;21;108;Cisai-Saint-Aubin;168;4;172;61108
28;61;01;10;111;Colombiers;329;13;342;61111
28;61;03;16;113;Comblot;63;1;64;61113
28;61;02;04;114;Commeaux;154;5;159;61114
28;61;03;08;116;Sablons sur Huisne;2058;40;2098;61116
28;61;01;10;117;Condé-sur-Sarthe;2490;48;2538;61117
28;61;03;16;118;Corbon;123;5;128;61118
28;61;02;05;120;Coudehard;75;0;75;61120
28;61;03;16;121;Coulimer;293;8;301;61121
28;61;03;21;122;Coulmer;83;6;89;61122
28;61;02;05;123;Coulonces;221;5;226;61123
28;61;02;12;124;La Coulonche;500;5;505;61124
28;61;01;17;126;Coulonges-sur-Sarthe;509;10;519;61126
28;61;03;16;129;Courgeon;366;11;377;61129
28;61;03;16;130;Courgeoût;458;13;471;61130
28;61;01;17;133;Courtomer;707;18;725;61133
28;61;02;06;137;Craménil;132;5;137;61137
28;61;03;21;138;Croisilles;209;4;213;61138
28;61;03;21;139;Crouttes;303;11;314;61139
28;61;03;20;140;Crulai;847;16;863;61140
28;61;01;10;141;Cuissai;410;17;427;61141
28;61;03;09;142;Dame-Marie;138;4;142;61142
28;61;01;10;143;Damigny;2464;63;2527;61143
28;61;02;11;145;Domfront en Poiraie;4196;124;4320;61145
28;61;02;12;146;Dompierre;398;5;403;61146
28;61;02;06;148;Durcet;299;11;310;61148
28;61;02;12;149;Echalou;387;8;395;61149
28;61;03;18;150;Echauffour;742;13;755;61150
28;61;03;18;151;Ecorcei;394;11;405;61151
28;61;02;05;152;Ecorches;98;0;98;61152
28;61;02;15;153;Ecouché-les-Vallées;2190;49;2239;61153
28;61;01;17;156;Essay;537;14;551;61156
28;61;02;06;158;Faverolles;148;2;150;61158
28;61;03;18;159;Fay;70;1;71;61159
28;61;03;16;160;Feings;186;5;191;61160
28;61;03;20;162;La Ferrière-au-Doyen;160;3;163;61162
28;61;02;12;163;La Ferrière-aux-Etangs;1545;22;1567;61163
28;61;01;19;164;La Ferrière-Béchet;241;2;243;61164
28;61;01;10;165;La Ferrière-Bochard;746;14;760;61165
28;61;01;17;166;Ferrières-la-Verrerie;141;3;144;61166
28;61;03;18;167;La Ferté-en-Ouche;3092;62;3154;61167
28;61;02;12;168;La Ferté Macé;5186;402;5588;61168
28;61;02;99;169;Flers;14762;364;15126;61169
28;61;02;15;170;Fleuré;196;3;199;61170
28;61;02;05;171;Fontaine-les-Bassets;103;1;104;61171
28;61;01;19;176;Francheville;143;2;145;61176
28;61;03;21;178;La Fresnaie-Fayel;54;2;56;61178
28;61;03;21;180;Fresnay-le-Samson;84;1;85;61180
28;61;03;21;181;Gacé;1811;59;1870;61181
28;61;01;10;182;Gandelain;418;5;423;61182
28;61;01;17;183;Gâprée;141;3;144;61183
28;61;03;20;187;Les Genettes;194;7;201;61187
28;61;03;18;188;La Genevraie;91;5;96;61188
28;61;02;06;189;Giel-Courteilles;458;216;674;61189
28;61;02;05;190;Ginai;74;1;75;61190
28;61;03;18;192;Godisson;107;3;110;61192
28;61;03;18;193;La Gonfrière;282;3;285;61193
28;61;02;15;194;Monts-sur-Orne;883;14;897;61194
28;61;02;06;195;Le Grais;192;4;196;61195
28;61;03;09;196;Belforêt-en-Perche;1565;51;1616;61196
28;61;02;05;197;Guêprei;135;4;139;61197
28;61;03;21;198;Guerquesalles;134;0;134;61198
28;61;02;06;199;Habloville;328;7;335;61199
28;61;01;17;202;Hauterive;464;11;475;61202
28;61;01;10;203;Héloup;902;26;928;61203
28;61;03;20;206;L'Hôme-Chamondot;252;4;256;61206
28;61;03;09;207;Igé;606;23;629;61207
28;61;03;20;208;Irai;617;15;632;61208
28;61;01;15;209;Joué-du-Bois;420;2;422;61209
28;61;02;15;210;Joué-du-Plain;248;9;257;61210
28;61;01;07;211;Juvigny Val d'Andaine;2162;54;2216;61211
28;61;02;04;212;Juvigny-sur-Orne;126;4;130;61212
28;61;01;10;213;Lalacelle;275;10;285;61213
28;61;03;01;214;L'Aigle;7961;239;8200;61214
28;61;01;17;215;Laleu;356;7;363;61215
28;61;01;15;216;La Lande-de-Goult;192;3;195;61216
28;61;02;15;217;La Lande-de-Lougé;53;1;54;61217
28;61;02;13;218;La Lande-Patry;1793;54;1847;61218
28;61;02;06;219;La Lande-Saint-Siméon;158;1;159;61219
28;61;02;14;221;Landigou;450;8;458;61221
28;61;02;13;222;Landisacq;759;20;779;61222
28;61;01;17;224;Larré;452;6;458;61224
28;61;03;18;225;Lignères;29;0;29;61225
28;61;02;06;227;Lignou;145;3;148;61227
28;61;01;15;228;L'Orée-d'Ecouves;770;16;786;61228
28;61;03;16;229;Loisail;126;4;130;61229
28;61;03;20;230;Longny les Villages;2985;50;3035;61230
28;61;02;11;232;Lonlay-l'Abbaye;1118;39;1157;61232
28;61;02;12;233;Lonlay-le-Tesson;228;7;235;61233
28;61;01;10;234;Lonrai;1129;37;1166;61234
28;61;02;15;237;Lougé-sur-Maire;316;1;317;61237
28;61;02;05;238;Louvières-en-Auge;88;1;89;61238
28;61;01;19;240;Macé;368;4;372;61240
28;61;03;08;241;La Madeleine-Bouvet;411;11;422;61241
28;61;03;20;242;Le Mage;223;10;233;61242
28;61;01;15;243;Magny-le-Désert;1388;43;1431;61243
28;61;03;18;244;Mahéru;269;12;281;61244
28;61;01;07;248;Mantilly;520;8;528;61248
28;61;01;17;251;Marchemaisons;155;6;161;61251
28;61;03;21;252;Mardilly;136;4;140;61252
28;61;03;16;255;Mauves-sur-Huisne;533;12;545;61255
28;61;01;19;256;Médavy;153;5;158;61256
28;61;01;15;257;Méhoudin;119;2;121;61257
28;61;01;17;258;Le Mêle-sur-Sarthe;670;11;681;61258
28;61;03;20;259;Le Ménil-Bérard;73;0;73;61259
28;61;02;06;260;Le Ménil-de-Briouze;539;10;549;61260
28;61;01;17;261;Le Ménil-Broût;169;3;172;61261
28;61;02;11;262;Le Ménil-Ciboult;112;1;113;61262
28;61;01;17;263;Ménil-Erreux;207;7;214;61263
28;61;03;18;264;Ménil-Froger;54;1;55;61264
28;61;02;06;265;Ménil-Gondouin;165;4;169;61265
28;61;01;17;266;Le Ménil-Guyon;76;0;76;61266
28;61;02;06;267;Ménil-Hermei;205;3;208;61267
28;61;03;21;268;Ménil-Hubert-en-Exmes;110;5;115;61268
28;61;02;06;269;Ménil-Hubert-sur-Orne;484;8;492;61269
28;61;01;15;271;Le Ménil-Scelleur;86;0;86;61271
28;61;03;18;272;Le Ménil-Vicomte;22;1;23;61272
28;61;02;06;273;Ménil-Vin;52;3;55;61273
28;61;03;20;274;Les Menus;238;6;244;61274
28;61;03;18;275;Le Merlerault;772;19;791;61275
28;61;02;05;276;Merri;156;6;162;61276
28;61;03;16;277;La Mesnière;281;6;287;61277
28;61;02;12;278;Messei;1854;54;1908;61278
28;61;01;10;279;Mieuxcé;611;15;626;61279
28;61;02;13;281;Moncy;255;7;262;61281
28;61;02;04;283;Montabard;283;9;292;61283
28;61;01;17;284;Montchevrel;222;2;224;61284
28;61;03;16;286;Montgaudry;79;0;79;61286
28;61;02;14;287;Montilly-sur-Noireau;720;19;739;61287
28;61;01;19;288;Montmerrei;519;7;526;61288
28;61;02;05;289;Mont-Ormel;50;0;50;61289
28;61;02;06;290;Montreuil-au-Houlme;131;4;135;61290
28;61;02;05;291;Montreuil-la-Cambe;63;0;63;61291
28;61;02;11;292;Montsecret-Clairefougère;654;9;663;61292
28;61;03;16;293;Mortagne-au-Perche;3775;296;4071;61293
28;61;01;19;294;Mortrée;1153;27;1180;61294
28;61;01;15;295;La Motte-Fouquet;162;2;164;61295
28;61;03;20;297;Moulins-la-Marche;732;10;742;61297
28;61;02;04;298;Moulins-sur-Orne;314;11;325;61298
28;61;03;08;300;Moutiers-au-Perche;383;8;391;61300
28;61;01;19;301;Neauphe-sous-Essai;212;1;213;61301
28;61;02;05;302;Neauphe-sur-Dive;136;3;139;61302
28;61;02;04;303;Nécy;517;13;530;61303
28;61;01;17;304;Neuilly-le-Bisson;301;6;307;61304
28;61;03;21;307;Neuville-sur-Touques;227;2;229;61307
28;61;02;06;308;Neuvy-au-Houlme;206;4;210;61308
28;61;03;08;309;Perche en Nocé;2022;63;2085;61309
28;61;03;18;310;Nonant-le-Pin;446;30;476;61310
28;61;02;04;314;Occagnes;669;17;686;61314
28;61;02;05;316;Ommoy;115;3;118;61316
28;61;03;21;317;Orgères;179;5;184;61317
28;61;03;09;319;Origny-le-Roux;263;7;270;61319
28;61;01;10;321;Pacé;420;6;426;61321
28;61;03;16;322;Parfondeval;108;2;110;61322
28;61;03;20;323;Le Pas-Saint-l'Homer;128;2;130;61323
28;61;01;07;324;Passais Villages;1162;14;1176;61324
28;61;01;07;326;Perrou;308;6;314;61326
28;61;03;16;327;Pervenchères;341;11;352;61327
28;61;02;05;328;Le Pin-au-Haras;268;5;273;61328
28;61;03;16;329;Le Pin-la-Garenne;639;11;650;61329
28;61;03;18;330;Planches;185;3;188;61330
28;61;01;17;331;Le Plantis;137;2;139;61331
28;61;02;06;332;Pointel;315;43;358;61332
28;61;03;21;333;Pontchardon;174;4;178;61333
28;61;03;09;336;Pouvrai;103;7;110;61336
28;61;02;06;339;Putanges-le-Lac;2140;32;2172;61339
28;61;01;17;341;Ecouves;1647;55;1702;61341
28;61;03;18;342;Rai;1406;30;1436;61342
28;61;02;15;344;Rânes;1036;13;1049;61344
28;61;03;08;345;Rémalard en Perche;1903;42;1945;61345
28;61;03;21;346;Le Renouard;203;6;209;61346
28;61;03;21;347;Résenlieu;176;0;176;61347
28;61;03;16;348;Réveillon;372;6;378;61348
28;61;02;04;349;Ri;161;3;164;61349
28;61;01;10;350;La Roche-Mabile;160;8;168;61350
28;61;03;21;351;Roiville;133;4;137;61351
28;61;02;04;352;Rônai;175;5;180;61352
28;61;01;15;357;Rouperroux;200;3;203;61357
28;61;02;04;358;Sai;225;5;230;61358
28;61;01;17;360;Saint-Agnan-sur-Sarthe;91;2;93;61360
28;61;02;06;361;Saint-André-de-Briouze;173;6;179;61361
28;61;02;12;362;Saint-André-de-Messei;543;19;562;61362
28;61;03;16;363;Saint-Aquilin-de-Corbion;58;2;60;61363
28;61;01;17;365;Saint-Aubin-d'Appenai;406;9;415;61365
28;61;03;21;366;Saint-Aubin-de-Bonneval;134;2;136;61366
28;61;03;16;367;Saint-Aubin-de-Courteraie;131;2;133;61367
28;61;02;11;369;Saint-Bômer-les-Forges;1026;37;1063;61369
28;61;02;11;370;Saint-Brice;150;2;152;61370
28;61;02;15;371;Saint-Brice-sous-Rânes;135;2;137;61371
28;61;01;10;372;Saint-Céneri-le-Gérei;115;4;119;61372
28;61;03;16;373;Sainte-Céronne-lès-Mortagne;245;8;253;61373
28;61;02;11;374;Saint-Christophe-de-Chaulieu;96;4;100;61374
28;61;02;04;375;Boischampré;1190;36;1226;61375
28;61;02;13;376;Saint-Clair-de-Halouze;864;18;882;61376
28;61;03;08;379;Saint-Cyr-la-Rosière;233;5;238;61379
28;61;03;16;381;Saint-Denis-sur-Huisne;59;5;64;61381
28;61;01;10;382;Saint-Denis-sur-Sarthon;1128;19;1147;61382
28;61;01;15;384;Saint-Ellier-les-Bois;256;2;258;61384
28;61;03;21;385;Saint-Evroult-de-Montfort;338;8;346;61385
28;61;03;18;386;Saint-Evroult-Notre-Dame-du-Bois;442;31;473;61386
28;61;01;07;387;Saint-Fraimbault;539;18;557;61387
28;61;03;09;388;Saint-Fulgent-des-Ormes;157;2;159;61388
28;61;03;18;389;Sainte-Gauburge-Sainte-Colombe;1041;23;1064;61389
28;61;02;15;390;Saint-Georges-d'Annebecq;158;1;159;61390
28;61;02;14;391;Saint-Georges-des-Groseillers;3152;113;3265;61391
28;61;03;21;392;Saint-Germain-d'Aunay;142;4;146;61392
28;61;03;18;393;Saint-Germain-de-Clairefeuille;135;5;140;61393
28;61;03;09;394;Saint-Germain-de-la-Coudre;797;20;817;61394
28;61;03;08;395;Saint-Germain-des-Grois;238;7;245;61395
28;61;03;16;396;Saint-Germain-de-Martigny;80;5;85;61396
28;61;01;03;397;Saint-Germain-du-Corbéis;3780;132;3912;61397
28;61;01;17;398;Saint-Germain-le-Vieux;59;1;60;61398
28;61;02;05;399;Saint-Gervais-des-Sablons;73;3;76;61399
28;61;01;19;400;Saint-Gervais-du-Perron;361;7;368;61400
28;61;02;11;401;Saint-Gilles-des-Marais;106;4;110;61401
28;61;02;06;402;Saint-Hilaire-de-Briouze;307;8;315;61402
28;61;03;16;404;Saint-Hilaire-le-Châtel;629;21;650;61404
28;61;03;09;405;Saint-Hilaire-sur-Erre;531;12;543;61405
28;61;03;20;406;Saint-Hilaire-sur-Risle;316;5;321;61406
28;61;02;06;407;Sainte-Honorine-la-Chardonne;698;13;711;61407
28;61;02;06;408;Sainte-Honorine-la-Guillaume;329;9;338;61408
28;61;03;16;411;Saint-Jouin-de-Blavou;280;11;291;61411
28;61;01;17;412;Saint-Julien-sur-Sarthe;676;15;691;61412
28;61;02;05;413;Saint-Lambert-sur-Dive;138;4;142;61413
28;61;03;16;414;Saint-Langis-lès-Mortagne;888;21;909;61414
28;61;01;17;415;Saint-Léger-sur-Sarthe;319;6;325;61415
28;61;01;17;416;Saint-Léonard-des-Parcs;77;1;78;61416
28;61;03;16;418;Saint-Mard-de-Réno;417;11;428;61418
28;61;01;15;419;Sainte-Marguerite-de-Carrouges;216;7;223;61419
28;61;01;15;420;Sainte-Marie-la-Robert;88;1;89;61420
28;61;01;07;421;Saint-Mars-d'Egrenne;661;18;679;61421
28;61;03;20;422;Les Aspres;617;15;632;61422
28;61;03;01;423;Saint-Martin-d'Ecublei;642;27;669;61423
28;61;01;15;424;Saint-Martin-des-Landes;199;4;203;61424
28;61;03;16;425;Saint-Martin-des-Pézerits;145;2;147;61425
28;61;03;09;426;Saint-Martin-du-Vieux-Bellême;562;17;579;61426
28;61;01;15;427;Saint-Martin-l'Aiguillon;194;4;198;61427
28;61;03;20;429;Charencey;784;16;800;61429
28;61;03;01;432;Saint-Michel-TubÅ“uf;607;22;629;61432
28;61;01;10;433;Saint-Nicolas-des-Bois;284;8;292;61433
28;61;03;18;435;Saint-Nicolas-de-Sommaire;272;4;276;61435
28;61;02;06;436;Sainte-Opportune;235;2;237;61436
28;61;03;16;438;Saint-Ouen-de-Sécherouvre;174;5;179;61438
28;61;01;15;439;Saint-Ouen-le-Brisoult;121;4;125;61439
28;61;03;01;440;Saint-Ouen-sur-Iton;828;35;863;61440
28;61;01;15;442;Saint-Patrice-du-Désert;218;6;224;61442
28;61;02;13;443;Saint-Paul;689;15;704;61443
28;61;02;06;444;Saint-Philbert-sur-Orne;119;3;122;61444
28;61;02;13;445;Saint-Pierre-d'Entremont;668;10;678;61445
28;61;03;18;446;Saint-Pierre-des-Loges;155;5;160;61446
28;61;02;14;447;Saint-Pierre-du-Regard;1404;20;1424;61447
28;61;03;08;448;Saint-Pierre-la-Bruyère;431;6;437;61448
28;61;01;17;450;Saint-Quentin-de-Blavou;72;1;73;61450
28;61;02;11;451;Saint-Quentin-les-Chardonnets;311;6;317;61451
28;61;01;07;452;Saint-Roch-sur-Egrenne;175;0;175;61452
28;61;01;15;453;Saint-Sauveur-de-Carrouges;245;7;252;61453
28;61;01;17;454;Sainte-Scolasse-sur-Sarthe;598;16;614;61454
28;61;03;01;456;Saint-Sulpice-sur-Risle;1670;49;1719;61456
28;61;03;18;457;Saint-Symphorien-des-Bruyères;479;8;487;61457
28;61;02;12;459;Saires-la-Verrerie;308;6;314;61459
28;61;03;21;460;Sap-en-Auge;960;10;970;61460
28;61;03;21;461;Le Sap-André;127;3;130;61461
28;61;02;04;462;Sarceaux;1039;34;1073;61462
28;61;02;12;463;Les Monts d'Andaine;1726;34;1760;61463
28;61;01;19;464;Sées;4198;444;4642;61464
28;61;02;14;466;La Selle-la-Forge;1478;39;1517;61466
28;61;01;17;467;Semallé;338;11;349;61467
28;61;02;04;472;Sévigny;305;12;317;61472
28;61;02;15;473;Sevrai;267;6;273;61473
28;61;02;05;474;Gouffern en Auge;3700;80;3780;61474
28;61;03;16;475;Soligny-la-Trappe;668;15;683;61475
28;61;03;09;476;Suré;276;5;281;61476
28;61;02;15;479;Tanques;157;4;161;61479
28;61;01;19;480;Tanville;232;5;237;61480
28;61;01;17;481;Tellières-le-Plessis;75;3;78;61481
28;61;01;07;482;Tessé-Froulay;381;9;390;61482
28;61;01;07;483;Bagnoles de l'Orne Normandie;2732;51;2783;61483
28;61;03;09;484;Val-au-Perche;3432;73;3505;61484
28;61;03;21;485;Ticheville;198;7;205;61485
28;61;02;11;486;Tinchebray-Bocage;4882;87;4969;61486
28;61;01;07;487;Torchamp;299;4;303;61487
28;61;03;18;488;Touquettes;90;2;92;61488
28;61;02;05;490;Tournai-sur-Dive;302;1;303;61490
28;61;03;20;491;Tourouvre au Perche;3092;50;3142;61491
28;61;01;17;492;Trémont;119;4;123;61492
28;61;03;21;493;La Trinité-des-Laitiers;60;5;65;61493
28;61;02;05;494;Trun;1235;66;1301;61494
28;61;01;10;497;Valframbert;1768;29;1797;61497
28;61;03;09;498;Vaunoise;101;4;105;61498
28;61;01;17;499;Les Ventes-de-Bourse;146;3;149;61499
28;61;03;20;500;La Ventrouze;124;4;128;61500
28;61;03;08;501;Verrières;423;5;428;61501
28;61;01;17;502;Vidai;99;0;99;61502
28;61;02;15;503;Vieux-Pont;196;4;200;61503
28;61;02;05;505;Villedieu-lès-Bailleul;214;6;220;61505
28;61;03;16;507;Villiers-sous-Mortagne;282;5;287;61507
28;61;03;21;508;Vimoutiers;3116;87;3203;61508
28;61;03;01;510;Vitrai-sous-Laigle;231;4;235;61510
28;61;02;06;512;Les Yveteaux;106;3;109;61512
32;62;07;17;001;Ablain-Saint-Nazaire;1877;38;1915;62001
32;62;01;09;002;Ablainzevelle;229;3;232;62002
32;62;07;08;003;Acheville;604;22;626;62003
32;62;01;04;004;Achicourt;7957;108;8065;62004
32;62;01;09;005;Achiet-le-Grand;971;5;976;62005
32;62;01;09;006;Achiet-le-Petit;311;5;316;62006
32;62;01;02;007;Acq;798;5;803;62007
32;62;05;33;008;Acquin-Westbécourt;808;11;819;62008
32;62;01;07;009;Adinfer;274;7;281;62009
32;62;05;33;010;Affringues;250;0;250;62010
32;62;01;07;011;Agnez-lès-Duisans;654;16;670;62011
32;62;01;07;012;Agnières;255;4;259;62012
32;62;01;04;013;Agny;1899;35;1934;62013
32;62;05;01;014;Aire-sur-la-Lys;9691;265;9956;62014
32;62;04;10;015;Airon-Notre-Dame;238;2;240;62015
32;62;04;10;016;Airon-Saint-Vaast;190;5;195;62016
32;62;04;33;017;Aix-en-Ergny;203;1;204;62017
32;62;04;06;018;Aix-en-Issart;267;5;272;62018
32;62;07;17;019;Aix-Noulette;3923;42;3965;62019
32;62;06;19;020;Alembon;624;11;635;62020
32;62;04;33;021;Alette;383;1;384;62021
32;62;03;22;022;Alincthun;314;10;324;62022
32;62;02;31;023;Allouagne;2890;30;2920;62023
32;62;05;33;024;Alquines;984;12;996;62024
32;62;03;22;025;Ambleteuse;1946;30;1976;62025
32;62;04;25;026;Ambricourt;117;9;126;62026
32;62;01;07;027;Ambrines;221;0;221;62027
32;62;02;31;028;Ames;628;8;636;62028
32;62;02;31;029;Amettes;467;1;468;62029
32;62;01;07;030;Amplier;300;4;304;62030
32;62;06;19;031;Andres;1554;23;1577;62031
32;62;07;17;032;Angres;4698;57;4755;62032
32;62;07;29;033;Annay;4377;25;4402;62033
32;62;02;23;034;Annequin;2143;14;2157;62034
32;62;02;11;035;Annezin;5836;46;5882;62035
32;62;01;38;036;Anvin;748;17;765;62036
32;62;01;02;037;Anzin-Saint-Aubin;2751;87;2838;62037
32;62;06;19;038;Ardres;4403;47;4450;62038
32;62;01;15;039;Arleux-en-Gohelle;862;17;879;62039
32;62;05;32;040;Arques;9584;127;9711;62040
32;62;01;96;041;Arras;41694;788;42482;62041
32;62;01;03;042;Athies;1045;13;1058;62042
32;62;06;19;043;Les Attaques;2027;28;2055;62043
32;62;04;10;044;Attin;784;8;792;62044
32;62;01;07;045;Aubigny-en-Artois;1472;19;1491;62045
32;62;04;06;046;Aubin-Saint-Vaast;742;6;748;62046
32;62;01;38;047;Aubrometz;151;1;152;62047
32;62;02;05;048;Auchel;10272;44;10316;62048
32;62;02;31;049;Auchy-au-Bois;530;2;532;62049
32;62;04;06;050;Auchy-lès-Hesdin;1562;16;1578;62050
32;62;02;23;051;Auchy-les-Mines;4678;32;4710;62051
32;62;03;22;052;Audembert;454;13;467;62052
32;62;05;25;053;Audincthun;662;6;668;62053
32;62;03;22;054;Audinghen;588;7;595;62054
32;62;05;33;055;Audrehem;534;8;542;62055
32;62;03;22;056;Audresselles;634;5;639;62056
32;62;06;34;057;Audruicq;5434;53;5487;62057
32;62;01;38;058;Aumerval;199;5;204;62058
32;62;06;19;059;Autingues;289;14;303;62059
32;62;01;06;060;Auxi-le-Château;2572;24;2596;62060
32;62;01;38;061;Averdoingt;292;7;299;62061
32;62;04;33;062;Avesnes;54;1;55;62062
32;62;01;07;063;Avesnes-le-Comte;1833;31;1864;62063
32;62;01;09;064;Avesnes-lès-Bapaume;166;2;168;62064
32;62;07;08;065;Avion;17625;139;17764;62065
32;62;04;25;066;Avondance;35;2;37;62066
32;62;05;25;067;Avroult;619;4;623;62067
32;62;01;09;068;Ayette;325;7;332;62068
32;62;04;06;069;Azincourt;310;8;318;62069
32;62;01;07;070;Bailleul-aux-Cornailles;260;5;265;62070
32;62;01;38;071;Bailleul-lès-Pernes;405;7;412;62071
32;62;01;07;072;Bailleulmont;227;3;230;62072
32;62;01;03;073;Bailleul-Sir-Berthoult;1423;25;1448;62073
32;62;01;07;074;Bailleulval;232;8;240;62074
32;62;03;14;075;Baincthun;1294;30;1324;62075
32;62;06;19;076;Bainghen;218;1;219;62076
32;62;02;16;077;Bajus;366;6;372;62077
32;62;06;19;078;Balinghem;1227;10;1237;62078
32;62;01;09;079;Bancourt;88;0;88;62079
32;62;01;09;080;Bapaume;3748;319;4067;62080
32;62;01;09;081;Baralle;477;10;487;62081
32;62;01;09;082;Barastre;312;4;316;62082
32;62;02;35;083;Barlin;7544;44;7588;62083
32;62;01;07;084;Barly;212;8;220;62084
32;62;01;07;085;Basseux;135;5;140;62085
32;62;01;07;086;Bavincourt;385;7;392;62086
32;62;05;37;087;Bayenghem-lès-Eperlecques;1002;22;1024;62087
32;62;05;33;088;Bayenghem-lès-Seninghem;328;6;334;62088
32;62;03;22;089;Bazinghen;394;13;407;62089
32;62;04;06;090;Béalencourt;129;5;134;62090
32;62;01;07;091;Beaudricourt;87;1;88;62091
32;62;01;07;092;Beaufort-Blavincourt;403;3;406;62092
32;62;01;09;093;Beaulencourt;229;0;229;62093
32;62;04;10;094;Beaumerie-Saint-Martin;409;4;413;62094
32;62;05;25;095;Beaumetz-lès-Aire;241;1;242;62095
32;62;01;09;096;Beaumetz-lès-Cambrai;571;3;574;62096
32;62;01;02;097;Beaumetz-lès-Loges;1002;14;1016;62097
32;62;01;04;099;Beaurains;5552;62;5614;62099
32;62;04;06;100;Beaurainville;2089;27;2116;62100
32;62;01;38;101;Beauvois;138;1;139;62101
32;62;04;33;102;Bécourt;275;3;278;62102
32;62;01;09;103;Béhagnies;130;2;132;62103
32;62;03;22;104;Bellebrune;432;7;439;62104
32;62;03;22;105;Belle-et-Houllefort;566;16;582;62105
32;62;01;15;106;Bellonne;203;6;209;62106
32;62;07;39;107;Bénifontaine;356;9;365;62107
32;62;04;10;108;Berck;13482;331;13813;62108
32;62;01;38;109;Bergueneuse;220;1;221;62109
32;62;01;07;111;Berlencourt-le-Cauroy;283;79;362;62111
32;62;01;07;112;Berles-au-Bois;516;8;524;62112
32;62;01;07;113;Berles-Monchel;487;12;499;62113
32;62;01;38;114;Bermicourt;168;4;172;62114
32;62;01;07;115;Berneville;467;18;485;62115
32;62;04;10;116;Bernieulles;184;1;185;62116
32;62;01;09;117;Bertincourt;916;14;930;62117
32;62;01;07;118;Béthonsart;143;4;147;62118
32;62;02;11;119;Béthune;25039;349;25388;62119
32;62;02;16;120;Beugin;467;8;475;62120
32;62;01;09;121;Beugnâtre;173;4;177;62121
32;62;01;09;122;Beugny;357;4;361;62122
32;62;04;33;123;Beussent;539;4;543;62123
32;62;04;10;124;Beutin;453;5;458;62124
32;62;03;22;125;Beuvrequen;460;14;474;62125
32;62;02;12;126;Beuvry;9219;160;9379;62126
32;62;04;33;127;Bezinghem;388;11;399;62127
32;62;01;15;128;Biache-Saint-Vaast;4305;47;4352;62128
32;62;01;09;129;Biefvillers-lès-Bapaume;97;2;99;62129
32;62;01;07;130;Bienvillers-au-Bois;651;13;664;62130
32;62;01;09;131;Bihucourt;343;3;346;62131
32;62;02;23;132;Billy-Berclau;4885;40;4925;62132
32;62;07;26;133;Billy-Montigny;8177;41;8218;62133
32;62;04;33;134;Bimont;111;2;113;62134
32;62;01;07;135;Blairville;307;3;310;62135
32;62;01;38;137;Blangerval-Blangermont;98;1;99;62137
32;62;04;06;138;Blangy-sur-Ternoise;716;13;729;62138
32;62;05;32;139;Blendecques;4944;133;5077;62139
32;62;05;33;140;Bléquin;501;5;506;62140
32;62;02;01;141;Blessy;877;13;890;62141
32;62;04;06;142;Blingel;160;7;167;62142
32;62;01;06;143;Boffles;49;1;50;62143
32;62;01;04;144;Boiry-Becquerelle;465;7;472;62144
32;62;01;15;145;Boiry-Notre-Dame;444;6;450;62145
32;62;01;07;146;Boiry-Saint-Martin;274;0;274;62146
32;62;01;07;147;Boiry-Sainte-Rictrude;410;5;415;62147
32;62;07;26;148;Bois-Bernard;819;9;828;62148
32;62;05;33;149;Boisdinghem;245;8;253;62149
32;62;04;06;150;Boisjean;499;7;506;62150
32;62;01;04;151;Boisleux-au-Mont;512;10;522;62151
32;62;01;04;152;Boisleux-Saint-Marc;244;3;247;62152
32;62;05;25;153;Bomy;645;7;652;62153
32;62;01;38;154;Bonnières;676;14;690;62154
32;62;05;33;155;Bonningues-lès-Ardres;639;14;653;62155
32;62;06;18;156;Bonningues-lès-Calais;559;13;572;62156
32;62;04;06;157;Boubers-lès-Hesmond;79;3;82;62157
32;62;01;38;158;Boubers-sur-Canche;582;13;595;62158
32;62;03;97;160;Boulogne-sur-Mer;40251;436;40687;62160
32;62;06;19;161;Bouquehault;786;5;791;62161
32;62;02;31;162;Bourecq;606;6;612;62162
32;62;01;38;163;Bouret-sur-Canche;248;3;251;62163
32;62;01;09;164;Bourlon;1141;18;1159;62164
32;62;03;22;165;Bournonville;233;5;238;62165
32;62;01;38;166;Bours;624;7;631;62166
32;62;06;19;167;Boursin;253;4;257;62167
32;62;04;33;168;Bourthes;845;12;857;62168
32;62;05;33;169;Bouvelinghem;238;6;244;62169
32;62;07;17;170;Bouvigny-Boyeffles;2372;93;2465;62170
32;62;01;38;171;Boyaval;131;2;133;62171
32;62;01;04;172;Boyelles;360;3;363;62172
32;62;01;15;173;Brebières;5088;63;5151;62173
32;62;06;19;174;Brêmes;1290;13;1303;62174
32;62;04;06;175;Brévillers;159;5;164;62175
32;62;04;24;176;Bréxent-Enocq;655;18;673;62176
32;62;04;06;177;Brimeux;855;22;877;62177
32;62;02;16;178;Bruay-la-Buissière;21903;367;22270;62178
32;62;03;22;179;Brunembert;412;7;419;62179
32;62;01;38;180;Brias;291;6;297;62180
32;62;01;09;181;Bucquoy;1445;90;1535;62181
32;62;01;06;182;Buire-au-Bois;235;7;242;62182
32;62;04;06;183;Buire-le-Sec;765;4;769;62183
32;62;01;09;184;Buissy;282;3;285;62184
32;62;01;09;185;Bullecourt;235;1;236;62185
32;62;07;17;186;Bully-les-Mines;12156;77;12233;62186
32;62;01;38;187;Buneville;183;2;185;62187
32;62;02;31;188;Burbure;2833;31;2864;62188
32;62;01;09;189;Bus;133;2;135;62189
32;62;02;31;190;Busnes;1257;19;1276;62190
32;62;06;19;191;Caffiers;732;3;735;62191
32;62;01;15;192;Cagnicourt;431;7;438;62192
32;62;06;98;193;Calais;72509;625;73134;62193
32;62;02;05;194;Calonne-Ricouart;5507;33;5540;62194
32;62;02;31;195;Calonne-sur-la-Lys;1540;20;1560;62195
32;62;04;10;196;La Calotterie;614;11;625;62196
32;62;02;05;197;Camblain-Châtelain;1779;16;1795;62197
32;62;01;07;198;Cambligneul;342;10;352;62198
32;62;01;07;199;Camblain-l'Abbé;663;126;789;62199
32;62;02;23;200;Cambrin;1229;13;1242;62200
32;62;04;24;201;Camiers;2730;40;2770;62201
32;62;04;33;202;Campagne-lès-Boulonnais;667;98;765;62202
32;62;06;19;203;Campagne-lès-Guines;449;11;460;62203
32;62;04;06;204;Campagne-lès-Hesdin;1942;37;1979;62204
32;62;05;32;205;Campagne-lès-Wardrecques;1273;27;1300;62205
32;62;04;10;206;Campigneulles-les-Grandes;289;15;304;62206
32;62;04;10;207;Campigneulles-les-Petites;551;22;573;62207
32;62;01;07;208;Canettemont;71;2;73;62208
32;62;04;25;209;Canlers;154;10;164;62209
32;62;01;07;211;Capelle-Fermont;220;4;224;62211
32;62;04;06;212;Capelle-lès-Hesdin;505;11;516;62212
32;62;07;17;213;Carency;780;11;791;62213
32;62;03;22;214;Carly;588;11;599;62214
32;62;07;21;215;Carvin;17557;103;17660;62215
32;62;01;07;216;La Cauchie;207;2;209;62216
32;62;02;05;217;Cauchy-Ã -la-Tour;2744;15;2759;62217
32;62;02;16;218;Caucourt;337;8;345;62218
32;62;04;06;219;Caumont;159;4;163;62219
32;62;04;06;220;Cavron-Saint-Martin;449;6;455;62220
32;62;01;07;221;Chelers;249;5;254;62221
32;62;04;06;222;Chériennes;159;2;161;62222
32;62;01;09;223;Chérisy;291;5;296;62223
32;62;02;11;224;Chocques;2831;27;2858;62224
32;62;05;37;225;Clairmarais;606;11;617;62225
32;62;04;33;227;Clenleu;188;2;190;62227
32;62;05;33;228;Clerques;327;3;330;62228
32;62;05;33;229;Cléty;793;16;809;62229
32;62;03;22;230;Colembert;971;13;984;62230
32;62;04;10;231;Colline-Beaumont;131;0;131;62231
32;62;02;16;232;La Comté;904;15;919;62232
32;62;04;10;233;Conchil-le-Temple;1125;14;1139;62233
32;62;01;38;234;Conchy-sur-Canche;222;4;226;62234
32;62;03;36;235;Condette;2485;89;2574;62235
32;62;04;06;236;Contes;341;9;350;62236
32;62;03;13;237;Conteville-lès-Boulogne;505;10;515;62237
32;62;01;38;238;Conteville-en-Ternois;84;1;85;62238
32;62;06;18;239;Coquelles;2602;34;2636;62239
32;62;01;15;240;Corbehem;2302;17;2319;62240
32;62;04;24;241;Cormont;310;5;315;62241
32;62;01;07;242;Couin;96;5;101;62242
32;62;01;07;243;Coullemont;125;3;128;62243
32;62;06;19;244;Coulogne;5430;206;5636;62244
32;62;05;33;245;Coulomby;760;7;767;62245
32;62;04;25;246;Coupelle-Neuve;154;0;154;62246
32;62;04;25;247;Coupelle-Vieille;604;11;615;62247
32;62;01;09;248;Courcelles-le-Comte;469;6;475;62248
32;62;07;28;249;Courcelles-lès-Lens;8104;39;8143;62249
32;62;07;21;250;Courrières;10554;96;10650;62250
32;62;03;22;251;Courset;512;191;703;62251
32;62;02;12;252;La Couture;2677;71;2748;62252
32;62;01;07;253;Couturelle;71;0;71;62253
32;62;05;25;254;Coyecques;602;15;617;62254
32;62;03;22;255;Crémarest;793;15;808;62255
32;62;04;25;256;Crépy;152;2;154;62256
32;62;04;25;257;Créquy;470;10;480;62257
32;62;01;38;258;Croisette;266;5;271;62258
32;62;01;09;259;Croisilles;1970;24;1994;62259
32;62;01;38;260;Croix-en-Ternois;330;3;333;62260
32;62;04;24;261;Cucq;5059;93;5152;62261
32;62;02;23;262;Cuinchy;1746;23;1769;62262
32;62;01;02;263;Dainville;5681;112;5793;62263
32;62;03;36;264;Dannes;1346;4;1350;62264
32;62;05;25;265;Delettes;1183;16;1199;62265
32;62;01;07;266;Denier;89;2;91;62266
32;62;05;25;267;DennebrÅ“ucq;395;6;401;62267
32;62;03;22;268;Desvres;4875;39;4914;62268
32;62;02;05;269;Diéval;733;11;744;62269
32;62;02;05;270;Divion;6963;40;7003;62270
32;62;05;33;271;Dohem;834;17;851;62271
32;62;01;09;272;Douchy-lès-Ayette;311;2;313;62272
32;62;03;22;273;Doudeauville;618;9;627;62273
32;62;07;27;274;Dourges;5928;44;5972;62274
32;62;04;06;275;Douriez;303;7;310;62275
32;62;02;23;276;Douvrin;5680;46;5726;62276
32;62;07;28;277;Drocourt;2926;12;2938;62277
32;62;02;35;278;Drouvin-le-Marais;615;19;634;62278
32;62;01;07;279;Duisans;1347;125;1472;62279
32;62;01;15;280;Dury;329;2;331;62280
32;62;03;14;281;Echinghen;387;6;393;62281
32;62;04;06;282;Eclimeux;180;0;180;62282
32;62;01;38;283;Ecoivres;134;0;134;62283
32;62;01;09;284;Ecourt-Saint-Quentin;1685;19;1704;62284
32;62;01;09;285;Ecoust-Saint-Mein;492;9;501;62285
32;62;02;31;286;Ecquedecques;506;4;510;62286
32;62;05;25;288;Ecques;2165;44;2209;62288
32;62;04;10;289;Ecuires;704;21;725;62289
32;62;01;02;290;Ecurie;381;7;388;62290
32;62;07;30;291;Eleu-dit-Leauwette;2840;31;2871;62291
32;62;05;33;292;Elnes;876;15;891;62292
32;62;04;25;293;Embry;234;5;239;62293
32;62;05;25;295;Enquin-lez-Guinegatte;1623;27;1650;62295
32;62;04;33;296;Enquin-sur-Baillons;281;2;283;62296
32;62;05;37;297;Eperlecques;3696;46;3742;62297
32;62;01;09;298;Epinoy;548;10;558;62298
32;62;01;38;299;Eps;248;5;253;62299
32;62;03;36;300;Equihen-Plage;2662;35;2697;62300
32;62;01;38;301;Equirre;80;1;81;62301
32;62;04;33;302;Ergny;234;2;236;62302
32;62;01;38;303;Erin;245;6;251;62303
32;62;05;25;304;Erny-Saint-Julien;332;2;334;62304
32;62;01;09;306;Ervillers;392;3;395;62306
32;62;06;18;307;Escalles;217;9;226;62307
32;62;05;33;308;EscÅ“uilles;476;10;486;62308
32;62;05;33;309;Esquerdes;1632;21;1653;62309
32;62;02;12;310;Essars;1755;19;1774;62310
32;62;07;39;311;Estevelles;2039;10;2049;62311
32;62;04;10;312;Estrée;292;6;298;62312
32;62;02;01;313;Estrée-Blanche;917;6;923;62313
32;62;02;16;314;Estrée-Cauchy;364;2;366;62314
32;62;04;10;315;Estréelles;348;9;357;62315
32;62;01;07;316;Estrée-Wamin;196;6;202;62316
32;62;01;15;317;Etaing;454;3;457;62317
32;62;04;24;318;Etaples;10912;113;11025;62318
32;62;01;15;319;Eterpigny;258;3;261;62319
32;62;01;02;320;Etrun;311;8;319;62320
32;62;07;28;321;Evin-Malmaison;4625;26;4651;62321
32;62;01;07;322;Famechon;114;1;115;62322
32;62;01;03;323;Fampoux;1203;21;1224;62323
32;62;01;03;324;Farbus;590;14;604;62324
32;62;05;25;325;Fauquembergues;961;20;981;62325
32;62;01;09;326;Favreuil;244;5;249;62326
32;62;05;25;327;Febvin-Palfart;609;4;613;62327
32;62;02;31;328;Ferfay;909;10;919;62328
32;62;03;22;329;Ferques;1768;20;1788;62329
32;62;02;23;330;Festubert;1283;24;1307;62330
32;62;01;03;331;Feuchy;1024;20;1044;62331
32;62;01;07;332;Ficheux;508;10;518;62332
32;62;01;38;333;Fiefs;387;6;393;62333
32;62;06;19;334;Fiennes;868;16;884;62334
32;62;04;06;335;Fillièvres;516;5;521;62335
32;62;05;25;336;Fléchin;480;7;487;62336
32;62;01;38;337;Flers;222;5;227;62337
32;62;02;12;338;Fleurbaix;2698;55;2753;62338
32;62;01;38;339;Fleury;111;1;112;62339
32;62;01;38;340;Floringhem;883;7;890;62340
32;62;01;07;341;Foncquevillers;420;8;428;62341
32;62;01;38;342;Fontaine-lès-Boulans;105;1;106;62342
32;62;01;09;343;Fontaine-lès-Croisilles;265;2;267;62343
32;62;01;38;344;Fontaine-lès-Hermans;108;3;111;62344
32;62;01;06;345;Fontaine-l'Etalon;99;1;100;62345
32;62;01;38;346;Fortel-en-Artois;214;4;218;62346
32;62;01;07;347;Fosseux;129;3;132;62347
32;62;01;38;348;Foufflin-Ricametz;165;2;167;62348
32;62;02;35;349;Fouquereuil;1609;23;1632;62349
32;62;02;35;350;Fouquières-lès-Béthune;1131;20;1151;62350
32;62;07;26;351;Fouquières-lès-Lens;6434;38;6472;62351
32;62;01;38;352;Framecourt;106;2;108;62352
32;62;01;09;353;Frémicourt;236;6;242;62353
32;62;04;24;354;Frencq;870;17;887;62354
32;62;01;15;355;Fresnes-lès-Montauban;581;5;586;62355
32;62;02;16;356;Fresnicourt-le-Dolmen;797;8;805;62356
32;62;04;06;357;Fresnoy;71;1;72;62357
32;62;01;15;358;Fresnoy-en-Gohelle;228;6;234;62358
32;62;04;25;359;Fressin;580;13;593;62359
32;62;06;18;360;Fréthun;1389;14;1403;62360
32;62;01;38;361;Frévent;3423;56;3479;62361
32;62;01;07;362;Frévillers;240;3;243;62362
32;62;01;07;363;Frévin-Capelle;382;9;391;62363
32;62;04;25;364;Fruges;2352;242;2594;62364
32;62;04;06;365;Galametz;201;0;201;62365
32;62;02;16;366;Gauchin-Légal;312;7;319;62366
32;62;01;38;367;Gauchin-Verloingt;830;37;867;62367
32;62;01;07;368;Gaudiempré;203;0;203;62368
32;62;01;03;369;Gavrelle;784;17;801;62369
32;62;01;06;370;Gennes-Ivergny;125;1;126;62370
32;62;07;30;371;Givenchy-en-Gohelle;2030;45;2075;62371
32;62;01;07;372;Givenchy-le-Noble;150;3;153;62372
32;62;02;23;373;Givenchy-lès-la-Bassée;1040;11;1051;62373
32;62;01;09;374;Gomiécourt;153;8;161;62374
32;62;01;07;375;Gommecourt;91;1;92;62375
32;62;02;31;376;Gonnehem;2508;38;2546;62376
32;62;02;35;377;Gosnay;956;7;963;62377
32;62;01;07;378;Gouves;200;4;204;62378
32;62;01;07;379;Gouy-en-Artois;326;8;334;62379
32;62;07;17;380;Gouy-Servins;347;1;348;62380
32;62;01;38;381;Gouy-en-Ternois;132;2;134;62381
32;62;04;06;382;Gouy-Saint-André;652;13;665;62382
32;62;01;15;383;Gouy-sous-Bellonne;1386;19;1405;62383
32;62;01;09;384;Graincourt-lès-Havrincourt;646;8;654;62384
32;62;01;07;385;Grand-Rullecourt;385;5;390;62385
32;62;07;39;386;Grenay;6799;32;6831;62386
32;62;01;09;387;Grévillers;360;10;370;62387
32;62;04;06;388;Grigny;297;1;298;62388
32;62;01;07;389;Grincourt-lès-Pas;30;2;32;62389
32;62;04;10;390;Groffliers;1531;44;1575;62390
32;62;02;01;391;Guarbecque;1399;14;1413;62391
32;62;01;04;392;Guémappe;361;9;370;62392
32;62;06;34;393;Guemps;1097;21;1118;62393
32;62;04;06;395;Guigny;133;4;137;62395
32;62;01;38;396;Guinecourt;15;1;16;62396
32;62;06;19;397;Guînes;5618;79;5697;62397
32;62;04;06;398;Guisy;273;12;285;62398
32;62;01;07;399;Habarcq;659;14;673;62399
32;62;02;35;400;Haillicourt;4837;37;4874;62400
32;62;02;23;401;Haisnes;4398;33;4431;62401
32;62;03;22;402;Halinghen;313;6;319;62402
32;62;05;32;403;Hallines;1206;15;1221;62403
32;62;01;07;404;Halloy;203;2;205;62404
32;62;01;15;405;Hamblain-les-Prés;481;10;491;62405
32;62;01;09;406;Hamelincourt;263;8;271;62406
32;62;02;31;407;Ham-en-Artois;959;13;972;62407
32;62;06;18;408;Hames-Boucres;1457;18;1475;62408
32;62;01;07;409;Hannescamps;195;3;198;62409
32;62;01;09;410;Haplincourt;182;6;188;62410
32;62;01;06;411;Haravesnes;53;0;53;62411
32;62;06;19;412;Hardinghen;1209;6;1215;62412
32;62;07;26;413;Harnes;12237;92;12329;62413
32;62;01;15;414;Haucourt;219;2;221;62414
32;62;01;07;415;Haute-Avesnes;435;9;444;62415
32;62;01;38;416;Hautecloque;216;1;217;62416
32;62;01;07;418;Hauteville;312;8;320;62418
32;62;05;33;419;Haut-Loquin;179;1;180;62419
32;62;01;09;421;Havrincourt;405;11;416;62421
32;62;01;07;422;Hébuterne;520;6;526;62422
32;62;05;32;423;Helfaut;1720;30;1750;62423
32;62;01;15;424;Hendecourt-lès-Cagnicourt;314;11;325;62424
32;62;01;07;425;Hendecourt-lès-Ransart;137;4;141;62425
32;62;01;04;426;Héninel;183;2;185;62426
32;62;07;99;427;Hénin-Beaumont;25992;374;26366;62427
32;62;01;04;428;Hénin-sur-Cojeul;524;7;531;62428
32;62;03;22;429;Henneveux;287;4;291;62429
32;62;01;07;430;Hénu;166;2;168;62430
32;62;06;19;432;Herbinghen;398;8;406;62432
32;62;01;38;433;Héricourt;87;6;93;62433
32;62;01;07;434;La Herlière;141;5;146;62434
32;62;01;38;435;Herlincourt;106;1;107;62435
32;62;01;38;436;Herlin-le-Sec;164;3;167;62436
32;62;04;33;437;Herly;307;7;314;62437
32;62;01;07;438;Hermaville;533;8;541;62438
32;62;06;19;439;Hermelinghen;424;3;427;62439
32;62;01;09;440;Hermies;1200;21;1221;62440
32;62;02;16;441;Hermin;209;2;211;62441
32;62;01;38;442;Hernicourt;565;5;570;62442
32;62;02;35;443;Hersin-Coupigny;6245;41;6286;62443
32;62;03;22;444;Hervelinghen;228;6;234;62444
32;62;02;35;445;Hesdigneul-lès-Béthune;823;17;840;62445
32;62;03;36;446;Hesdigneul-lès-Boulogne;718;22;740;62446
32;62;04;06;447;Hesdin;2216;14;2230;62447
32;62;03;36;448;Hesdin-l'Abbé;1902;28;1930;62448
32;62;04;06;449;Hesmond;159;6;165;62449
32;62;01;38;450;Hestrus;231;6;237;62450
32;62;01;38;451;Heuchin;498;10;508;62451
32;62;05;25;452;Heuringhem;1360;36;1396;62452
32;62;04;25;453;Hézecques;126;3;129;62453
32;62;02;12;454;Hinges;2400;47;2447;62454
32;62;06;19;455;Hocquinghen;112;1;113;62455
32;62;02;35;456;Houchin;710;12;722;62456
32;62;02;16;457;Houdain;7110;57;7167;62457
32;62;05;37;458;Houlle;1147;13;1160;62458
32;62;01;07;459;Houvin-Houvigneul;238;4;242;62459
32;62;04;10;460;Hubersent;272;7;279;62460
32;62;04;06;461;Huby-Saint-Leu;884;10;894;62461
32;62;01;38;462;Huclier;144;5;149;62462
32;62;04;33;463;Hucqueliers;443;37;480;62463
32;62;07;39;464;Hulluch;3405;18;3423;62464
32;62;01;07;465;Humbercamps;222;0;222;62465
32;62;04;33;466;Humbert;232;1;233;62466
32;62;01;38;467;HumerÅ“uille;180;0;180;62467
32;62;01;38;468;Humières;218;2;220;62468
32;62;01;09;469;Inchy-en-Artois;593;7;600;62469
32;62;04;06;470;Incourt;86;0;86;62470
32;62;05;25;471;Bellinghem;1066;22;1088;62471
32;62;04;10;472;Inxent;161;6;167;62472
32;62;02;01;473;Isbergues;8717;78;8795;62473
32;62;03;36;474;Isques;1160;21;1181;62474
32;62;01;07;475;Ivergny;248;3;251;62475
32;62;01;15;476;Izel-lès-Equerchin;1049;11;1060;62476
32;62;01;07;477;Izel-lès-Hameau;729;17;746;62477
32;62;05;33;478;Journy;279;5;284;62478
32;62;02;11;479;Labeuvrière;1660;14;1674;62479
32;62;02;35;480;Labourse;2893;22;2915;62480
32;62;04;06;481;Labroye;154;3;157;62481
32;62;03;22;483;Lacres;247;2;249;62483
32;62;01;09;484;Lagnicourt-Marcel;323;6;329;62484
32;62;05;25;485;Laires;369;1;370;62485
32;62;02;01;486;Lambres;1062;14;1076;62486
32;62;03;22;487;Landrethun-le-Nord;1268;22;1290;62487
32;62;06;19;488;Landrethun-lès-Ardres;769;20;789;62488
32;62;02;11;489;Lapugnoy;3471;29;3500;62489
32;62;01;07;490;Lattre-Saint-Quentin;276;3;279;62490
32;62;02;12;491;Laventie;4979;83;5062;62491
32;62;04;25;492;Lebiez;243;3;246;62492
32;62;01;09;493;Lebucquière;233;4;237;62493
32;62;01;09;494;Léchelle;47;1;48;62494
32;62;05;33;495;Ledinghem;331;6;337;62495
32;62;04;24;496;Lefaux;234;6;240;62496
32;62;07;28;497;Leforest;7248;50;7298;62497
32;62;07;29;498;Lens;31461;187;31648;62498
32;62;04;10;499;Lépine;287;8;295;62499
32;62;02;31;500;Lespesses;409;3;412;62500
32;62;04;06;501;Lespinoy;219;2;221;62501
32;62;02;31;502;Lestrem;4728;73;4801;62502
32;62;03;22;503;Leubringhen;293;6;299;62503
32;62;05;33;504;Leulinghem;256;7;263;62504
32;62;03;22;505;Leulinghen-Bernes;498;9;507;62505
32;62;06;19;506;Licques;1625;20;1645;62506
32;62;01;07;507;Liencourt;295;6;301;62507
32;62;02;31;508;Lières;380;10;390;62508
32;62;02;01;509;Liettres;330;5;335;62509
32;62;07;30;510;Liévin;30112;363;30475;62510
32;62;01;07;511;Lignereuil;141;1;142;62511
32;62;02;01;512;Ligny-lès-Aire;574;15;589;62512
32;62;01;38;513;Ligny-sur-Canche;190;6;196;62513
32;62;01;38;514;Ligny-Saint-Flochel;247;3;250;62514
32;62;01;09;515;Ligny-Thilloy;521;17;538;62515
32;62;02;31;516;Lillers;9810;88;9898;62516
32;62;02;01;517;Linghem;196;6;202;62517
32;62;01;38;518;Linzeux;165;1;166;62518
32;62;01;38;519;Lisbourg;605;8;613;62519
32;62;02;12;520;Locon;2396;58;2454;62520
32;62;04;06;521;La Loge;206;4;210;62521
32;62;04;06;522;Loison-sur-Créquoise;271;3;274;62522
32;62;07;29;523;Loison-sous-Lens;5366;52;5418;62523
32;62;03;22;524;Longfossé;1487;18;1505;62524
32;62;05;32;525;Longuenesse;10563;519;11082;62525
32;62;03;22;526;Longueville;144;2;146;62526
32;62;04;24;527;Longvilliers;253;6;259;62527
32;62;07;39;528;Loos-en-Gohelle;6879;62;6941;62528
32;62;02;23;529;Lorgies;1568;18;1586;62529
32;62;03;22;530;Lottinghen;535;9;544;62530
32;62;06;19;531;Louches;950;19;969;62531
32;62;02;05;532;Lozinghem;1291;13;1304;62532
32;62;04;25;533;Lugy;146;3;149;62533
32;62;05;33;534;Lumbres;3601;74;3675;62534
32;62;04;10;535;La Madelaine-sous-Montreuil;154;8;162;62535
32;62;01;07;536;Magnicourt-en-Comte;643;5;648;62536
32;62;01;07;537;Magnicourt-sur-Canche;108;4;112;62537
32;62;04;06;538;Maintenay;444;9;453;62538
32;62;01;38;539;Maisnil;242;3;245;62539
32;62;02;16;540;Maisnil-lès-Ruitz;1707;15;1722;62540
32;62;04;06;541;Maisoncelle;121;4;125;62541
32;62;01;07;542;Maizières;202;4;206;62542
32;62;05;25;543;Mametz;2004;32;2036;62543
32;62;01;07;544;Manin;182;1;183;62544
32;62;04;33;545;Maninghem;147;0;147;62545
32;62;03;22;546;Maninghen-Henne;296;16;312;62546
32;62;04;06;547;Marant;62;1;63;62547
32;62;06;34;548;Marck;10529;125;10654;62548
32;62;04;06;549;Marconne;1079;64;1143;62549
32;62;04;06;550;Marconnelle;1099;20;1119;62550
32;62;04;06;551;Marenla;237;2;239;62551
32;62;04;06;552;Maresquel-Ecquemicourt;1030;8;1038;62552
32;62;01;38;553;Marest;284;6;290;62553
32;62;04;24;554;Maresville;105;0;105;62554
32;62;02;05;555;Marles-les-Mines;5542;26;5568;62555
32;62;04;06;556;Marles-sur-Canche;308;4;312;62556
32;62;01;02;557;MarÅ“uil;2457;55;2512;62557
32;62;01;38;558;Marquay;176;1;177;62558
32;62;01;09;559;Marquion;964;14;978;62559
32;62;03;22;560;Marquise;5083;61;5144;62560
32;62;01;09;561;Martinpuich;194;1;195;62561
32;62;04;25;562;Matringhem;174;3;177;62562
32;62;07;17;563;Mazingarbe;8033;42;8075;62563
32;62;02;01;564;Mazinghem;469;9;478;62564
32;62;04;25;565;Mencas;77;0;77;62565
32;62;03;22;566;Menneville;670;17;687;62566
32;62;05;37;567;Mentque-Nortbécourt;637;9;646;62567
32;62;01;04;568;Mercatel;716;10;726;62568
32;62;05;25;569;Merck-Saint-Liévin;662;6;668;62569
32;62;07;08;570;Méricourt;11267;69;11336;62570
32;62;04;24;571;Merlimont;3401;70;3471;62571
32;62;01;09;572;Metz-en-Couture;624;10;634;62572
32;62;07;39;573;Meurchin;3748;23;3771;62573
32;62;01;07;574;Mingoval;232;5;237;62574
32;62;01;38;576;Moncheaux-lès-Frévent;144;0;144;62576
32;62;01;38;577;Monchel-sur-Canche;81;2;83;62577
32;62;01;07;578;Monchiet;95;2;97;62578
32;62;01;07;579;Monchy-au-Bois;550;5;555;62579
32;62;01;38;580;Monchy-Breton;515;11;526;62580
32;62;01;38;581;Monchy-Cayeux;298;3;301;62581
32;62;01;03;582;Monchy-le-Preux;647;37;684;62582
32;62;01;07;583;Mondicourt;568;9;577;62583
32;62;02;31;584;Mont-Bernanchon;1337;33;1370;62584
32;62;04;10;585;Montcavrel;399;5;404;62585
32;62;01;07;586;Montenescourt;451;5;456;62586
32;62;07;27;587;Montigny-en-Gohelle;10180;54;10234;62587
32;62;04;10;588;Montreuil;1935;124;2059;62588
32;62;01;02;589;Mont-Saint-Eloi;1014;20;1034;62589
32;62;01;38;590;Monts-en-Ternois;61;0;61;62590
32;62;01;09;591;Morchies;209;5;214;62591
32;62;05;37;592;Moringhem;557;12;569;62592
32;62;01;09;593;Morval;91;0;91;62593
32;62;01;09;594;Mory;307;3;310;62594
32;62;05;37;595;Moulle;1131;29;1160;62595
32;62;04;06;596;Mouriez;243;5;248;62596
32;62;01;09;597;Moyenneville;283;3;286;62597
32;62;06;34;598;Muncq-Nieurlet;727;7;734;62598
32;62;03;22;599;Nabringhen;223;7;230;62599
32;62;01;38;600;Nédon;150;3;153;62600
32;62;01;38;601;Nédonchel;351;5;356;62601
32;62;04;10;602;Nempont-Saint-Firmin;203;2;205;62602
32;62;03;36;603;Nesles;1029;8;1037;62603
32;62;03;36;604;Neufchâtel-Hardelot;3745;72;3817;62604
32;62;04;06;605;Neulette;27;0;27;62605
32;62;02;12;606;Neuve-Chapelle;1450;12;1462;62606
32;62;01;38;607;Neuville-au-Cornet;66;3;69;62607
32;62;01;09;608;Neuville-Bourjonval;168;1;169;62608
32;62;01;02;609;Neuville-Saint-Vaast;1571;37;1608;62609
32;62;04;10;610;Neuville-sous-Montreuil;649;9;658;62610
32;62;01;04;611;Neuville-Vitasse;502;8;510;62611
32;62;01;15;612;Neuvireuil;581;12;593;62612
32;62;05;33;613;Nielles-lès-Bléquin;890;9;899;62613
32;62;06;19;614;Nielles-lès-Ardres;580;14;594;62614
32;62;06;18;615;Nielles-lès-Calais;288;5;293;62615
32;62;01;06;616;NÅ“ux-lès-Auxi;182;2;184;62616
32;62;02;35;617;NÅ“ux-les-Mines;11575;70;11645;62617
32;62;05;37;618;Nordausques;1315;14;1329;62618
32;62;01;09;619;Noreuil;147;2;149;62619
32;62;02;31;620;Norrent-Fontes;1384;22;1406;62620
32;62;06;34;621;Nortkerque;1700;30;1730;62621
32;62;05;37;622;Nort-Leulinghem;258;3;261;62622
32;62;06;34;623;Nouvelle-Eglise;704;8;712;62623
32;62;07;28;624;Noyelles-Godault;5773;32;5805;62624
32;62;04;06;625;Noyelles-lès-Humières;56;2;58;62625
32;62;02;23;626;Noyelles-lès-Vermelles;2329;20;2349;62626
32;62;01;15;627;Noyelles-sous-Bellonne;820;20;840;62627
32;62;07;26;628;Noyelles-sous-Lens;6632;47;6679;62628
32;62;01;07;629;Noyellette;165;1;166;62629
32;62;01;07;630;Noyelle-Vion;299;5;304;62630
32;62;01;38;631;Nuncq-Hautecôte;496;8;504;62631
32;62;02;11;632;Oblinghem;380;6;386;62632
32;62;01;38;633;Å’uf-en-Ternois;251;3;254;62633
32;62;06;34;634;Offekerque;1178;19;1197;62634
32;62;04;06;635;Offin;200;2;202;62635
32;62;03;22;636;Offrethun;267;14;281;62636
32;62;07;27;637;Oignies;9993;48;10041;62637
32;62;01;09;638;Oisy-le-Verger;1195;14;1209;62638
32;62;01;15;639;Oppy;388;9;397;62639
32;62;01;07;640;Orville;381;1;382;62640
32;62;01;38;641;Ostreville;220;3;223;62641
32;62;02;05;642;Ourton;763;9;772;62642
32;62;03;36;643;Outreau;13378;170;13548;62643
32;62;05;33;644;Ouve-Wirquin;503;7;510;62644
32;62;06;34;645;Oye-Plage;5583;84;5667;62645
32;62;01;09;646;Palluel;570;7;577;62646
32;62;04;06;647;Le Parcq;745;15;760;62647
32;62;04;33;648;Parenty;508;11;519;62648
32;62;01;07;649;Pas-en-Artois;756;10;766;62649
32;62;01;15;650;Pelves;754;8;762;62650
32;62;01;07;651;Penin;486;6;492;62651
32;62;01;38;652;Pernes;1633;29;1662;62652
32;62;03;13;653;Pernes-lès-Boulogne;418;19;437;62653
32;62;06;18;654;Peuplingues;782;11;793;62654
32;62;01;38;655;Pierremont;308;7;315;62655
32;62;05;33;656;Pihem;947;27;974;62656
32;62;06;18;657;Pihen-lès-Guînes;499;7;506;62657
32;62;03;13;658;Pittefaux;119;9;128;62658
32;62;04;25;659;Planques;95;3;98;62659
32;62;01;15;660;Plouvain;460;7;467;62660
32;62;04;06;661;Bouin-Plumoison;506;9;515;62661
32;62;06;34;662;Polincove;864;21;885;62662
32;62;01;07;663;Pommera;305;4;309;62663
32;62;01;07;664;Pommier;236;5;241;62664
32;62;01;06;665;Le Ponchel;215;6;221;62665
32;62;07;39;666;Pont-Ã -Vendin;3134;17;3151;62666
32;62;03;14;667;Le Portel;9071;114;9185;62667
32;62;01;38;668;Prédefin;190;2;192;62668
32;62;01;38;669;Pressy;314;5;319;62669
32;62;04;33;670;Preures;618;7;625;62670
32;62;01;09;671;Pronville-en-Artois;321;4;325;62671
32;62;01;07;672;Puisieux;652;5;657;62672
32;62;01;09;673;Quéant;647;8;655;62673
32;62;05;33;674;Quelmes;555;18;573;62674
32;62;05;33;675;Quercamps;275;2;277;62675
32;62;02;01;676;Quernes;451;7;458;62676
32;62;04;06;677;Le Quesnoy-en-Artois;347;5;352;62677
32;62;03;22;678;Quesques;691;3;694;62678
32;62;03;22;679;Questrecques;318;8;326;62679
32;62;01;15;680;Quiéry-la-Motte;731;13;744;62680
32;62;05;25;681;Quiestède;627;23;650;62681
32;62;04;33;682;Quilen;64;0;64;62682
32;62;01;06;683;QuÅ“ux-Haut-Maînil;236;3;239;62683
32;62;05;25;684;Racquinghem;2234;31;2265;62684
32;62;04;25;685;Radinghem;270;163;433;62685
32;62;01;38;686;Ramecourt;359;6;365;62686
32;62;04;10;688;Rang-du-Fliers;4307;117;4424;62688
32;62;01;07;689;Ransart;393;2;395;62689
32;62;04;06;690;Raye-sur-Authie;239;7;246;62690
32;62;05;25;691;Saint-Augustin;813;13;826;62691
32;62;05;33;692;Rebergues;367;4;371;62692
32;62;02;16;693;Rebreuve-Ranchicourt;1076;22;1098;62693
32;62;01;07;694;Rebreuve-sur-Canche;188;2;190;62694
32;62;01;07;695;Rebreuviette;263;2;265;62695
32;62;05;25;696;Reclinghem;236;3;239;62696
32;62;01;15;697;Récourt;229;0;229;62697
32;62;04;10;698;Recques-sur-Course;273;5;278;62698
32;62;06;34;699;Recques-sur-Hem;644;13;657;62699
32;62;04;06;700;Regnauville;215;1;216;62700
32;62;02;01;701;Rely;451;2;453;62701
32;62;05;33;702;Remilly-Wirquin;357;6;363;62702
32;62;01;15;703;Rémy;384;3;387;62703
32;62;05;25;704;Renty;598;18;616;62704
32;62;03;22;705;Rety;2092;16;2108;62705
32;62;02;12;706;Richebourg;2646;57;2703;62706
32;62;01;09;708;Riencourt-lès-Bapaume;32;1;33;62708
32;62;01;15;709;Riencourt-lès-Cagnicourt;253;5;258;62709
32;62;04;25;710;Rimboval;169;4;173;62710
32;62;03;22;711;Rinxent;3038;30;3068;62711
32;62;01;07;712;Rivière;1127;29;1156;62712
32;62;02;31;713;Robecq;1342;23;1365;62713
32;62;01;02;714;Roclincourt;784;18;802;62714
32;62;01;09;715;Rocquigny;287;0;287;62715
32;62;06;19;716;Rodelinghem;540;6;546;62716
32;62;01;38;717;RoÃ«llecourt;534;10;544;62717
32;62;01;15;718;RÅ“ux;1413;22;1435;62718
32;62;04;06;719;Rollancourt;281;35;316;62719
32;62;02;01;720;Rombly;44;2;46;62720
32;62;05;01;721;Roquetoire;1936;49;1985;62721
32;62;01;06;722;Rougefay;89;3;92;62722
32;62;04;06;723;Roussent;239;1;240;62723
32;62;07;26;724;Rouvroy;8945;37;8982;62724
32;62;04;25;725;Royon;139;0;139;62725
32;62;04;25;726;Ruisseauville;203;5;208;62726
32;62;02;35;727;Ruitz;1542;23;1565;62727
32;62;01;09;728;Rumaucourt;683;11;694;62728
32;62;04;33;729;Rumilly;250;6;256;62729
32;62;06;34;730;Ruminghem;1626;22;1648;62730
32;62;01;09;731;Ruyaulcourt;283;3;286;62731
32;62;01;38;732;Sachin;330;2;332;62732
32;62;01;07;733;Sailly-au-Bois;310;2;312;62733
32;62;01;15;734;Sailly-en-Ostrevent;689;8;697;62734
32;62;02;23;735;Sailly-Labourse;2404;17;2421;62735
32;62;02;12;736;Sailly-sur-la-Lys;3910;72;3982;62736
32;62;07;17;737;Sains-en-Gohelle;6060;34;6094;62737
32;62;04;25;738;Sains-lès-Fressin;157;4;161;62738
32;62;01;09;739;Sains-lès-Marquion;325;3;328;62739
32;62;01;38;740;Sains-lès-Pernes;304;9;313;62740
32;62;01;07;741;Saint-Amand;119;3;122;62741
32;62;04;24;742;Saint-Aubin;269;6;275;62742
32;62;04;06;743;Sainte-Austreberthe;389;8;397;62743
32;62;01;02;744;Sainte-Catherine;3562;58;3620;62744
32;62;04;06;745;Saint-DenÅ“ux;159;1;160;62745
32;62;03;36;746;Saint-Etienne-au-Mont;5130;65;5195;62746
32;62;02;31;747;Saint-Floris;619;16;635;62747
32;62;06;34;748;Saint-Folquin;2292;41;2333;62748
32;62;04;06;749;Saint-Georges;334;6;340;62749
32;62;02;01;750;Saint-Hilaire-Cottes;810;9;819;62750
32;62;03;22;751;Saint-Inglevert;796;9;805;62751
32;62;04;24;752;Saint-Josse;1130;26;1156;62752
32;62;01;03;753;Saint-Laurent-Blangy;6542;64;6606;62753
32;62;01;09;754;Saint-Léger;474;4;478;62754
32;62;03;36;755;Saint-Léonard;3410;52;3462;62755
32;62;06;34;756;Sainte-Marie-Kerque;1649;30;1679;62756
32;62;05;37;757;Saint-Martin-lez-Tatinghem;5923;134;6057;62757
32;62;03;14;758;Saint-Martin-Boulogne;11136;182;11318;62758
32;62;03;22;759;Saint-Martin-Choquel;473;8;481;62759
32;62;05;25;760;Saint-Martin-d'Hardinghem;279;7;286;62760
32;62;01;04;761;Saint-Martin-sur-Cojeul;210;4;214;62761
32;62;04;33;762;Saint-Michel-sous-Bois;121;5;126;62762
32;62;01;38;763;Saint-Michel-sur-Ternoise;863;16;879;62763
32;62;01;03;764;Saint-Nicolas;4687;53;4740;62764
32;62;05;37;765;Saint-Omer;14903;656;15559;62765
32;62;06;34;766;Saint-Omer-Capelle;1115;12;1127;62766
32;62;01;38;767;Saint-Pol-sur-Ternoise;4909;161;5070;62767
32;62;04;06;768;Saint-Rémy-au-Bois;105;2;107;62768
32;62;06;18;769;Saint-Tricat;760;14;774;62769
32;62;02;31;770;Saint-Venant;3062;86;3148;62770
32;62;07;08;771;Sallaumines;9594;41;9635;62771
32;62;05;37;772;Salperwick;479;25;504;62772
32;62;03;22;773;Samer;4666;147;4813;62773
32;62;06;18;774;Sangatte;4845;128;4973;62774
32;62;06;19;775;Sanghen;349;2;351;62775
32;62;01;09;776;Sapignies;195;4;199;62776
32;62;01;09;777;Le Sars;167;1;168;62777
32;62;01;07;778;Sars-le-Bois;78;1;79;62778
32;62;01;07;779;Sarton;187;1;188;62779
32;62;01;09;780;Sauchy-Cauchy;364;3;367;62780
32;62;01;09;781;Sauchy-Lestrée;461;3;464;62781
32;62;01;15;782;Saudemont;435;8;443;62782
32;62;04;06;783;Saulchoy;317;5;322;62783
32;62;01;07;784;Saulty;775;12;787;62784
32;62;01;07;785;Savy-Berlette;895;185;1080;62785
32;62;03;22;786;Selles;329;3;332;62786
32;62;04;06;787;Sempy;317;3;320;62787
32;62;05;33;788;Seninghem;693;16;709;62788
32;62;03;22;789;Senlecques;281;1;282;62789
32;62;04;25;790;Senlis;162;4;166;62790
32;62;01;38;791;Séricourt;51;0;51;62791
32;62;05;37;792;Serques;1151;32;1183;62792
32;62;07;17;793;Servins;1120;19;1139;62793
32;62;05;33;794;Setques;595;11;606;62794
32;62;01;38;795;Sibiville;112;2;114;62795
32;62;01;07;796;Simencourt;557;12;569;62796
32;62;01;38;797;Siracourt;272;3;275;62797
32;62;01;07;798;Sombrin;239;7;246;62798
32;62;04;10;799;Sorrus;882;27;909;62799
32;62;01;07;800;Souastre;377;3;380;62800
32;62;07;17;801;Souchez;2594;49;2643;62801
32;62;01;07;802;Le Souich;175;2;177;62802
32;62;05;33;803;Surques;637;5;642;62803
32;62;01;07;804;Sus-Saint-Léger;369;5;374;62804
32;62;01;38;805;Tangry;269;1;270;62805
32;62;03;22;806;Tardinghen;151;4;155;62806
32;62;01;38;808;Teneur;257;0;257;62808
32;62;01;38;809;Ternas;137;3;140;62809
32;62;01;03;810;Thélus;1207;36;1243;62810
32;62;05;25;811;Thérouanne;1099;25;1124;62811
32;62;05;25;812;Thiembronne;831;7;838;62812
32;62;01;38;813;La Thieuloye;506;2;508;62813
32;62;01;07;814;Thièvres;101;1;102;62814
32;62;04;10;815;Tigny-Noyelle;174;0;174;62815
32;62;01;07;816;Tilloy-lès-Hermaville;220;5;225;62816
32;62;01;04;817;Tilloy-lès-Mofflaines;1435;119;1554;62817
32;62;01;38;818;Tilly-Capelle;154;1;155;62818
32;62;05;37;819;Tilques;1084;30;1114;62819
32;62;01;07;820;Tincques;816;19;835;62820
32;62;03;22;821;Tingry;294;7;301;62821
32;62;01;06;822;Tollent;92;3;95;62822
32;62;04;25;823;Torcy;173;5;178;62823
32;62;04;06;824;Tortefontaine;212;5;217;62824
32;62;01;15;825;Tortequesne;838;8;846;62825
32;62;04;24;826;Le Touquet-Paris-Plage;4227;274;4501;62826
32;62;05;37;827;Tournehem-sur-la-Hem;1400;17;1417;62827
32;62;04;06;828;Tramecourt;59;0;59;62828
32;62;01;09;829;Le Transloy;433;3;436;62829
32;62;01;09;830;Trescault;176;2;178;62830
32;62;01;38;831;Troisvaux;300;7;307;62831
32;62;04;24;832;Tubersent;563;18;581;62832
32;62;01;38;833;Vacquerie-le-Boucq;77;2;79;62833
32;62;04;06;834;Vacqueriette-Erquières;249;4;253;62834
32;62;01;38;835;Valhuon;554;19;573;62835
32;62;02;35;836;Vaudricourt;1054;29;1083;62836
32;62;05;33;837;Vaudringhem;506;8;514;62837
32;62;01;06;838;Vaulx;90;3;93;62838
32;62;01;09;839;Vaulx-Vraucourt;1023;9;1032;62839
32;62;01;09;840;Vélu;133;0;133;62840
32;62;02;11;841;Vendin-lès-Béthune;2436;24;2460;62841
32;62;07;39;842;Vendin-le-Vieil;8479;44;8523;62842
32;62;04;25;843;Verchin;236;2;238;62843
32;62;04;33;844;Verchocq;634;14;648;62844
32;62;03;22;845;Verlincthun;483;4;487;62845
32;62;02;23;846;Vermelles;4765;41;4806;62846
32;62;02;12;847;Verquigneul;2019;24;2043;62847
32;62;02;12;848;Verquin;3501;34;3535;62848
32;62;04;10;849;Verton;2491;54;2545;62849
32;62;04;06;850;Vieil-Hesdin;344;6;350;62850
32;62;02;12;851;Vieille-Chapelle;805;19;824;62851
32;62;06;34;852;Vieille-Eglise;1420;11;1431;62852
32;62;03;22;853;Vieil-Moutier;381;10;391;62853
32;62;07;17;854;Villers-au-Bois;599;10;609;62854
32;62;01;09;855;Villers-au-Flos;255;1;256;62855
32;62;01;07;856;Villers-Brûlin;366;4;370;62856
32;62;01;07;857;Villers-Châtel;130;9;139;62857
32;62;01;15;858;Villers-lès-Cagnicourt;257;5;262;62858
32;62;01;06;859;Villers-l'Hôpital;261;4;265;62859
32;62;01;07;860;Villers-Sir-Simon;121;3;124;62860
32;62;07;30;861;Vimy;4358;79;4437;62861
32;62;04;25;862;Vincly;156;3;159;62862
32;62;02;23;863;Violaines;3773;33;3806;62863
32;62;01;15;864;Vis-en-Artois;649;15;664;62864
32;62;01;15;865;Vitry-en-Artois;4675;52;4727;62865
32;62;04;10;866;Waben;438;15;453;62866
32;62;03;22;867;Wacquinghen;269;7;276;62867
32;62;04;06;868;Wail;259;6;265;62868
32;62;01;02;869;Wailly;1083;32;1115;62869
32;62;04;10;870;Wailly-Beaucamp;1029;24;1053;62870
32;62;04;06;871;Wambercourt;256;1;257;62871
32;62;04;06;872;Wamin;233;5;238;62872
32;62;01;04;873;Wancourt;642;10;652;62873
32;62;01;07;874;Wanquetin;716;15;731;62874
32;62;05;25;875;Wardrecques;1363;23;1386;62875
32;62;01;09;876;Warlencourt-Eaucourt;134;2;136;62876
32;62;01;07;877;Warlincourt-lès-Pas;159;5;164;62877
32;62;01;07;878;Warlus;379;7;386;62878
32;62;01;07;879;Warluzel;233;3;236;62879
32;62;03;22;880;Le Wast;202;3;205;62880
32;62;01;06;881;Beauvoir-Wavans;377;10;387;62881
32;62;05;33;882;Wavrans-sur-l'Aa;1239;34;1273;62882
32;62;01;38;883;Wavrans-sur-Ternoise;195;0;195;62883
32;62;02;31;885;Westrehem;256;1;257;62885
32;62;04;33;886;Wicquinghem;267;3;270;62886
32;62;04;24;887;Widehem;243;1;244;62887
32;62;03;22;888;Wierre-au-Bois;225;0;225;62888
32;62;03;22;889;Wierre-Effroy;872;19;891;62889
32;62;04;06;890;Willeman;183;1;184;62890
32;62;01;06;891;Willencourt;136;4;140;62891
32;62;01;03;892;Willerval;649;20;669;62892
32;62;03;13;893;Wimereux;6343;162;6505;62893
32;62;03;13;894;Wimille;3987;80;4067;62894
32;62;07;39;895;Wingles;8756;64;8820;62895
32;62;03;22;896;Wirwignes;738;21;759;62896
32;62;05;33;897;Wismes;511;9;520;62897
32;62;05;33;898;Wisques;220;9;229;62898
32;62;03;22;899;Wissant;854;17;871;62899
32;62;02;01;900;Witternesse;587;15;602;62900
32;62;05;01;901;Wittes;993;13;1006;62901
32;62;05;32;902;Wizernes;3292;53;3345;62902
32;62;04;33;903;Zoteux;620;4;624;62903
32;62;05;37;904;Zouafques;593;10;603;62904
32;62;05;33;905;Zudausques;987;48;1035;62905
32;62;06;34;906;Zutkerque;1784;22;1806;62906
32;62;07;21;907;Libercourt;8321;40;8361;62907
32;62;03;13;908;La Capelle-lès-Boulogne;1616;38;1654;62908
32;62;01;09;909;Ytres;434;5;439;62909
84;63;04;01;001;Aigueperse;2767;34;2801;63001
84;63;01;22;002;Aix-la-Fayette;94;0;94;63002
84;63;01;02;003;Ambert;6655;245;6900;63003
84;63;04;27;004;Les Ancizes-Comps;1694;29;1723;63004
84;63;03;06;005;Antoingt;407;5;412;63005
84;63;03;06;006;Anzat-le-Luguet;173;2;175;63006
84;63;03;06;007;Apchat;164;3;167;63007
84;63;05;30;008;Arconsat;585;10;595;63008
84;63;03;06;009;Ardes;592;6;598;63009
84;63;01;02;010;Arlanc;1817;39;1856;63010
84;63;04;26;011;Ars-les-Favets;221;12;233;63011
84;63;04;01;012;Artonne;912;17;929;63012
84;63;04;01;013;Aubiat;924;12;936;63013
84;63;02;03;014;Aubière;10904;154;11058;63014
84;63;05;22;015;Aubusson-d'Auvergne;236;2;238;63015
84;63;05;22;016;Augerolles;887;25;912;63016
84;63;03;06;017;Augnat;195;1;196;63017
84;63;02;17;019;Aulnat;4095;39;4134;63019
84;63;03;23;020;Aurières;362;12;374;63020
84;63;02;21;021;Authezat;690;8;698;63021
84;63;03;06;022;Auzat-la-Combelle;2004;28;2032;63022
84;63;01;22;023;Auzelles;377;10;387;63023
84;63;03;29;024;Avèze;182;4;186;63024
84;63;04;26;025;Ayat-sur-Sioule;139;5;144;63025
84;63;02;23;026;Aydat;2466;46;2512;63026
84;63;01;02;027;Baffie;111;1;112;63027
84;63;03;29;028;Bagnols;416;16;432;63028
84;63;03;06;029;Bansat;258;3;261;63029
84;63;04;20;030;Bas-et-Lezat;340;6;346;63030
84;63;03;06;031;Beaulieu;467;5;472;63031
84;63;02;04;032;Beaumont;10664;225;10889;63032
84;63;04;20;033;Beaumont-lès-Randan;306;2;308;63033
84;63;02;05;034;Beauregard-l'Evêque;1537;27;1564;63034
84;63;04;27;035;Beauregard-Vendon;1238;19;1257;63035
84;63;03;06;036;Bergonne;319;4;323;63036
84;63;01;22;037;Bertignat;455;14;469;63037
84;63;03;29;038;Besse-et-Saint-Anastaise;1497;68;1565;63038
84;63;01;02;039;Beurières;289;10;299;63039
84;63;02;05;040;Billom;4777;81;4858;63040
84;63;04;26;041;Biollet;320;9;329;63041
84;63;02;07;042;Blanzat;3840;57;3897;63042
84;63;04;27;043;Blot-l'Eglise;440;3;443;63043
84;63;02;05;044;Bongheat;429;7;436;63044
84;63;05;19;045;Bort-l'Etang;689;17;706;63045
84;63;03;06;046;Boudes;292;4;296;63046
84;63;03;29;047;La Bourboule;1768;36;1804;63047
84;63;04;28;048;Bourg-Lastic;865;27;892;63048
84;63;02;05;049;Bouzel;729;7;736;63049
84;63;03;06;050;Brassac-les-Mines;3362;122;3484;63050
84;63;03;18;051;Brenat;628;13;641;63051
84;63;03;06;052;Le Breuil-sur-Couze;1039;86;1125;63052
84;63;04;28;053;Briffons;261;11;272;63053
84;63;03;18;054;Le Broc;693;17;710;63054
84;63;04;28;055;Bromont-Lamothe;982;16;998;63055
84;63;01;22;056;Brousse;336;4;340;63056
84;63;01;22;057;Le Brugeron;242;6;248;63057
84;63;05;19;058;Bulhon;534;9;543;63058
84;63;02;31;059;Busséol;218;5;223;63059
84;63;04;26;060;Bussières;91;0;91;63060
84;63;04;01;061;Bussières-et-Pruns;469;7;476;63061
84;63;04;26;062;Buxières-sous-Montaigut;236;2;238;63062
84;63;02;07;063;Cébazat;8805;110;8915;63063
84;63;04;28;064;La Celle;78;0;78;63064
84;63;01;22;065;Ceilloux;174;3;177;63065
84;63;05;30;066;Celles-sur-Durolle;1677;31;1708;63066
84;63;04;26;067;La Cellette;164;2;166;63067
84;63;02;16;069;Le Cendre;5510;59;5569;63069
84;63;02;04;070;Ceyrat;6364;131;6495;63070
84;63;03;23;071;Ceyssat;691;11;702;63071
84;63;05;30;072;Chabreloche;1200;16;1216;63072
84;63;03;31;073;Chadeleuf;432;14;446;63073
84;63;03;06;074;Chalus;183;0;183;63074
84;63;02;08;075;Chamalières;17276;573;17849;63075
84;63;01;22;076;Chambon-sur-Dolore;149;2;151;63076
84;63;03;29;077;Chambon-sur-Lac;423;4;427;63077
84;63;03;06;079;Champagnat-le-Jeune;151;2;153;63079
84;63;03;29;080;Champeix;1405;22;1427;63080
84;63;01;02;081;Champétières;271;6;277;63081
84;63;04;27;082;Champs;403;9;412;63082
84;63;04;23;083;Chanat-la-Mouteyre;927;27;954;63083
84;63;02;21;084;Chanonat;1703;36;1739;63084
84;63;04;28;085;Chapdes-Beaufort;1119;7;1126;63085
84;63;01;22;086;La Chapelle-Agnon;337;12;349;63086
84;63;03;06;087;La Chapelle-Marcousse;66;1;67;63087
84;63;03;06;088;La Chapelle-sur-Usson;83;0;83;63088
84;63;04;01;089;Chappes;1630;26;1656;63089
84;63;04;01;090;Chaptuzat;505;8;513;63090
84;63;03;06;091;Charbonnier-les-Mines;901;15;916;63091
84;63;04;28;092;Charbonnières-les-Varennes;1789;26;1815;63092
84;63;04;27;093;Charbonnières-les-Vieilles;1122;22;1144;63093
84;63;04;26;094;Charensat;489;5;494;63094
84;63;05;20;095;Charnat;206;3;209;63095
84;63;02;05;096;Chas;387;6;393;63096
84;63;03;06;097;Chassagne;79;2;81;63097
84;63;03;29;098;Chastreix;223;8;231;63098
84;63;02;09;099;Châteaugay;3105;53;3158;63099
84;63;04;26;100;Châteauneuf-les-Bains;324;4;328;63100
84;63;04;26;101;Château-sur-Cher;68;1;69;63101
84;63;05;20;102;Châteldon;773;14;787;63102
84;63;04;09;103;Châtel-Guyon;6239;183;6422;63103
84;63;01;02;104;La Chaulme;113;5;118;63104
84;63;01;02;105;Chaumont-le-Bourg;229;6;235;63105
84;63;02;05;106;Chauriat;1699;18;1717;63106
84;63;04;01;107;Chavaroux;494;8;502;63107
84;63;04;25;108;Le Cheix;677;14;691;63108
84;63;03;29;109;Chidrac;527;13;540;63109
84;63;04;28;110;Cisternes-la-Forêt;463;5;468;63110
84;63;03;29;111;Clémensat;120;5;125;63111
84;63;04;01;112;Clerlande;620;7;627;63112
84;63;02;99;113;Clermont-Ferrand;147865;2731;150596;63113
84;63;03;06;114;Collanges;158;1;159;63114
84;63;04;28;115;Combrailles;221;4;225;63115
84;63;04;27;116;Combronde;2170;34;2204;63116
84;63;03;29;117;Compains;128;3;131;63117
84;63;04;28;118;Condat-en-Combraille;414;7;421;63118
84;63;01;22;119;Condat-lès-Montboissier;227;3;230;63119
84;63;02;21;120;Corent;762;9;771;63120
84;63;03;31;121;Coudes;1269;15;1284;63121
84;63;03;29;122;Courgoul;62;1;63;63122
84;63;02;23;123;Cournols;236;7;243;63123
84;63;02;16;124;Cournon-d'Auvergne;20322;366;20688;63124
84;63;05;22;125;Courpière;4017;147;4164;63125
84;63;02;21;126;Le Crest;1269;26;1295;63126
84;63;05;19;128;Crevant-Laveine;963;16;979;63128
84;63;03;29;129;Cros;167;1;168;63129
84;63;04;26;130;La Crouzille;259;11;270;63130
84;63;05;19;131;Culhat;1126;19;1145;63131
84;63;01;22;132;Cunlhat;1297;26;1323;63132
84;63;03;06;134;Dauzat-sur-Vodable;68;2;70;63134
84;63;04;27;135;Davayat;609;5;614;63135
84;63;01;22;136;Domaize;388;8;396;63136
84;63;01;02;137;Doranges;175;4;179;63137
84;63;05;30;138;Dorat;709;9;718;63138
84;63;01;02;139;Dore-l'Eglise;656;8;664;63139
84;63;04;26;140;Durmignat;211;5;216;63140
84;63;02;07;141;Durtol;2057;48;2105;63141
84;63;01;22;142;Echandelys;252;12;264;63142
84;63;04;01;143;Effiat;1131;18;1149;63143
84;63;03;29;144;Egliseneuve-d'Entraigues;341;9;350;63144
84;63;03;06;145;Egliseneuve-des-Liards;151;6;157;63145
84;63;02;05;146;Egliseneuve-près-Billom;808;64;872;63146
84;63;01;02;147;Eglisolles;253;3;256;63147
84;63;04;01;148;Ennezat;2520;53;2573;63148
84;63;04;01;149;Entraigues;675;9;684;63149
84;63;04;09;150;Enval;1543;31;1574;63150
84;63;05;30;151;Escoutoux;1344;38;1382;63151
84;63;04;26;152;Espinasse;291;4;295;63152
84;63;03;29;153;Espinchal;106;2;108;63153
84;63;02;05;154;Espirat;436;6;442;63154
84;63;02;05;155;Estandeuil;482;14;496;63155
84;63;03;06;156;Esteil;59;0;59;63156
84;63;02;05;157;Fayet-le-Château;367;10;377;63157
84;63;01;22;158;Fayet-Ronaye;106;6;112;63158
84;63;04;28;159;FernoÃ«l;134;0;134;63159
84;63;03;18;160;Aulhat-Flat;926;32;958;63160
84;63;01;02;161;La Forie;320;10;330;63161
84;63;01;22;162;Fournols;320;8;328;63162
84;63;03;23;163;Gelles;954;57;1011;63163
84;63;02;17;164;Gerzat;10289;86;10375;63164
84;63;04;28;165;Giat;797;36;833;63165
84;63;03;06;166;Gignat;241;5;246;63166
84;63;04;27;167;Gimeaux;401;6;407;63167
84;63;02;05;168;Glaine-Montaigut;580;13;593;63168
84;63;03;06;169;La Godivelle;16;0;16;63169
84;63;04;28;170;La Goutelle;623;15;638;63170
84;63;04;26;171;Gouttières;329;13;342;63171
84;63;03;29;172;Grandeyrolles;53;2;55;63172
84;63;01;02;173;Grandrif;200;7;207;63173
84;63;01;22;174;Grandval;120;2;122;63174
84;63;04;28;175;Herment;236;8;244;63175
84;63;03;23;176;Heume-l'Eglise;106;3;109;63176
84;63;02;05;177;Isserteaux;408;10;418;63177
84;63;03;18;178;Issoire;15296;405;15701;63178
84;63;01;02;179;Job;1027;30;1057;63179
84;63;05;19;180;Joze;1132;17;1149;63180
84;63;04;27;181;Jozerand;551;14;565;63181
84;63;03;06;182;Jumeaux;589;15;604;63182
84;63;03;29;183;Labessette;65;0;65;63183
84;63;05;20;184;Lachaux;279;4;283;63184
84;63;03;06;185;Lamontgie;639;8;647;63185
84;63;04;28;186;Landogne;228;8;236;63186
84;63;04;26;187;Lapeyrouse;523;12;535;63187
84;63;02;31;188;Laps;589;16;605;63188
84;63;03;23;189;Laqueuille;370;4;374;63189
84;63;03;29;190;Larodde;278;7;285;63190
84;63;04;28;191;Lastic;104;3;107;63191
84;63;03;29;192;La Tour-d'Auvergne;643;31;674;63192
84;63;02;24;193;Lempdes;8677;435;9112;63193
84;63;05;19;194;Lempty;389;7;396;63194
84;63;05;19;195;Lezoux;6256;73;6329;63195
84;63;04;20;196;Limons;749;13;762;63196
84;63;04;27;197;Lisseuil;127;2;129;63197
84;63;04;27;198;Loubeyrat;1384;19;1403;63198
84;63;03;29;199;Ludesse;516;5;521;63199
84;63;04;01;200;Lussat;907;18;925;63200
84;63;04;20;201;Luzillat;1134;17;1151;63201
84;63;03;06;202;Madriat;107;3;110;63202
84;63;04;09;203;Malauzat;1165;18;1183;63203
84;63;04;17;204;Malintrat;1132;20;1152;63204
84;63;02;31;205;Manglieu;467;4;471;63205
84;63;04;27;206;Manzat;1387;19;1406;63206
84;63;01;22;207;Marat;813;11;824;63207
84;63;04;27;208;Marcillat;292;5;297;63208
84;63;03;06;209;Mareugheol;209;5;214;63209
84;63;04;20;210;Maringues;3125;50;3175;63210
84;63;01;02;211;Marsac-en-Livradois;1455;47;1502;63211
84;63;04;09;212;Marsat;1425;37;1462;63212
84;63;04;01;213;Les Martres-d'Artière;2149;21;2170;63213
84;63;02;21;214;Les Martres-de-Veyre;3984;55;4039;63214
84;63;04;01;215;Martres-sur-Morge;676;7;683;63215
84;63;02;05;216;Mauzun;117;4;121;63216
84;63;01;02;218;Mayres;198;6;204;63218
84;63;03;23;219;Mazaye;716;11;727;63219
84;63;03;06;220;Mazoires;96;3;99;63220
84;63;01;02;221;Medeyrolles;122;0;122;63221
84;63;03;18;222;Meilhaud;489;8;497;63222
84;63;04;26;223;Menat;538;11;549;63223
84;63;04;09;224;Ménétrol;1623;24;1647;63224
84;63;04;28;225;Messeix;1048;40;1088;63225
84;63;02;24;226;Mur-sur-Allier;3435;76;3511;63226
84;63;02;31;227;Mirefleurs;2380;59;2439;63227
84;63;04;28;228;Miremont;294;10;304;63228
84;63;05;19;229;Moissat;1226;23;1249;63229
84;63;01;22;230;Le Monestier;228;5;233;63230
84;63;05;30;231;La Monnerie-le-Montel;1685;34;1719;63231
84;63;04;20;232;Mons;541;13;554;63232
84;63;04;26;233;Montaigut;982;9;991;63233
84;63;03;29;234;Montaigut-le-Blanc;875;17;892;63234
84;63;04;27;235;Montcel;538;6;544;63235
84;63;03;29;236;Mont-Dore;1279;18;1297;63236
84;63;04;28;237;Montel-de-Gelat;427;6;433;63237
84;63;04;28;238;Montfermy;228;1;229;63238
84;63;02;05;239;Montmorin;720;23;743;63239
84;63;04;01;240;Montpensier;465;9;474;63240
84;63;03;31;241;Montpeyroux;326;15;341;63241
84;63;03;06;242;Moriat;380;10;390;63242
84;63;04;26;243;Moureuille;378;6;384;63243
84;63;04;25;244;Chambaron sur Morge;1786;26;1812;63244
84;63;04;09;245;Mozac;3876;66;3942;63245
84;63;03;29;246;Murat-le-Quaire;483;17;500;63246
84;63;03;29;247;Murol;580;10;590;63247
84;63;03;23;248;Nébouzat;847;21;868;63248
84;63;05;22;249;Néronde-sur-Dore;523;10;533;63249
84;63;03;31;250;Neschers;858;18;876;63250
84;63;04;26;251;Neuf-Eglise;296;7;303;63251
84;63;02;05;252;Neuville;379;7;386;63252
84;63;05;20;253;Noalhat;239;2;241;63253
84;63;02;07;254;Nohanent;2218;36;2254;63254
84;63;03;06;255;Nonette-Orsonnette;595;16;611;63255
84;63;01;02;256;Novacelles;150;2;152;63256
84;63;03;23;257;Olby;829;11;840;63257
84;63;01;22;258;Olliergues;763;20;783;63258
84;63;02;23;259;Olloix;313;10;323;63259
84;63;05;22;260;Olmet;158;5;163;63260
84;63;03;18;261;Orbeil;843;29;872;63261
84;63;02;21;262;Orcet;2756;40;2796;63262
84;63;02;23;263;Orcines;3493;105;3598;63263
84;63;03;23;264;Orcival;247;1;248;63264
84;63;05;19;265;Orléat;2192;43;2235;63265
84;63;05;30;267;Palladuc;532;17;549;63267
84;63;03;18;268;Pardines;290;4;294;63268
84;63;03;31;269;Parent;882;15;897;63269
84;63;03;06;270;Parentignat;499;15;514;63270
84;63;05;20;271;Paslières;1490;37;1527;63271
84;63;02;03;272;Pérignat-lès-Sarliève;2705;52;2757;63272
84;63;02;31;273;Pérignat-sur-Allier;1507;32;1539;63273
84;63;03;23;274;Perpezat;428;15;443;63274
84;63;03;18;275;Perrier;891;19;910;63275
84;63;05;19;276;Peschadoires;2121;45;2166;63276
84;63;03;06;277;Peslières;65;0;65;63277
84;63;04;25;278;Pessat-Villeneuve;706;6;712;63278
84;63;03;29;279;Picherande;318;6;324;63279
84;63;02;31;280;Pignols;345;6;351;63280
84;63;04;26;281;Pionsat;1062;19;1081;63281
84;63;03;31;282;Plauzat;1713;21;1734;63282
84;63;04;28;283;Pontaumur;634;114;748;63283
84;63;02;24;284;Pont-du-Château;12182;305;12487;63284
84;63;04;28;285;Pontgibaud;762;17;779;63285
84;63;04;27;286;Pouzol;270;5;275;63286
84;63;03;06;287;Les Pradeaux;344;7;351;63287
84;63;04;27;288;Prompsat;453;14;467;63288
84;63;04;28;289;Prondines;261;9;270;63289
84;63;04;28;290;Pulvérières;403;9;412;63290
84;63;05;20;291;Puy-Guillaume;2790;46;2836;63291
84;63;04;28;292;Puy-Saint-Gulmier;150;5;155;63292
84;63;04;26;293;Le Quartier;215;8;223;63293
84;63;04;27;294;Queuille;289;6;295;63294
84;63;04;20;295;Randan;1591;15;1606;63295
84;63;05;19;296;Ravel;762;15;777;63296
84;63;02;05;297;Reignat;382;3;385;63297
84;63;05;22;298;La Renaudie;127;4;131;63298
84;63;03;06;299;Rentières;103;0;103;63299
84;63;04;25;300;Riom;19004;758;19762;63300
84;63;05;20;301;Ris;747;9;756;63301
84;63;02;21;302;La Roche-Blanche;3483;67;3550;63302
84;63;03;06;303;Roche-Charles-la-Mayrand;41;1;42;63303
84;63;04;26;304;Roche-d'Agoux;110;0;110;63304
84;63;03;23;305;Rochefort-Montagne;860;143;1003;63305
84;63;02;31;306;La Roche-Noire;622;10;632;63306
84;63;02;03;307;Romagnat;7791;178;7969;63307
84;63;02;08;308;Royat;4359;118;4477;63308
84;63;01;02;309;Saillant;308;3;311;63309
84;63;05;30;310;Sainte-Agathe;173;2;175;63310
84;63;04;01;311;Saint-Agoulin;339;2;341;63311
84;63;01;02;312;Saint-Alyre-d'Arlanc;151;4;155;63312
84;63;03;06;313;Saint-Alyre-ès-Montagne;111;5;116;63313
84;63;01;22;314;Saint-Amant-Roche-Savine;494;27;521;63314
84;63;02;21;315;Saint-Amant-Tallende;1747;38;1785;63315
84;63;04;20;317;Saint-André-le-Coq;529;3;532;63317
84;63;04;27;318;Saint-Angel;462;9;471;63318
84;63;01;02;319;Saint-Anthème;706;25;731;63319
84;63;04;28;320;Saint-Avit;218;5;223;63320
84;63;03;18;321;Saint-Babel;935;15;950;63321
84;63;04;17;322;Saint-Beauzire;2218;30;2248;63322
84;63;01;22;323;Saint-Bonnet-le-Bourg;167;3;170;63323
84;63;01;22;324;Saint-Bonnet-le-Chastel;205;8;213;63324
84;63;02;05;325;Saint-Bonnet-lès-Allier;418;6;424;63325
84;63;03;23;326;Saint-Bonnet-près-Orcival;513;8;521;63326
84;63;04;25;327;Saint-Bonnet-près-Riom;2035;39;2074;63327
84;63;01;22;328;Sainte-Catherine;51;2;53;63328
84;63;04;26;329;Sainte-Christine;127;5;132;63329
84;63;03;29;330;Saint-Cirgues-sur-Couze;351;7;358;63330
84;63;01;02;331;Saint-Clément-de-Valorgue;232;6;238;63331
84;63;04;20;332;Saint-Clément-de-Régnat;539;10;549;63332
84;63;04;20;333;Saint-Denis-Combarnazat;230;8;238;63333
84;63;02;05;334;Saint-Dier-d'Auvergne;542;20;562;63334
84;63;03;29;335;Saint-Diéry;525;12;537;63335
84;63;03;29;336;Saint-Donat;201;4;205;63336
84;63;01;22;337;Saint-Eloy-la-Glacière;61;1;62;63337
84;63;04;26;338;Saint-Eloy-les-Mines;3572;141;3713;63338
84;63;04;28;339;Saint-Etienne-des-Champs;134;2;136;63339
84;63;03;06;340;Saint-Etienne-sur-Usson;259;3;262;63340
84;63;01;02;341;Saint-Ferréol-des-Côtes;547;16;563;63341
84;63;03;29;342;Saint-Floret;245;7;252;63342
84;63;05;22;343;Saint-Flour-l'Etang;279;7;286;63343
84;63;04;27;344;Saint-Gal-sur-Sioule;144;4;148;63344
84;63;02;04;345;Saint-Genès-Champanelle;3659;105;3764;63345
84;63;03;29;346;Saint-Genès-Champespe;218;7;225;63346
84;63;04;01;347;Saint-Genès-du-Retz;464;18;482;63347
84;63;03;06;348;Saint-Genès-la-Tourette;182;1;183;63348
84;63;04;27;349;Saint-Georges-de-Mons;1933;49;1982;63349
84;63;02;31;350;Saint-Georges-sur-Allier;1287;19;1306;63350
84;63;04;28;351;Saint-Germain-près-Herment;72;2;74;63351
84;63;03;06;352;Saint-Germain-Lembron;2008;42;2050;63352
84;63;01;22;353;Saint-Germain-l'Herm;483;27;510;63353
84;63;04;26;354;Saint-Gervais-d'Auvergne;1273;144;1417;63354
84;63;01;22;355;Saint-Gervais-sous-Meymont;224;4;228;63355
84;63;03;06;356;Saint-Gervazy;335;13;348;63356
84;63;03;06;357;Saint-Hérent;116;2;118;63357
84;63;04;27;358;Saint-Hilaire-la-Croix;360;3;363;63358
84;63;04;28;359;Saint-Hilaire-les-Monges;85;1;86;63359
84;63;04;26;360;Saint-Hilaire;154;3;157;63360
84;63;04;01;362;Saint-Ignat;915;17;932;63362
84;63;04;28;363;Saint-Jacques-d'Ambur;281;6;287;63363
84;63;05;19;364;Saint-Jean-d'Heurs;664;8;672;63364
84;63;02;05;365;Saint-Jean-des-Ollières;431;11;442;63365
84;63;03;06;366;Saint-Jean-en-Val;353;3;356;63366
84;63;03;06;367;Saint-Jean-Saint-Gervais;123;1;124;63367
84;63;02;05;368;Saint-Julien-de-Coppel;1299;26;1325;63368
84;63;04;26;369;Saint-Julien-la-Geneste;120;3;123;63369
84;63;03;28;370;Saint-Julien-Puy-Lavèze;365;5;370;63370
84;63;01;02;371;Saint-Just;154;5;159;63371
84;63;04;01;372;Saint-Laure;670;5;675;63372
84;63;04;26;373;Saint-Maigner;189;4;193;63373
84;63;01;02;374;Saint-Martin-des-Olmes;287;7;294;63374
84;63;03;06;375;Saint-Martin-des-Plains;166;1;167;63375
84;63;03;06;376;Saint-Martin-d'Ollières;148;7;155;63376
84;63;04;26;377;Saint-Maurice-près-Pionsat;372;6;378;63377
84;63;02;31;378;Saint-Maurice;941;8;949;63378
84;63;04;27;379;Saint-Myon;517;6;523;63379
84;63;03;29;380;Saint-Nectaire;762;3;765;63380
84;63;04;28;381;Saint-Ours;1650;22;1672;63381
84;63;04;27;382;Saint-Pardoux;393;13;406;63382
84;63;03;29;383;Saint-Pierre-Colamine;250;5;255;63383
84;63;01;22;384;Saint-Pierre-la-Bourlhonne;132;5;137;63384
84;63;04;28;385;Saint-Pierre-le-Chastel;443;9;452;63385
84;63;03;23;386;Saint-Pierre-Roche;483;5;488;63386
84;63;04;20;387;Saint-Priest-Bramefant;863;17;880;63387
84;63;04;26;388;Saint-Priest-des-Champs;702;17;719;63388
84;63;03;06;389;Saint-Quentin-sur-Sauxillanges;111;2;113;63389
84;63;04;27;390;Saint-Quintin-sur-Sioule;384;13;397;63390
84;63;04;27;391;Saint-Rémy-de-Blot;238;4;242;63391
84;63;03;06;392;Saint-Rémy-de-Chargnat;579;9;588;63392
84;63;05;30;393;Saint-Rémy-sur-Durolle;1754;33;1787;63393
84;63;01;02;394;Saint-Romain;207;6;213;63394
84;63;02;23;395;Saint-Sandoux;972;19;991;63395
84;63;02;23;396;Saint-Saturnin;1164;70;1234;63396
84;63;03;29;397;Saint-Sauves-d'Auvergne;1128;20;1148;63397
84;63;01;02;398;Saint-Sauveur-la-Sagne;88;3;91;63398
84;63;04;28;399;Saint-Sulpice;85;6;91;63399
84;63;04;20;400;Saint-Sylvestre-Pragoulin;1076;19;1095;63400
84;63;03;29;401;Saint-Victor-la-Rivière;252;6;258;63401
84;63;05;30;402;Saint-Victor-Montvianeix;250;7;257;63402
84;63;03;29;403;Saint-Vincent;414;11;425;63403
84;63;03;18;404;Saint-Yvoine;608;11;619;63404
84;63;02;31;405;Sallèdes;584;12;596;63405
84;63;04;01;406;Sardon;303;6;309;63406
84;63;03;23;407;Saulzet-le-Froid;280;7;287;63407
84;63;04;26;408;Sauret-Besserve;166;5;171;63408
84;63;03;29;409;Saurier;279;2;281;63409
84;63;04;28;410;Sauvagnat;138;3;141;63410
84;63;03;31;411;Sauvagnat-Sainte-Marthe;475;9;484;63411
84;63;01;02;412;Sauvessanges;529;7;536;63412
84;63;02;21;413;La Sauvetat;710;12;722;63413
84;63;05;22;414;Sauviat;551;12;563;63414
84;63;03;06;415;Sauxillanges;1296;13;1309;63415
84;63;04;28;416;Savennes;93;3;96;63416
84;63;04;07;417;Sayat;2429;46;2475;63417
84;63;05;22;418;Sermentizon;575;9;584;63418
84;63;04;26;419;Servant;549;12;561;63419
84;63;05;19;420;Seychalles;799;9;808;63420
84;63;03;29;421;Singles;160;5;165;63421
84;63;03;29;422;Solignat;510;9;519;63422
84;63;03;06;423;Sugères;602;9;611;63423
84;63;04;01;424;Surat;580;12;592;63424
84;63;02;21;425;Tallende;1499;42;1541;63425
84;63;03;29;426;Tauves;766;17;783;63426
84;63;04;27;427;Teilhède;486;15;501;63427
84;63;04;26;428;Teilhet;283;2;285;63428
84;63;03;06;429;Ternant-les-Eaux;32;2;34;63429
84;63;05;30;430;Thiers;11784;368;12152;63430
84;63;01;02;431;Thiolières;162;1;163;63431
84;63;04;01;432;Thuret;915;38;953;63432
84;63;04;28;433;Tortebesse;73;3;76;63433
84;63;01;22;434;Tours-sur-Meymont;514;24;538;63434
84;63;03;29;435;Tourzel-Ronzières;215;6;221;63435
84;63;04;28;436;Tralaigues;75;0;75;63436
84;63;03;29;437;Trémouille-Saint-Loup;151;4;155;63437
84;63;02;05;438;Trézioux;483;5;488;63438
84;63;03;06;439;Usson;298;2;300;63439
84;63;03;29;440;Valbeleix;125;0;125;63440
84;63;01;02;441;Valcivières;208;3;211;63441
84;63;03;06;442;Valz-sous-Châteauneuf;52;3;55;63442
84;63;04;01;443;Varennes-sur-Morge;417;12;429;63443
84;63;03;06;444;Varennes-sur-Usson;300;4;304;63444
84;63;02;05;445;Vassel;302;5;307;63445
84;63;04;01;446;Vensat;523;4;527;63446
84;63;04;26;447;Vergheas;65;4;69;63447
84;63;03;06;448;Le Vernet-Chaméane;813;64;877;63448
84;63;03;23;449;Le Vernet-Sainte-Marguerite;302;4;306;63449
84;63;04;28;450;Verneugheol;236;10;246;63450
84;63;03;23;451;Vernines;413;17;430;63451
84;63;03;29;452;Verrières;72;1;73;63452
84;63;02;05;453;Vertaizon;3258;32;3290;63453
84;63;01;22;454;Vertolaye;537;10;547;63454
84;63;02;21;455;Veyre-Monton;3635;57;3692;63455
84;63;03;06;456;Vichel;343;14;357;63456
84;63;02;31;457;Vic-le-Comte;5189;99;5288;63457
84;63;03;06;458;Villeneuve;151;1;152;63458
84;63;04;20;459;Villeneuve-les-Cerfs;526;4;530;63459
84;63;04;28;460;Villossanges;366;10;376;63460
84;63;05;19;461;Vinzelles;359;3;362;63461
84;63;04;26;462;Virlet;268;5;273;63462
84;63;05;30;463;Viscomtat;516;9;525;63463
84;63;04;27;464;Vitrac;346;12;358;63464
84;63;01;02;465;Viverols;405;9;414;63465
84;63;03;29;466;Vodable;196;3;199;63466
84;63;04;28;467;Voingt;30;1;31;63467
84;63;05;30;468;Vollore-Montagne;300;9;309;63468
84;63;05;22;469;Vollore-Ville;720;16;736;63469
84;63;04;09;470;Volvic;4623;71;4694;63470
84;63;04;26;471;Youx;904;19;923;63471
84;63;02;31;472;Yronde-et-Buron;652;17;669;63472
84;63;04;27;473;Yssac-la-Tourette;392;7;399;63473
75;64;03;27;001;Aast;186;7;193;64001
75;64;03;23;002;Abère;167;1;168;64002
75;64;03;09;003;Abidos;214;8;222;64003
75;64;02;16;004;Abitain;107;1;108;64004
75;64;03;09;005;Abos;544;13;557;64005
75;64;02;14;006;Accous;458;12;470;64006
75;64;02;14;007;Agnos;1037;26;1063;64007
75;64;01;12;008;Ahaxe-Alciette-Bascassan;269;9;278;64008
75;64;01;26;009;Ahetze;2071;32;2103;64009
75;64;01;22;010;AÃ¯cirits-Camou-Suhast;667;16;683;64010
75;64;01;12;011;Aincille;115;6;121;64011
75;64;02;12;012;Ainharp;136;1;137;64012
75;64;01;12;013;Ainhice-Mongelos;172;5;177;64013
75;64;01;26;014;Ainhoa;670;7;677;64014
75;64;02;12;015;Alçay-Alçabéhéty-Sunharette;215;3;218;64015
75;64;01;12;016;Aldudes;324;6;330;64016
75;64;02;12;017;Alos-Sibas-Abense;330;4;334;64017
75;64;01;22;018;Amendeuix-Oneix;450;9;459;64018
75;64;01;22;019;Amorots-Succos;233;1;234;64019
75;64;03;23;021;Andoins;662;21;683;64021
75;64;02;16;022;Andrein;136;3;139;64022
75;64;03;27;023;AngaÃ¯s;911;23;934;64023
75;64;01;96;024;Anglet;39719;1121;40840;64024
75;64;02;09;025;Angous;97;5;102;64025
75;64;01;12;026;Anhaux;380;10;390;64026
75;64;03;23;027;Anos;188;3;191;64027
75;64;03;25;028;Anoye;136;2;138;64028
75;64;02;14;029;Aramits;665;15;680;64029
75;64;01;22;031;Arancou;174;3;177;64031
75;64;02;09;032;Araujuzon;183;8;191;64032
75;64;02;09;033;Araux;134;1;135;64033
75;64;01;22;034;Arbérats-Sillègue;297;6;303;64034
75;64;01;26;035;Arbonne;2342;62;2404;64035
75;64;01;22;036;Arbouet-Sussaute;317;7;324;64036
75;64;03;11;037;Arbus;1214;22;1236;64037
75;64;01;26;038;Arcangues;3195;81;3276;64038
75;64;02;14;039;Aren;245;1;246;64039
75;64;02;14;040;Arette;1074;33;1107;64040
75;64;03;17;041;Aressy;763;11;774;64041
75;64;03;02;042;Argagnon;702;23;725;64042
75;64;03;25;043;Argelos;289;4;293;64043
75;64;03;02;044;Arget;78;1;79;64044
75;64;01;22;045;Arhansus;77;1;78;64045
75;64;01;22;046;Armendarits;396;5;401;64046
75;64;01;12;047;Arnéguy;236;3;239;64047
75;64;03;02;048;Arnos;130;1;131;64048
75;64;01;22;049;Aroue-Ithorots-OlhaÃ¯by;232;8;240;64049
75;64;02;12;050;Arrast-Larrebieu;95;3;98;64050
75;64;01;22;051;Arraute-Charritte;406;5;411;64051
75;64;03;25;052;Arricau-Bordes;108;0;108;64052
75;64;03;23;053;Arrien;190;3;193;64053
75;64;03;17;054;Arros-de-Nay;767;21;788;64054
75;64;03;25;056;Arrosès;139;2;141;64056
75;64;03;02;057;Arthez-de-Béarn;1835;42;1877;64057
75;64;03;17;058;Arthez-d'Asson;472;10;482;64058
75;64;03;23;059;Artigueloutan;1083;28;1111;64059
75;64;03;11;060;Artiguelouve;1851;52;1903;64060
75;64;03;02;061;Artix;3428;64;3492;64061
75;64;02;15;062;Arudy;2239;46;2285;64062
75;64;03;02;063;Arzacq-Arraziguet;1057;21;1078;64063
75;64;02;14;064;Asasp-Arros;449;9;458;64064
75;64;01;26;065;Ascain;4359;113;4472;64065
75;64;01;12;066;Ascarat;329;9;338;64066
75;64;03;17;067;Assat;1942;45;1987;64067
75;64;03;17;068;Asson;2004;51;2055;64068
75;64;02;15;069;Aste-Béon;231;6;237;64069
75;64;03;25;070;Astis;307;1;308;64070
75;64;02;16;071;Athos-Aspis;210;5;215;64071
75;64;03;08;072;Aubertin;651;14;665;64072
75;64;03;25;073;Aubin;260;5;265;64073
75;64;03;25;074;Aubous;45;0;45;64074
75;64;02;09;075;Audaux;166;1;167;64075
75;64;03;25;077;Auga;173;3;176;64077
75;64;03;25;078;Auriac;230;6;236;64078
75;64;03;25;079;Aurions-Idernes;102;3;105;64079
75;64;03;02;080;Aussevielle;790;24;814;64080
75;64;02;12;081;Aussurucq;239;2;241;64081
75;64;02;16;082;Auterrive;140;1;141;64082
75;64;02;16;083;Autevielle-Saint-Martin-Bideren;203;3;206;64083
75;64;03;25;084;Aydie;140;2;142;64084
75;64;02;14;085;Aydius;109;1;110;64085
75;64;01;22;086;Ayherre;1094;33;1127;64086
75;64;03;16;087;Baigts-de-Béarn;865;22;887;64087
75;64;03;02;088;Balansun;299;9;308;64088
75;64;03;23;089;Baleix;143;1;144;64089
75;64;03;25;090;Baliracq-Maumusson;121;2;123;64090
75;64;03;17;091;Baliros;494;7;501;64091
75;64;01;12;092;Banca;346;7;353;64092
75;64;02;12;093;Barcus;641;5;646;64093
75;64;01;13;094;Bardos;1828;49;1877;64094
75;64;03;23;095;Barinque;592;12;604;64095
75;64;02;16;096;Barraute-Camu;175;1;176;64096
75;64;03;27;097;Barzun;609;11;620;64097
75;64;03;25;098;Bassillon-Vauzé;65;2;67;64098
75;64;02;09;099;Bastanès;98;4;102;64099
75;64;01;26;100;Bassussarry;3231;95;3326;64100
75;64;03;27;101;Baudreix;585;114;699;64101
75;64;01;97;102;Bayonne;51894;1169;53063;64102
75;64;03;23;103;Bédeille;207;3;210;64103
75;64;02;14;104;Bedous;600;15;615;64104
75;64;01;22;105;Béguios;271;12;283;64105
75;64;01;22;106;Béhasque-Lapiste;520;9;529;64106
75;64;01;12;107;Béhorléguy;73;3;76;64107
75;64;03;16;108;Bellocq;909;11;920;64108
75;64;03;27;109;Bénéjacq;1943;44;1987;64109
75;64;02;15;110;Béost;220;2;222;64110
75;64;03;23;111;Bentayou-Sérée;109;1;110;64111
75;64;02;16;112;Bérenx;427;4;431;64112
75;64;01;22;113;Bergouey-Viellenave;116;5;121;64113
75;64;03;23;114;Bernadets;586;9;595;64114
75;64;02;12;115;Berrogain-Laruns;159;68;227;64115
75;64;02;15;116;Bescat;245;5;250;64116
75;64;03;09;117;Bésingrand;145;4;149;64117
75;64;03;25;118;Bétracq;50;0;50;64118
75;64;03;27;119;Beuste;673;21;694;64119
75;64;01;22;120;Beyrie-sur-Joyeuse;530;7;537;64120
75;64;03;02;121;Beyrie-en-Béarn;193;2;195;64121
75;64;01;07;122;Biarritz;25787;721;26508;64122
75;64;01;22;123;Bidache;1358;26;1384;64123
75;64;01;12;124;Bidarray;663;15;678;64124
75;64;01;24;125;Bidart;6975;138;7113;64125
75;64;02;14;126;Bidos;1109;30;1139;64126
75;64;02;15;127;Bielle;390;14;404;64127
75;64;02;15;128;Bilhères;159;5;164;64128
75;64;03;08;129;Billère;12793;230;13023;64129
75;64;01;10;130;Biriatou;1228;20;1248;64130
75;64;03;09;131;Biron;637;21;658;64131
75;64;03;20;132;Bizanos;4563;126;4689;64132
75;64;03;27;133;Boeil-Bezing;1347;27;1374;64133
75;64;01;22;134;Bonloc;369;7;376;64134
75;64;03;02;135;Bonnut;794;14;808;64135
75;64;02;14;136;Borce;136;5;141;64136
75;64;03;27;137;Bordères;676;20;696;64137
75;64;03;27;138;Bordes;2887;52;2939;64138
75;64;03;17;139;Bosdarros;988;23;1011;64139
75;64;01;05;140;Boucau;8627;170;8797;64140
75;64;03;25;141;Boueilh-Boueilho-Lasque;375;9;384;64141
75;64;03;02;142;Bougarber;844;27;871;64142
75;64;03;02;143;Bouillon;157;0;157;64143
75;64;03;02;144;Boumourt;165;2;167;64144
75;64;03;17;145;Bourdettes;513;8;521;64145
75;64;03;25;146;Bournos;334;4;338;64146
75;64;01;13;147;Briscous;2878;45;2923;64147
75;64;03;17;148;Bruges-Capbis-Mifaget;870;25;895;64148
75;64;02;09;149;Bugnein;243;6;249;64149
75;64;01;22;150;Bunus;131;2;133;64150
75;64;02;16;151;Burgaronne;99;5;104;64151
75;64;03;23;152;Buros;1927;54;1981;64152
75;64;03;25;153;Burosse-Mendousse;67;1;68;64153
75;64;01;12;154;Bussunarits-Sarrasquette;206;1;207;64154
75;64;01;12;155;Bustince-Iriberry;104;1;105;64155
75;64;02;15;156;Buziet;476;14;490;64156
75;64;02;15;157;Buzy;988;22;1010;64157
75;64;03;02;158;Cabidos;173;7;180;64158
75;64;03;25;159;Cadillon;117;4;121;64159
75;64;01;03;160;Cambo-les-Bains;6622;109;6731;64160
75;64;01;22;161;Came;996;19;1015;64161
75;64;02;12;162;Camou-Cihigue;101;3;104;64162
75;64;03;09;165;Cardesse;300;1;301;64165
75;64;01;12;166;Caro;193;9;202;64166
75;64;03;25;167;Carrère;217;5;222;64167
75;64;02;16;168;Carresse-Cassaber;667;15;682;64168
75;64;02;16;170;Castagnède;200;2;202;64170
75;64;03;02;171;Casteide-Cami;260;2;262;64171
75;64;03;02;172;Casteide-Candau;302;3;305;64172
75;64;03;23;173;Casteide-Doat;162;1;163;64173
75;64;03;23;174;Castéra-Loubix;52;1;53;64174
75;64;02;15;175;Castet;153;4;157;64175
75;64;02;16;176;Castetbon;166;4;170;64176
75;64;03;02;177;Castétis;624;25;649;64177
75;64;02;09;178;Castetnau-Camblong;464;15;479;64178
75;64;03;09;179;Castetner;133;6;139;64179
75;64;03;25;180;Castetpugon;212;5;217;64180
75;64;03;02;181;Castillon (Canton d'Arthez-de-Béarn);330;4;334;64181
75;64;03;25;182;Castillon (Canton de Lembeye);69;1;70;64182
75;64;03;25;183;Caubios-Loos;598;18;616;64183
75;64;03;02;184;Cescau;612;27;639;64184
75;64;02;14;185;Cette-Eygun;61;1;62;64185
75;64;02;09;186;Charre;216;3;219;64186
75;64;02;12;187;Charritte-de-Bas;254;9;263;64187
75;64;02;12;188;Chéraute;1083;154;1237;64188
75;64;01;24;189;Ciboure;6211;180;6391;64189
75;64;03;25;190;Claracq;236;8;244;64190
75;64;03;27;191;Coarraze;2170;142;2312;64191
75;64;03;25;192;Conchez-de-Béarn;111;1;112;64192
75;64;03;25;193;Corbère-Abères;98;2;100;64193
75;64;03;25;194;CoslédaÃ -Lube-Boast;382;9;391;64194
75;64;03;02;195;Coublucq;95;2;97;64195
75;64;03;25;196;Crouseilles;121;0;121;64196
75;64;03;09;197;Cuqueron;189;5;194;64197
75;64;03;02;198;Denguin;1766;50;1816;64198
75;64;03;25;199;Diusse;142;4;146;64199
75;64;03;02;200;Doazon;182;3;185;64200
75;64;02;09;201;Dognen;227;7;234;64201
75;64;01;22;202;Domezain-Berraute;464;11;475;64202
75;64;03;25;203;Doumy;317;7;324;64203
75;64;02;15;204;Eaux-Bonnes;193;3;196;64204
75;64;02;16;205;Escos;237;2;239;64205
75;64;02;14;206;Escot;123;1;124;64206
75;64;02;15;207;Escou;423;12;435;64207
75;64;03;23;208;Escoubès;425;8;433;64208
75;64;02;15;209;Escout;438;8;446;64209
75;64;03;25;210;Escurès;145;1;146;64210
75;64;03;23;211;Eslourenties-Daban;361;4;365;64211
75;64;03;23;212;Espéchède;142;2;144;64212
75;64;01;03;213;Espelette;1985;47;2032;64213
75;64;02;12;214;Espès-Undurein;491;16;507;64214
75;64;02;16;215;Espiute;105;3;108;64215
75;64;03;27;216;Espoey;1190;46;1236;64216
75;64;02;14;217;Esquiule;538;12;550;64217
75;64;01;12;218;Estérençuby;328;1;329;64218
75;64;02;15;219;Estialescq;260;6;266;64219
75;64;02;15;220;Estos;505;12;517;64220
75;64;01;22;221;Etcharry;154;29;183;64221
75;64;02;12;222;Etchebar;75;0;75;64222
75;64;02;14;223;Etsaut;59;2;61;64223
75;64;02;14;224;Eysus;638;17;655;64224
75;64;02;14;225;Ance Féas;615;16;631;64225
75;64;03;02;226;Fichous-Riumayou;177;1;178;64226
75;64;03;23;227;Gabaston;667;13;680;64227
75;64;01;22;228;Gabat;270;2;272;64228
75;64;01;12;229;Gamarthe;127;5;132;64229
75;64;03;17;230;Gan;5585;107;5692;64230
75;64;02;12;231;Garindein;498;8;506;64231
75;64;03;25;232;Garlède-Mondebat;220;2;222;64232
75;64;03;25;233;Garlin;1356;23;1379;64233
75;64;03;02;234;Garos;261;9;270;64234
75;64;01;22;235;Garris;281;8;289;64235
75;64;03;25;236;Gayon;54;1;55;64236
75;64;03;21;237;Gelos;3652;132;3784;64237
75;64;03;27;238;Ger;1969;53;2022;64238
75;64;03;25;239;Gerderest;139;1;140;64239
75;64;02;15;240;Gère-Bélesten;183;7;190;64240
75;64;02;14;241;Géronce;477;6;483;64241
75;64;02;09;242;Gestas;75;0;75;64242
75;64;03;02;243;Géus-d'Arzacq;201;2;203;64243
75;64;02;14;244;GeÃ¼s-d'Oloron;255;10;265;64244
75;64;02;15;245;Goès;576;14;590;64245
75;64;03;27;246;Gomer;303;7;310;64246
75;64;02;12;247;Gotein-Libarrenx;474;13;487;64247
75;64;01;24;249;Guéthary;1326;36;1362;64249
75;64;01;13;250;Guiche;1001;33;1034;64250
75;64;02;16;251;Guinarthe-Parenties;221;8;229;64251
75;64;02;14;252;Gurmençon;880;27;907;64252
75;64;02;09;253;Gurs;419;10;429;64253
75;64;03;02;254;Hagetaubin;576;18;594;64254
75;64;01;03;255;Halsou;621;5;626;64255
75;64;01;03;256;Hasparren;7498;281;7779;64256
75;64;03;17;257;Haut-de-Bosdarros;350;1;351;64257
75;64;02;12;258;Haux;86;1;87;64258
75;64;01;22;259;Hélette;736;16;752;64259
75;64;01;10;260;Hendaye;16967;437;17404;64260
75;64;02;15;261;Herrère;389;2;391;64261
75;64;03;23;262;Higuères-Souye;275;6;281;64262
75;64;02;16;263;L'Hôpital-d'Orion;128;4;132;64263
75;64;02;12;264;L'Hôpital-Saint-Blaise;61;2;63;64264
75;64;01;22;265;Hosta;93;0;93;64265
75;64;03;27;266;Hours;243;9;252;64266
75;64;01;22;267;Ibarrolle;77;1;78;64267
75;64;02;12;268;Idaux-Mendy;275;4;279;64268
75;64;03;19;269;Idron;4903;161;5064;64269
75;64;03;27;270;Igon;974;48;1022;64270
75;64;01;22;271;Iholdy;537;8;545;64271
75;64;01;22;272;Ilharre;145;1;146;64272
75;64;01;22;273;Irissarry;912;13;925;64273
75;64;01;12;274;Irouléguy;364;2;366;64274
75;64;01;12;275;Ispoure;672;13;685;64275
75;64;02;14;276;Issor;236;6;242;64276
75;64;01;22;277;Isturits;517;13;530;64277
75;64;01;03;279;Itxassou;2168;66;2234;64279
75;64;02;15;280;Izeste;432;3;435;64280
75;64;02;09;281;Jasses;145;3;148;64281
75;64;01;03;282;Jatxou;1168;31;1199;64282
75;64;01;12;283;Jaxu;195;1;196;64283
75;64;03;08;284;Jurançon;7102;240;7342;64284
75;64;01;22;285;Juxue;206;6;212;64285
75;64;03;09;286;LaÃ -Mondrans;432;13;445;64286
75;64;02;16;287;LaÃ s;139;3;142;64287
75;64;03;02;288;Labastide-Cézéracq;556;13;569;64288
75;64;01;22;289;La Bastide-Clairence;961;34;995;64289
75;64;03;02;290;Labastide-Monréjeau;604;17;621;64290
75;64;02;16;291;Labastide-Villefranche;318;6;324;64291
75;64;03;27;292;Labatmale;255;2;257;64292
75;64;03;23;293;Labatut;170;2;172;64293
75;64;01;22;294;Labets-Biscay;159;3;162;64294
75;64;03;02;295;Labeyrie;115;3;118;64295
75;64;03;02;296;Lacadée;152;4;156;64296
75;64;01;12;297;Lacarre;169;4;173;64297
75;64;02;12;298;Lacarry-Arhan-Charritte-de-Haut;131;0;131;64298
75;64;03;09;299;Lacommande;193;6;199;64299
75;64;03;02;300;Lacq;725;12;737;64300
75;64;03;09;301;Lagor;1158;30;1188;64301
75;64;03;27;302;Lagos;468;12;480;64302
75;64;02;12;303;Laguinge-Restoue;157;8;165;64303
75;64;01;13;304;Lahonce;2506;55;2561;64304
75;64;02;16;305;Lahontan;517;12;529;64305
75;64;03;09;306;Lahourcade;699;21;720;64306
75;64;03;25;307;Lalongue;209;3;212;64307
75;64;03;25;308;Lalonquette;264;5;269;64308
75;64;03;23;309;Lamayou;204;5;209;64309
75;64;02;14;310;Lanne-en-Barétous;493;8;501;64310
75;64;03;25;311;Lannecaube;156;2;158;64311
75;64;03;16;312;LanneplaÃ ;305;9;314;64312
75;64;01;22;313;Lantabat;275;5;280;64313
75;64;01;22;314;Larceveau-Arros-Cibits;436;3;439;64314
75;64;03;08;315;Laroin;1105;27;1132;64315
75;64;02;12;316;Larrau;195;2;197;64316
75;64;01;03;317;Larressore;2140;31;2171;64317
75;64;03;02;318;Larreule;182;5;187;64318
75;64;01;22;319;Larribar-Sorhapuru;183;0;183;64319
75;64;02;15;320;Laruns;1185;23;1208;64320
75;64;03;25;321;Lasclaveries;245;5;250;64321
75;64;01;12;322;Lasse;337;6;343;64322
75;64;03;25;323;Lasserre;102;3;105;64323
75;64;02;15;324;Lasseube;1750;40;1790;64324
75;64;02;15;325;Lasseubetat;208;4;212;64325
75;64;02;09;326;Lay-Lamidou;118;4;122;64326
75;64;01;12;327;Lecumberry;170;4;174;64327
75;64;02;15;328;Ledeuix;1029;29;1058;64328
75;64;03;23;329;Lée;1257;59;1316;64329
75;64;02;14;330;Lées-Athas;250;9;259;64330
75;64;03;25;331;Lembeye;768;16;784;64331
75;64;03;25;332;Lème;166;4;170;64332
75;64;02;16;334;Léren;218;3;221;64334
75;64;03;11;335;Lescar;9665;419;10084;64335
75;64;02;14;336;Lescun;168;1;169;64336
75;64;03;25;337;Lespielle;150;3;153;64337
75;64;03;23;338;Lespourcy;189;6;195;64338
75;64;03;27;339;Lestelle-Bétharram;825;81;906;64339
75;64;02;12;340;Lichans-Sunhar;84;1;85;64340
75;64;02;12;341;Lichos;135;1;136;64341
75;64;02;12;342;Licq-Athérey;201;7;208;64342
75;64;03;27;343;Limendous;734;8;742;64343
75;64;03;27;344;Livron;381;16;397;64344
75;64;01;22;345;Lohitzun-Oyhercq;203;1;204;64345
75;64;03;23;346;Lombia;206;1;207;64346
75;64;03;02;347;Lonçon;209;3;212;64347
75;64;03;11;348;Lons;13707;250;13957;64348
75;64;03;09;349;Loubieng;503;18;521;64349
75;64;01;03;350;Louhossoa;858;18;876;64350
75;64;02;14;351;Lourdios-Ichère;136;9;145;64351
75;64;03;27;352;Lourenties;391;10;401;64352
75;64;02;15;353;Louvie-Juzon;1042;28;1070;64353
75;64;02;15;354;Louvie-Soubiron;124;1;125;64354
75;64;03;02;355;Louvigny;139;2;141;64355
75;64;03;25;356;Luc-Armau;110;0;110;64356
75;64;03;25;357;Lucarré;63;0;63;64357
75;64;03;27;358;Lucgarier;251;1;252;64358
75;64;03;09;359;Lucq-de-Béarn;919;20;939;64359
75;64;02;14;360;Lurbe-Saint-Christau;190;6;196;64360
75;64;03;25;361;Lussagnet-Lusson;179;8;187;64361
75;64;01;22;362;Luxe-Sumberraute;410;22;432;64362
75;64;02;15;363;Lys;327;4;331;64363
75;64;01;03;364;Macaye;584;10;594;64364
75;64;03;02;365;Malaussanne;408;7;415;64365
75;64;03;25;366;MascaraÃ s-Haron;123;0;123;64366
75;64;03;09;367;Maslacq;882;25;907;64367
75;64;01;22;368;Masparraute;250;7;257;64368
75;64;03;25;369;Maspie-Lalonquère-Juillacq;250;11;261;64369
75;64;03;23;370;Maucor;560;16;576;64370
75;64;02;12;371;Mauléon-Licharre;2947;236;3183;64371
75;64;03;23;372;Maure;94;1;95;64372
75;64;03;20;373;Mazères-Lezons;1823;43;1866;64373
75;64;03;02;374;Mazerolles;1139;19;1158;64374
75;64;01;22;375;Méharin;279;4;283;64375
75;64;03;17;376;Meillon;929;26;955;64376
75;64;01;22;377;Mendionde;838;23;861;64377
75;64;02;12;378;Menditte;204;128;332;64378
75;64;01;12;379;Mendive;161;5;166;64379
75;64;03;02;380;Méracq;231;5;236;64380
75;64;02;09;381;Méritein;282;9;291;64381
75;64;03;02;382;Mesplède;344;10;354;64382
75;64;03;02;383;Mialos;133;1;134;64383
75;64;03;25;385;Miossens-Lanusse;275;2;277;64385
75;64;03;27;386;Mirepeix;1258;26;1284;64386
75;64;03;02;387;Momas;606;12;618;64387
75;64;03;23;388;Momy;116;1;117;64388
75;64;03;25;389;Monassut-Audiracq;366;6;372;64389
75;64;03;25;390;Moncaup;159;12;171;64390
75;64;02;12;391;Moncayolle-Larrory-Mendibieu;306;7;313;64391
75;64;03;25;392;Moncla;83;2;85;64392
75;64;03;09;393;Monein;4435;105;4540;64393
75;64;03;25;394;Monpezat;84;1;85;64394
75;64;03;23;395;Monségur;124;0;124;64395
75;64;03;02;396;Mont;1137;95;1232;64396
75;64;03;02;397;Montagut;118;6;124;64397
75;64;03;23;398;Montaner;430;8;438;64398
75;64;03;25;399;Montardon;2323;306;2629;64399
75;64;03;27;400;Montaut;1101;46;1147;64400
75;64;03;25;401;Mont-Disse;78;1;79;64401
75;64;02;16;403;Montfort;178;3;181;64403
75;64;02;12;404;Montory;309;8;317;64404
75;64;03;23;405;MorlaÃ s;4356;260;4616;64405
75;64;03;02;406;Morlanne;613;16;629;64406
75;64;01;13;407;Mouguerre;5294;148;5442;64407
75;64;03;25;408;Mouhous;60;0;60;64408
75;64;02;14;409;Moumour;831;22;853;64409
75;64;03;09;410;Mourenx;6122;180;6302;64410
75;64;02;12;411;Musculdy;236;3;239;64411
75;64;02;09;412;Nabas;94;1;95;64412
75;64;03;17;413;Narcastet;762;12;774;64413
75;64;02;16;414;Narp;112;2;114;64414
75;64;03;25;415;Navailles-Angos;1522;33;1555;64415
75;64;02;09;416;Navarrenx;1052;23;1075;64416
75;64;03;17;417;Nay;3265;236;3501;64417
75;64;03;09;418;Noguères;138;3;141;64418
75;64;03;27;419;Nousty;1597;30;1627;64419
75;64;02;09;420;Ogenne-Camptort;245;5;250;64420
75;64;02;15;421;Ogeu-les-Bains;1276;29;1305;64421
75;64;02;98;422;Oloron-Sainte-Marie;10594;639;11233;64422
75;64;02;16;423;OraÃ s;182;3;185;64423
75;64;02;12;424;Ordiarp;540;4;544;64424
75;64;01;22;425;Orègue;487;9;496;64425
75;64;02;14;426;Orin;249;10;259;64426
75;64;02;16;427;Orion;148;2;150;64427
75;64;02;16;428;Orriule;139;1;140;64428
75;64;01;22;429;Orsanco;114;4;118;64429
75;64;03;16;430;Orthez;10369;678;11047;64430
75;64;03;09;431;Os-Marsillon;536;9;545;64431
75;64;02;12;432;Ossas-Suhare;85;1;86;64432
75;64;02;14;433;Osse-en-Aspe;330;19;349;64433
75;64;02;16;434;Ossenx;50;1;51;64434
75;64;01;22;435;Osserain-Rivareyte;214;9;223;64435
75;64;01;12;436;Ossès;816;22;838;64436
75;64;01;22;437;Ostabat-Asme;195;2;197;64437
75;64;03;23;438;Ouillon;539;13;552;64438
75;64;03;23;439;Ousse;1669;51;1720;64439
75;64;03;09;440;Ozenx-Montestrucq;388;17;405;64440
75;64;01;22;441;Pagolle;261;5;266;64441
75;64;03;09;442;Parbayse;335;11;346;64442
75;64;03;09;443;Pardies;860;23;883;64443
75;64;03;17;444;Pardies-Piétat;462;11;473;64444
75;64;03;99;445;Pau;75627;1443;77070;64445
75;64;03;25;446;Peyrelongue-Abos;157;1;158;64446
75;64;03;02;447;Piets-Plasence-Moustrou;140;1;141;64447
75;64;03;11;448;Poey-de-Lescar;1772;50;1822;64448
75;64;02;15;449;Poey-d'Oloron;164;3;167;64449
75;64;03;02;450;Pomps;295;6;301;64450
75;64;03;23;451;Ponson-Debat-Pouts;97;3;100;64451
75;64;03;27;452;Ponson-Dessus;260;7;267;64452
75;64;03;27;453;Pontacq;2925;57;2982;64453
75;64;03;23;454;Pontiacq-Viellepinte;186;2;188;64454
75;64;03;25;455;Portet;167;3;170;64455
75;64;03;25;456;Pouliacq;51;3;54;64456
75;64;03;02;457;Poursiugues-Boucoue;187;4;191;64457
75;64;02;14;458;Préchacq-Josbaig;295;8;303;64458
75;64;02;09;459;Préchacq-Navarrenx;173;2;175;64459
75;64;02;15;460;Précilhon;405;7;412;64460
75;64;03;16;461;Puyoô;1125;17;1142;64461
75;64;03;16;462;Ramous;494;6;500;64462
75;64;02;15;463;Rébénacq;663;6;669;64463
75;64;03;25;464;Ribarrouy;83;1;84;64464
75;64;03;23;465;Riupeyrous;224;3;227;64465
75;64;02;09;466;Rivehaute;266;7;273;64466
75;64;03;17;467;Rontignon;849;16;865;64467
75;64;02;12;468;Roquiague;122;2;124;64468
75;64;03;17;469;Saint-Abit;311;8;319;64469
75;64;03;23;470;Saint-Armou;656;21;677;64470
75;64;03;16;471;Saint-Boès;361;12;373;64471
75;64;03;23;472;Saint-Castin;866;11;877;64472
75;64;02;15;473;Sainte-Colome;358;4;362;64473
75;64;02;16;474;Saint-Dos;158;2;160;64474
75;64;02;12;475;Sainte-Engrâce;195;1;196;64475
75;64;01;22;476;Saint-Esteben;411;6;417;64476
75;64;01;12;477;Saint-Etienne-de-BaÃ¯gorry;1478;39;1517;64477
75;64;03;08;478;Saint-Faust;746;26;772;64478
75;64;03;16;479;Saint-Girons-en-Béarn;163;4;167;64479
75;64;02;16;480;Saint-Gladie-Arrive-Munein;198;5;203;64480
75;64;02;14;481;Saint-Goin;237;4;241;64481
75;64;03;23;482;Saint-Jammes;620;8;628;64482
75;64;01;24;483;Saint-Jean-de-Luz;14196;422;14618;64483
75;64;01;12;484;Saint-Jean-le-Vieux;840;17;857;64484
75;64;01;12;485;Saint-Jean-Pied-de-Port;1532;295;1827;64485
75;64;03;25;486;Saint-Jean-Poudge;67;0;67;64486
75;64;01;22;487;Saint-Just-Ibarre;206;5;211;64487
75;64;03;23;488;Saint-Laurent-Bretagne;447;12;459;64488
75;64;01;22;489;Saint-Martin-d'Arberoue;332;10;342;64489
75;64;01;12;490;Saint-Martin-d'Arrossa;538;15;553;64490
75;64;03;02;491;Saint-Médard;202;5;207;64491
75;64;01;12;492;Saint-Michel;292;6;298;64492
75;64;01;22;493;Saint-Palais;1841;67;1908;64493
75;64;02;16;494;Saint-Pé-de-Léren;259;6;265;64494
75;64;01;26;495;Saint-Pée-sur-Nivelle;7037;152;7189;64495
75;64;01;13;496;Saint-Pierre-d'Irube;5491;97;5588;64496
75;64;03;27;498;Saint-Vincent;395;10;405;64498
75;64;02;16;499;Salies-de-Béarn;4568;129;4697;64499
75;64;03;16;500;Salles-Mongiscard;297;6;303;64500
75;64;03;02;501;Sallespisse;571;8;579;64501
75;64;01;13;502;Sames;709;6;715;64502
75;64;03;25;503;Samsons-Lion;90;1;91;64503
75;64;01;26;504;Sare;2688;37;2725;64504
75;64;03;09;505;Sarpourenx;310;14;324;64505
75;64;02;14;506;Sarrance;161;3;164;64506
75;64;03;23;507;Saubole;139;3;142;64507
75;64;02;15;508;Saucède;132;2;134;64508
75;64;02;12;509;Sauguis-Saint-Etienne;175;4;179;64509
75;64;03;02;510;Sault-de-Navailles;941;19;960;64510
75;64;03;25;511;Sauvagnon;3411;86;3497;64511
75;64;03;09;512;Sauvelade;265;4;269;64512
75;64;02;16;513;Sauveterre-de-Béarn;1370;96;1466;64513
75;64;03;02;514;Séby;196;7;203;64514
75;64;03;23;515;Sedze-Maubecq;252;4;256;64515
75;64;03;23;516;Sedzère;384;3;387;64516
75;64;03;25;517;Séméacq-Blachon;160;8;168;64517
75;64;03;23;518;Sendets;1048;21;1069;64518
75;64;03;25;519;Serres-Castet;4348;126;4474;64519
75;64;03;23;520;Serres-MorlaÃ s;829;33;862;64520
75;64;03;02;521;Serres-Sainte-Marie;571;17;588;64521
75;64;02;15;522;Sévignacq-Meyracq;530;15;545;64522
75;64;03;25;523;Sévignacq;764;14;778;64523
75;64;03;25;524;Simacourbe;417;2;419;64524
75;64;03;11;525;Siros;773;15;788;64525
75;64;03;27;526;Soumoulou;1583;20;1603;64526
75;64;01;03;527;SouraÃ¯de;1497;29;1526;64527
75;64;01;22;528;Suhescun;168;8;176;64528
75;64;02;09;529;Sus;377;11;388;64529
75;64;02;09;530;Susmiou;352;7;359;64530
75;64;02;16;531;Tabaille-Usquain;46;2;48;64531
75;64;03;25;532;Tadousse-Ussau;70;1;71;64532
75;64;02;12;533;Tardets-Sorholus;558;9;567;64533
75;64;03;25;534;Taron-Sadirac-Viellenave;192;0;192;64534
75;64;03;09;535;Tarsacq;530;6;536;64535
75;64;03;25;536;Thèze;858;16;874;64536
75;64;02;12;537;Trois-Villes;129;4;133;64537
75;64;01;12;538;Uhart-Cize;803;16;819;64538
75;64;01;22;539;Uhart-Mixe;210;5;215;64539
75;64;01;13;540;Urcuit;2725;73;2798;64540
75;64;03;02;541;Urdès;310;3;313;64541
75;64;02;14;542;Urdos;66;1;67;64542
75;64;01;12;543;Urepel;277;7;284;64543
75;64;03;23;544;Urost;76;2;78;64544
75;64;01;10;545;Urrugne;10418;193;10611;64545
75;64;01;13;546;Urt;2323;34;2357;64546
75;64;01;26;547;Ustaritz;6918;260;7178;64547
75;64;03;02;548;Uzan;166;4;170;64548
75;64;03;11;549;Uzein;1228;24;1252;64549
75;64;03;17;550;Uzos;767;30;797;64550
75;64;02;15;551;Verdets;287;4;291;64551
75;64;03;25;552;Vialer;183;3;186;64552
75;64;03;02;554;Viellenave-d'Arthez;210;3;213;64554
75;64;02;09;555;Viellenave-de-Navarrenx;166;2;168;64555
75;64;03;09;556;Vielleségure;385;8;393;64556
75;64;03;02;557;Vignes;458;22;480;64557
75;64;01;13;558;Villefranque;2822;78;2900;64558
75;64;02;12;559;Viodos-Abense-de-Bas;728;16;744;64559
75;64;03;25;560;Viven;178;0;178;64560
76;65;01;16;001;Adast;297;7;304;65001
76;65;01;06;002;Adé;826;10;836;65002
76;65;02;08;003;Adervielle-Pouchergues;143;1;144;65003
76;65;01;16;004;Agos-Vidalos;409;10;419;65004
76;65;03;07;005;Allier;433;11;444;65005
76;65;02;08;006;Ancizan;269;8;277;65006
76;65;03;17;007;Andrest;1379;26;1405;65007
76;65;02;15;009;Anères;171;4;175;65009
76;65;03;07;010;Angos;223;4;227;65010
76;65;01;06;011;Les Angles;130;3;133;65011
76;65;02;15;012;Anla;81;2;83;65012
76;65;03;13;013;Ansost;57;2;59;65013
76;65;02;15;014;Antichan;40;0;40;65014
76;65;03;03;015;Antin;105;7;112;65015
76;65;02;04;016;Antist;183;3;186;65016
76;65;02;08;017;Aragnouet;249;2;251;65017
76;65;01;16;018;Arbéost;84;1;85;65018
76;65;03;07;019;Arcizac-Adour;559;11;570;65019
76;65;01;06;020;Arcizac-ez-Angles;263;5;268;65020
76;65;01;16;021;Arcizans-Avant;390;15;405;65021
76;65;01;16;022;Arcizans-Dessus;118;7;125;65022
76;65;02;08;023;Ardengost;13;0;13;65023
76;65;02;14;024;Argelès-Bagnères;105;3;108;65024
76;65;01;16;025;Argelès-Gazost;2911;170;3081;65025
76;65;03;03;026;Aries-Espénan;75;0;75;65026
76;65;02;15;028;Arné;206;5;211;65028
76;65;01;16;029;Arras-en-Lavedan;482;11;493;65029
76;65;02;08;031;Arreau;792;27;819;65031
76;65;01;16;032;Arrens-Marsous;700;20;720;65032
76;65;01;06;033;Arrodets-ez-Angles;113;3;116;65033
76;65;02;14;034;Arrodets;19;0;19;65034
76;65;03;17;035;Artagnan;518;12;530;65035
76;65;01;16;036;Artalens-Souin;132;3;135;65036
76;65;02;14;037;Artiguemy;88;1;89;65037
76;65;01;06;038;Artigues;14;1;15;65038
76;65;02;08;039;Aspin-Aure;40;0;40;65039
76;65;01;05;040;Aspin-en-Lavedan;321;3;324;65040
76;65;02;14;041;Asque;119;7;126;65041
76;65;02;04;042;Asté;575;12;587;65042
76;65;02;04;043;Astugue;263;7;270;65043
76;65;03;03;044;Aubarède;298;6;304;65044
76;65;01;16;045;Aucun;230;9;239;65045
76;65;02;08;046;Aulon;93;3;96;65046
76;65;03;01;047;Aureilhan;7864;223;8087;65047
76;65;03;17;048;Aurensan;789;10;799;65048
76;65;03;13;049;Auriébat;241;3;244;65049
76;65;02;08;050;Avajan;79;2;81;65050
76;65;02;15;051;Aventignan;208;7;215;65051
76;65;03;09;052;Averan;66;0;66;65052
76;65;02;15;053;Aveux;42;1;43;65053
76;65;02;08;054;Avezac-Prat-Lahitte;610;8;618;65054
76;65;01;16;055;Ayros-Arbouix;334;12;346;65055
76;65;01;16;056;Ayzac-Ost;453;13;466;65056
76;65;03;09;057;Azereix;984;17;1001;65057
76;65;02;08;058;Azet;143;2;145;65058
76;65;02;04;059;Bagnères-de-Bigorre;7085;283;7368;65059
76;65;02;14;060;Banios;60;3;63;65060
76;65;03;13;061;Barbachen;51;0;51;65061
76;65;03;07;062;Barbazan-Debat;3498;76;3574;65062
76;65;03;14;063;Barbazan-Dessus;172;3;175;65063
76;65;02;08;064;Bareilles;49;1;50;65064
76;65;01;05;065;Barlest;293;8;301;65065
76;65;02;08;066;Barrancoueu;32;0;32;65066
76;65;03;09;067;Barry;128;7;135;65067
76;65;03;03;068;Barthe;23;1;24;65068
76;65;02;08;069;La Barthe-de-Neste;1224;30;1254;65069
76;65;01;05;070;Bartrès;553;18;571;65070
76;65;02;14;071;Batsère;33;0;33;65071
76;65;03;02;072;Bazet;1824;15;1839;65072
76;65;03;13;073;Bazillac;355;7;362;65073
76;65;03;03;074;Bazordan;110;2;112;65074
76;65;02;08;075;Bazus-Aure;133;7;140;65075
76;65;02;08;076;Bazus-Neste;59;2;61;65076
76;65;01;16;077;Beaucens;418;24;442;65077
76;65;02;04;078;Beaudéan;399;10;409;65078
76;65;03;14;079;Bégole;198;4;202;65079
76;65;03;09;080;Bénac;557;9;566;65080
76;65;02;14;081;Benqué-Molère;135;3;138;65081
76;65;01;06;082;Berbérust-Lias;51;0;51;65082
76;65;03;07;083;Bernac-Debat;706;17;723;65083
76;65;03;07;084;Bernac-Dessus;290;3;293;65084
76;65;03;03;085;Bernadets-Debat;111;2;113;65085
76;65;03;14;086;Bernadets-Dessus;151;6;157;65086
76;65;02;15;087;Bertren;177;5;182;65087
76;65;03;03;088;Betbèze;47;1;48;65088
76;65;01;16;089;Betpouey;85;3;88;65089
76;65;03;03;090;Betpouy;79;3;82;65090
76;65;02;14;091;Bettes;56;1;57;65091
76;65;02;08;092;Beyrède-Jumet-Camous;226;2;228;65092
76;65;02;15;093;Bize;209;8;217;65093
76;65;02;15;094;Bizous;122;1;123;65094
76;65;03;03;095;Bonnefont;331;11;342;65095
76;65;02;14;096;Bonnemazon;64;3;67;65096
76;65;02;14;097;Bonrepos;190;8;198;65097
76;65;01;16;098;Boô-Silhen;325;7;332;65098
76;65;02;08;099;Bordères-Louron;141;3;144;65099
76;65;03;02;100;Bordères-sur-l'Echez;5357;114;5471;65100
76;65;03;14;101;Bordes;762;12;774;65101
76;65;03;13;102;Bouilh-Devant;20;2;22;65102
76;65;03;03;103;Bouilh-Péreuilh;109;1;110;65103
76;65;03;03;104;Boulin;295;9;304;65104
76;65;02;14;105;Bourg-de-Bigorre;196;3;199;65105
76;65;02;08;106;Bourisp;165;4;169;65106
76;65;01;06;107;Bourréac;111;2;113;65107
76;65;03;02;108;Bours;865;19;884;65108
76;65;02;15;109;Bramevaque;31;1;32;65109
76;65;03;03;110;Bugard;96;0;96;65110
76;65;02;14;111;Bulan;64;0;64;65111
76;65;01;16;112;Bun;156;5;161;65112
76;65;03;14;113;Burg;282;11;293;65113
76;65;03;13;114;Buzon;75;4;79;65114
76;65;03;03;115;Cabanac;289;10;299;65115
76;65;02;08;116;Cadéac;299;5;304;65116
76;65;02;08;117;Cadeilhan-Trachère;42;1;43;65117
76;65;03;14;118;Caharet;38;1;39;65118
76;65;03;17;119;Caixon;368;11;379;65119
76;65;03;14;120;Calavanté;337;14;351;65120
76;65;03;17;121;Camalès;390;11;401;65121
76;65;02;04;123;Campan;1313;54;1367;65123
76;65;02;08;124;Camparan;57;2;59;65124
76;65;02;15;125;Campistrous;313;7;320;65125
76;65;03;03;126;Campuzan;147;5;152;65126
76;65;02;08;127;Capvern;1264;26;1290;65127
76;65;02;14;128;Castelbajac;138;3;141;65128
76;65;03;03;129;Castelnau-Magnoac;799;22;821;65129
76;65;03;13;130;Castelnau-Rivière-Basse;614;12;626;65130
76;65;03;03;131;Castelvieilh;245;2;247;65131
76;65;03;14;132;Castéra-Lanusse;44;0;44;65132
76;65;03;03;133;Castéra-Lou;235;4;239;65133
76;65;03;03;134;Casterets;13;0;13;65134
76;65;02;14;135;Castillon;82;0;82;65135
76;65;03;03;136;Caubous;34;0;34;65136
76;65;03;13;137;Caussade-Rivière;96;3;99;65137
76;65;01;16;138;Cauterets;878;19;897;65138
76;65;02;15;139;Cazarilh;54;1;55;65139
76;65;02;08;140;Cazaux-Debat;31;1;32;65140
76;65;02;08;141;Cazaux-Fréchet-Anéran-Camors;56;3;59;65141
76;65;03;03;142;Chelle-Debat;211;4;215;65142
76;65;02;14;143;Chelle-Spou;113;2;115;65143
76;65;01;06;144;Cheust;87;2;89;65144
76;65;01;16;145;Chèze;49;0;49;65145
76;65;03;02;146;Chis;312;1;313;65146
76;65;02;14;147;Cieutat;608;12;620;65147
76;65;03;03;148;Cizos;133;1;134;65148
76;65;03;14;149;Clarac;169;4;173;65149
76;65;02;15;150;Clarens;499;25;524;65150
76;65;03;03;151;Collongues;146;4;150;65151
76;65;03;03;153;Coussan;122;5;127;65153
76;65;02;15;154;Créchets;59;0;59;65154
76;65;03;03;155;Devèze;52;2;54;65155
76;65;03;03;156;Dours;217;5;222;65156
76;65;02;08;157;Ens;21;2;23;65157
76;65;02;15;158;Esbareich;82;0;82;65158
76;65;02;08;159;Escala;361;11;372;65159
76;65;03;17;160;Escaunets;120;3;123;65160
76;65;03;13;161;Escondeaux;282;4;286;65161
76;65;02;14;162;Esconnets;33;1;34;65162
76;65;02;14;163;Escots;39;1;40;65163
76;65;01;06;164;Escoubès-Pouts;107;2;109;65164
76;65;02;08;165;Esparros;188;1;189;65165
76;65;02;14;166;Espèche;53;0;53;65166
76;65;02;14;167;Espieilh;26;1;27;65167
76;65;01;16;168;Esquièze-Sère;406;12;418;65168
76;65;01;16;169;Estaing;90;2;92;65169
76;65;03;03;170;Estampures;78;2;80;65170
76;65;02;08;171;Estarvielle;39;0;39;65171
76;65;02;08;172;Estensan;39;0;39;65172
76;65;01;16;173;Esterre;193;7;200;65173
76;65;03;13;174;Estirac;105;4;109;65174
76;65;02;15;175;Ferrère;40;3;43;65175
76;65;01;16;176;Ferrières;83;0;83;65176
76;65;03;03;177;Fontrailles;161;3;164;65177
76;65;03;03;178;Fréchède;53;0;53;65178
76;65;02;14;179;Fréchendets;27;0;27;65179
76;65;02;08;180;Fréchet-Aure;13;0;13;65180
76;65;03;14;181;Fréchou-Fréchet;164;3;167;65181
76;65;01;16;182;Gaillagos;124;1;125;65182
76;65;02;14;183;Galan;702;13;715;65183
76;65;02;14;184;Galez;173;2;175;65184
76;65;03;09;185;Gardères;445;11;456;65185
76;65;02;15;186;Gaudent;35;0;35;65186
76;65;03;03;187;Gaussan;100;4;104;65187
76;65;03;17;189;Gayan;281;2;283;65189
76;65;02;08;190;Gazave;71;0;71;65190
76;65;01;06;191;Gazost;123;2;125;65191
76;65;01;16;192;Gavarnie-Gèdre;341;9;350;65192
76;65;02;15;193;Gembrie;87;4;91;65193
76;65;02;15;194;Générest;97;3;100;65194
76;65;02;08;195;Génos;139;0;139;65195
76;65;03;13;196;Gensac;90;2;92;65196
76;65;01;06;197;Ger;155;9;164;65197
76;65;02;04;198;Gerde;1117;34;1151;65198
76;65;02;08;199;Germ;36;0;36;65199
76;65;01;06;200;Germs-sur-l'Oussouet;107;1;108;65200
76;65;01;06;201;Geu;183;4;187;65201
76;65;01;16;202;Gez;331;13;344;65202
76;65;01;06;203;Gez-ez-Angles;27;1;28;65203
76;65;03;03;204;Gonez;27;0;27;65204
76;65;02;08;205;Gouaux;54;1;55;65205
76;65;03;14;206;Goudon;230;6;236;65206
76;65;02;14;207;Gourgue;64;0;64;65207
76;65;02;08;208;Grailhen;23;2;25;65208
76;65;02;08;209;Grézian;78;0;78;65209
76;65;01;16;210;Grust;35;1;36;65210
76;65;02;08;211;Guchan;148;5;153;65211
76;65;02;08;212;Guchen;330;11;341;65212
76;65;03;03;213;Guizerix;121;3;124;65213
76;65;03;03;214;Hachan;44;0;44;65214
76;65;03;13;215;Hagedet;44;2;46;65215
76;65;02;14;216;Hauban;104;0;104;65216
76;65;02;15;217;Hautaget;55;2;57;65217
76;65;02;08;218;Hèches;613;14;627;65218
76;65;03;13;219;Hères;122;1;123;65219
76;65;03;09;220;Hibarette;240;1;241;65220
76;65;02;04;221;Hiis;255;5;260;65221
76;65;03;14;222;Hitte;163;1;164;65222
76;65;03;07;223;Horgues;1195;26;1221;65223
76;65;02;14;224;Houeydets;281;6;287;65224
76;65;03;03;225;Hourc;105;1;106;65225
76;65;03;02;226;Ibos;2906;138;3044;65226
76;65;02;08;228;Ilhet;121;0;121;65228
76;65;02;15;229;Ilheu;45;0;45;65229
76;65;02;15;230;Izaourt;255;6;261;65230
76;65;02;08;231;Izaux;200;12;212;65231
76;65;03;03;232;Jacque;68;2;70;65232
76;65;01;06;233;Jarret;315;4;319;65233
76;65;02;08;234;Jézeau;93;3;96;65234
76;65;03;09;235;Juillan;4045;95;4140;65235
76;65;01;06;236;Julos;441;12;453;65236
76;65;01;06;237;Juncalas;160;5;165;65237
76;65;02;04;238;Labassère;236;10;246;65238
76;65;02;08;239;Labastide;154;5;159;65239
76;65;03;13;240;Labatut-Rivière;385;6;391;65240
76;65;02;08;241;Laborde;85;3;88;65241
76;65;03;13;242;Lacassagne;238;3;241;65242
76;65;03;13;243;Lafitole;458;18;476;65243
76;65;03;17;244;Lagarde;529;7;536;65244
76;65;02;15;245;Lagrange;234;7;241;65245
76;65;01;06;247;Arrayou-Lahitte;104;1;105;65247
76;65;03;13;248;Lahitte-Toupière;258;17;275;65248
76;65;03;03;249;Lalanne;101;5;106;65249
76;65;03;03;250;Lalanne-Trie;118;1;119;65250
76;65;03;07;251;Laloubère;1877;65;1942;65251
76;65;03;09;252;Lamarque-Pontacq;866;14;880;65252
76;65;03;03;253;Lamarque-Rustaing;53;0;53;65253
76;65;03;13;254;Laméac;143;4;147;65254
76;65;02;08;255;Lançon;30;0;30;65255
76;65;03;14;256;Lanespède;147;2;149;65256
76;65;03;09;257;Lanne;601;9;610;65257
76;65;02;15;258;Lannemezan;5816;159;5975;65258
76;65;03;03;259;Lansac;180;5;185;65259
76;65;03;03;260;Lapeyre;95;1;96;65260
76;65;03;03;261;Laran;48;1;49;65261
76;65;03;13;262;Larreule;400;10;410;65262
76;65;03;03;263;Larroque;95;3;98;65263
76;65;03;13;264;Lascazères;311;25;336;65264
76;65;03;03;265;Laslades;329;10;339;65265
76;65;03;03;266;Lassales;36;1;37;65266
76;65;01;16;267;Lau-Balagnas;522;17;539;65267
76;65;03;09;268;Layrisse;212;3;215;65268
76;65;03;13;269;Lescurry;168;3;171;65269
76;65;03;14;270;Lespouey;204;9;213;65270
76;65;01;06;271;Lézignan;355;4;359;65271
76;65;03;14;272;Lhez;78;0;78;65272
76;65;03;13;273;Liac;198;0;198;65273
76;65;02;14;274;Libaros;138;1;139;65274
76;65;02;14;275;Lies;74;2;76;65275
76;65;03;03;276;Lizos;117;1;118;65276
76;65;02;15;277;Lombrès;92;3;95;65277
76;65;02;14;278;Lomné;31;0;31;65278
76;65;02;08;279;Lortet;218;8;226;65279
76;65;01;05;280;Loubajac;424;2;426;65280
76;65;03;09;281;Loucrup;242;4;246;65281
76;65;02;08;282;Loudenvielle;297;6;303;65282
76;65;02;08;283;Loudervielle;50;3;53;65283
76;65;03;09;284;Louey;1040;28;1068;65284
76;65;03;03;285;Louit;188;3;191;65285
76;65;01;98;286;Lourdes;13132;317;13449;65286
76;65;02;15;287;Loures-Barousse;630;13;643;65287
76;65;03;03;288;Lubret-Saint-Luc;53;0;53;65288
76;65;03;03;289;Luby-Betmont;111;1;112;65289
76;65;03;14;290;Luc;193;1;194;65290
76;65;01;06;291;Lugagnan;135;3;138;65291
76;65;03;09;292;Luquet;401;3;404;65292
76;65;03;03;293;Lustar;104;2;106;65293
76;65;02;14;294;Lutilhous;219;3;222;65294
76;65;01;16;295;Luz-Saint-Sauveur;939;15;954;65295
76;65;03;13;296;Madiran;424;12;436;65296
76;65;03;13;297;Mansan;41;5;46;65297
76;65;03;03;298;Marquerie;85;0;85;65298
76;65;03;17;299;Marsac;222;4;226;65299
76;65;02;14;300;Marsas;67;5;72;65300
76;65;03;03;301;Marseillan;260;4;264;65301
76;65;03;14;303;Mascaras;362;4;366;65303
76;65;03;13;304;Maubourguet;2266;28;2294;65304
76;65;02;15;305;Mauléon-Barousse;92;0;92;65305
76;65;02;14;306;Mauvezin;233;4;237;65306
76;65;02;15;307;Mazères-de-Neste;337;6;343;65307
76;65;03;03;308;Mazerolles;106;4;110;65308
76;65;02;08;309;Mazouau;15;3;18;65309
76;65;02;14;310;Mérilheu;243;5;248;65310
76;65;03;13;311;Mingot;101;0;101;65311
76;65;03;07;313;Momères;744;23;767;65313
76;65;03;13;314;Monfaucon;209;6;215;65314
76;65;03;03;315;Monléon-Magnoac;419;221;640;65315
76;65;03;03;316;Monlong;103;4;107;65316
76;65;02;08;317;Mont;36;2;38;65317
76;65;02;14;318;Montastruc;227;6;233;65318
76;65;02;15;319;Montégut;137;2;139;65319
76;65;02;04;320;Montgaillard;850;18;868;65320
76;65;03;07;321;Montignac;144;2;146;65321
76;65;02;08;322;Montoussé;254;7;261;65322
76;65;02;15;323;Montsérié;82;0;82;65323
76;65;03;14;324;Moulédous;212;7;219;65324
76;65;03;13;325;Moumoulous;44;0;44;65325
76;65;03;03;326;Mun;89;3;92;65326
76;65;02;15;327;Nestier;153;2;155;65327
76;65;02;04;328;Neuilh;97;4;101;65328
76;65;02;15;329;Nistos;210;8;218;65329
76;65;03;17;330;Nouilhan;216;3;219;65330
76;65;03;07;331;Odos;3290;99;3389;65331
76;65;03;03;332;Oléac-Debat;170;1;171;65332
76;65;03;14;333;Oléac-Dessus;114;1;115;65333
76;65;01;05;334;Omex;224;3;227;65334
76;65;02;04;335;Ordizan;523;16;539;65335
76;65;03;03;336;Organ;36;0;36;65336
76;65;03;14;337;Orieux;106;3;109;65337
76;65;02;14;338;Orignac;245;3;248;65338
76;65;03;09;339;Orincles;327;7;334;65339
76;65;03;02;340;Orleix;2011;43;2054;65340
76;65;03;17;341;Oroix;111;2;113;65341
76;65;03;03;342;Osmets;95;2;97;65342
76;65;01;05;343;Ossen;246;4;250;65343
76;65;03;09;344;Ossun;2374;49;2423;65344
76;65;01;06;345;Ossun-ez-Angles;55;0;55;65345
76;65;03;14;346;Oueilloux;160;6;166;65346
76;65;02;15;347;Ourde;44;0;44;65347
76;65;01;06;348;Ourdis-Cotdoussan;46;2;48;65348
76;65;01;06;349;Ourdon;11;0;11;65349
76;65;03;02;350;Oursbelille;1197;41;1238;65350
76;65;01;06;351;Ousté;32;0;32;65351
76;65;01;16;352;Ouzous;219;8;227;65352
76;65;03;14;353;Ozon;259;10;269;65353
76;65;02;08;354;Pailhac;71;2;73;65354
76;65;01;06;355;Paréac;71;0;71;65355
76;65;02;14;356;Péré;59;2;61;65356
76;65;03;14;357;Peyraube;168;3;171;65357
76;65;03;03;358;Peyret-Saint-André;52;2;54;65358
76;65;03;03;359;Peyriguère;30;0;30;65359
76;65;01;05;360;Peyrouse;276;8;284;65360
76;65;03;13;361;Peyrun;93;0;93;65361
76;65;01;16;362;Pierrefitte-Nestalas;1126;25;1151;65362
76;65;02;15;363;Pinas;450;9;459;65363
76;65;03;17;364;Pintac;21;3;24;65364
76;65;01;05;366;Poueyferré;843;17;860;65366
76;65;03;14;367;Poumarous;164;3;167;65367
76;65;03;03;368;Pouy;43;2;45;65368
76;65;03;03;369;Pouyastruc;647;22;669;65369
76;65;02;04;370;Pouzac;1115;38;1153;65370
76;65;01;16;371;Préchac;234;10;244;65371
76;65;03;17;372;Pujo;644;14;658;65372
76;65;03;03;373;Puntous;165;4;169;65373
76;65;03;03;374;Puydarrieux;232;1;233;65374
76;65;03;13;375;Rabastens-de-Bigorre;1447;25;1472;65375
76;65;02;14;376;Recurt;223;9;232;65376
76;65;02;15;377;Réjaumont;158;8;166;65377
76;65;03;14;378;Ricaud;67;2;69;65378
76;65;02;08;379;Ris;15;0;15;65379
76;65;03;03;380;Sabalos;149;1;150;65380
76;65;02;14;381;Sabarros;34;0;34;65381
76;65;02;15;382;Sacoué;74;3;77;65382
76;65;03;03;383;Sadournin;193;2;195;65383
76;65;02;08;384;Sailhan;173;1;174;65384
76;65;02;08;385;Saint-Arroman;93;2;95;65385
76;65;01;06;386;Saint-Créac;97;0;97;65386
76;65;03;13;387;Saint-Lanne;128;2;130;65387
76;65;02;08;388;Saint-Lary-Soulan;844;18;862;65388
76;65;02;15;389;Saint-Laurent-de-Neste;943;38;981;65389
76;65;03;17;390;Saint-Lézer;426;14;440;65390
76;65;02;15;391;Sainte-Marie;59;0;59;65391
76;65;03;07;392;Saint-Martin;445;8;453;65392
76;65;01;16;393;Saint-Pastous;142;5;147;65393
76;65;02;15;394;Saint-Paul;318;3;321;65394
76;65;01;05;395;Saint-Pé-de-Bigorre;1159;19;1178;65395
76;65;01;16;396;Saint-Savin;360;7;367;65396
76;65;03;13;397;Saint-Sever-de-Rustan;165;3;168;65397
76;65;02;15;398;Saléchan;254;2;256;65398
76;65;01;16;399;Saligos;102;3;105;65399
76;65;01;16;400;Salles;229;7;236;65400
76;65;03;07;401;Salles-Adour;581;24;605;65401
76;65;02;15;402;Samuran;25;0;25;65402
76;65;03;17;403;Sanous;100;2;102;65403
76;65;03;03;404;Sariac-Magnoac;154;3;157;65404
76;65;02;14;405;Sarlabous;75;3;78;65405
76;65;03;17;406;Sarniguet;257;5;262;65406
76;65;02;15;407;Sarp;107;2;109;65407
76;65;02;08;408;Sarrancolin;563;20;583;65408
76;65;03;13;409;Sarriac-Bigorre;301;5;306;65409
76;65;03;07;410;Sarrouilles;518;17;535;65410
76;65;01;16;411;Sassis;77;6;83;65411
76;65;03;13;412;Sauveterre;167;4;171;65412
76;65;01;16;413;Sazos;139;4;143;65413
76;65;03;13;414;Ségalas;79;4;83;65414
76;65;01;05;415;Ségus;242;1;243;65415
76;65;02;15;416;Seich;86;3;89;65416
76;65;03;01;417;Séméac;5085;103;5188;65417
76;65;03;13;418;Sénac;291;7;298;65418
76;65;02;14;419;Sentous;68;0;68;65419
76;65;01;16;420;Sère-en-Lavedan;77;2;79;65420
76;65;01;06;421;Sère-Lanso;50;2;52;65421
76;65;03;09;422;Séron;332;3;335;65422
76;65;03;03;423;Sère-Rustaing;131;1;132;65423
76;65;01;16;424;Sers;117;2;119;65424
76;65;03;17;425;Siarrouy;447;7;454;65425
76;65;03;14;426;Sinzos;132;6;138;65426
76;65;02;15;427;Siradan;283;5;288;65427
76;65;01;16;428;Sireix;63;1;64;65428
76;65;03;13;429;Sombrun;206;8;214;65429
76;65;03;03;430;Soréac;43;1;44;65430
76;65;02;15;431;Sost;95;4;99;65431
76;65;03;13;432;Soublecause;180;5;185;65432
76;65;03;01;433;Soues;3066;58;3124;65433
76;65;01;16;435;Soulom;274;4;278;65435
76;65;03;03;436;Souyeaux;305;7;312;65436
76;65;02;15;437;Tajan;129;3;132;65437
76;65;03;17;438;Talazac;76;1;77;65438
76;65;03;17;439;Tarasteix;271;3;274;65439
76;65;03;99;440;Tarbes;42758;1063;43821;65440
76;65;02;15;441;Thèbe;78;3;81;65441
76;65;03;03;442;Thermes-Magnoac;211;1;212;65442
76;65;03;03;443;Thuy;17;0;17;65443
76;65;02;15;444;Tibiran-Jaunac;319;4;323;65444
76;65;02;14;445;Tilhouse;227;6;233;65445
76;65;03;13;446;Tostat;547;8;555;65446
76;65;03;14;447;Tournay;1172;21;1193;65447
76;65;03;03;448;Tournous-Darré;92;4;96;65448
76;65;02;14;449;Tournous-Devant;90;5;95;65449
76;65;02;08;450;TramezaÃ¯gues;37;1;38;65450
76;65;02;04;451;Trébons;753;14;767;65451
76;65;03;03;452;Trie-sur-BaÃ¯se;1007;26;1033;65452
76;65;02;15;453;Troubat;75;0;75;65453
76;65;03;13;454;Trouley-Labarthe;104;1;105;65454
76;65;02;15;455;Tuzaguet;438;9;447;65455
76;65;02;15;456;Uglas;288;11;299;65456
76;65;03;13;457;Ugnouas;83;1;84;65457
76;65;01;16;458;Uz;31;1;32;65458
76;65;02;14;459;Uzer;102;4;106;65459
76;65;03;17;460;Vic-en-Bigorre;4843;268;5111;65460
76;65;03;03;461;Vidou;112;1;113;65461
76;65;03;13;462;Vidouze;243;9;252;65462
76;65;01;16;463;Viella;85;1;86;65463
76;65;03;07;464;Vielle-Adour;505;10;515;65464
76;65;02;08;465;Vielle-Aure;325;10;335;65465
76;65;02;08;466;Vielle-Louron;86;1;87;65466
76;65;01;16;467;Vier-Bordes;98;6;104;65467
76;65;03;03;468;Vieuzos;40;1;41;65468
76;65;01;16;469;Viey;25;1;26;65469
76;65;01;05;470;Viger;144;4;148;65470
76;65;02;08;471;Vignec;215;8;223;65471
76;65;03;13;472;Villefranque;76;5;81;65472
76;65;01;16;473;Villelongue;397;15;412;65473
76;65;03;03;474;Villembits;112;2;114;65474
76;65;03;03;475;Villemur;60;1;61;65475
76;65;03;17;476;Villenave-près-Béarn;64;4;68;65476
76;65;03;17;477;Villenave-près-Marsac;101;2;103;65477
76;65;01;16;478;Viscos;32;2;34;65478
76;65;03;09;479;Visker;351;10;361;65479
76;65;01;16;481;Barèges;159;5;164;65481
76;65;02;15;482;Cantaous;442;11;453;65482
76;66;01;17;001;L'Albère;73;1;74;66001
76;66;01;12;002;Alénya;3645;61;3706;66002
76;66;01;02;003;Amélie-les-Bains-Palalda;3542;47;3589;66003
76;66;03;13;004;Les Angles;553;8;561;66004
76;66;03;13;005;Angoustrine-Villeneuve-des-Escaldes;561;34;595;66005
76;66;03;15;006;Ansignan;165;2;167;66006
76;66;03;15;007;Arboussols;124;3;127;66007
76;66;01;05;008;Argelès-sur-Mer;10260;248;10508;66008
76;66;01;02;009;Arles-sur-Tech;2724;38;2762;66009
76;66;03;13;010;Ayguatébia-Talau;36;0;36;66010
76;66;01;12;011;Bages;4291;51;4342;66011
76;66;02;14;012;Baho;3431;64;3495;66012
76;66;03;02;013;Baillestavy;117;3;120;66013
76;66;02;14;014;Baixas;2612;50;2662;66014
76;66;01;01;015;Banyuls-dels-Aspres;1271;22;1293;66015
76;66;01;05;016;Banyuls-sur-Mer;4738;77;4815;66016
76;66;02;04;017;Le Barcarès;5771;40;5811;66017
76;66;01;02;018;La Bastide;68;0;68;66018
76;66;03;15;019;Bélesta;216;4;220;66019
76;66;03;13;020;Bolquère;818;26;844;66020
76;66;02;07;021;Bompas;7426;105;7531;66021
76;66;03;02;022;Boule-d'Amont;55;0;55;66022
76;66;03;02;023;Bouleternère;949;8;957;66023
76;66;01;17;024;Le Boulou;5278;55;5333;66024
76;66;03;13;025;Bourg-Madame;1207;75;1282;66025
76;66;01;01;026;Brouilla;1532;32;1564;66026
76;66;03;13;027;La Cabanasse;694;14;708;66027
76;66;02;08;028;Cabestany;10301;206;10507;66028
76;66;01;01;029;Caixas;134;1;135;66029
76;66;02;14;030;Calce;213;2;215;66030
76;66;01;01;032;Calmeilles;59;0;59;66032
76;66;01;01;033;Camélas;460;13;473;66033
76;66;03;13;034;Campôme;111;5;116;66034
76;66;03;15;035;Campoussy;40;0;40;66035
76;66;03;13;036;Canaveilles;24;0;24;66036
76;66;02;03;037;Canet-en-Roussillon;12284;251;12535;66037
76;66;02;10;038;Canohès;6344;115;6459;66038
76;66;03;15;039;Caramany;137;1;138;66039
76;66;03;02;040;Casefabre;41;1;42;66040
76;66;02;15;041;Cases-de-Pène;940;20;960;66041
76;66;02;15;042;Cassagnes;265;6;271;66042
76;66;03;02;043;Casteil;136;2;138;66043
76;66;01;01;044;Castelnou;293;6;299;66044
76;66;03;13;045;Catllar;780;15;795;66045
76;66;03;15;046;Caudiès-de-Fenouillèdes;603;11;614;66046
76;66;03;13;047;Caudiès-de-Conflent;18;2;20;66047
76;66;01;05;048;Cerbère;1345;16;1361;66048
76;66;01;17;049;Céret;7857;233;8090;66049
76;66;02;04;050;Claira;4470;54;4524;66050
76;66;03;13;051;Clara-Villerach;265;8;273;66051
76;66;03;13;052;Codalet;368;11;379;66052
76;66;01;05;053;Collioure;2407;28;2435;66053
76;66;03;13;054;Conat;60;3;63;66054
76;66;03;16;055;Corbère;762;15;777;66055
76;66;03;16;056;Corbère-les-Cabanes;1048;15;1063;66056
76;66;03;02;057;Corneilla-de-Conflent;530;4;534;66057
76;66;03;16;058;Corneilla-la-Rivière;1975;35;2010;66058
76;66;01;12;059;Corneilla-del-Vercol;2327;28;2355;66059
76;66;01;02;060;Corsavy;222;20;242;66060
76;66;01;02;061;Coustouges;93;0;93;66061
76;66;03;13;062;Dorres;169;7;176;66062
76;66;01;17;063;Les Cluses;234;3;237;66063
76;66;03;13;064;Egat;421;11;432;66064
76;66;01;12;065;Elne;9248;116;9364;66065
76;66;03;13;066;Enveitg;637;23;660;66066
76;66;03;13;067;Err;668;22;690;66067
76;66;03;13;068;Escaro;108;1;109;66068
76;66;02;15;069;Espira-de-l'Agly;3475;135;3610;66069
76;66;03;02;070;Espira-de-Conflent;165;4;169;66070
76;66;02;15;071;Estagel;2049;18;2067;66071
76;66;03;13;072;Estavar;477;9;486;66072
76;66;03;02;073;Estoher;138;2;140;66073
76;66;03;13;074;Eus;381;9;390;66074
76;66;03;13;075;Eyne;141;9;150;66075
76;66;03;15;076;Feilluns;65;0;65;66076
76;66;03;15;077;Fenouillet;88;1;89;66077
76;66;03;02;078;Fillols;189;7;196;66078
76;66;03;02;079;Finestret;192;5;197;66079
76;66;03;13;080;Fontpédrouse;117;2;119;66080
76;66;03;13;081;Fontrabiouse;125;3;128;66081
76;66;03;13;082;Formiguères;505;4;509;66082
76;66;03;15;083;Fosse;41;0;41;66083
76;66;01;01;084;Fourques;1311;19;1330;66084
76;66;03;02;085;Fuilla;443;9;452;66085
76;66;03;02;086;Glorianes;25;0;25;66086
76;66;03;16;088;Ille-sur-Têt;5513;63;5576;66088
76;66;03;02;089;Joch;321;6;327;66089
76;66;03;13;090;Jujols;44;2;46;66090
76;66;01;02;091;Lamanère;57;1;58;66091
76;66;03;15;092;Lansac;90;0;90;66092
76;66;01;17;093;Laroque-des-Albères;2140;41;2181;66093
76;66;01;12;094;Latour-Bas-Elne;3158;46;3204;66094
76;66;03;13;095;Latour-de-Carol;439;4;443;66095
76;66;03;15;096;Latour-de-France;1038;12;1050;66096
76;66;03;15;097;Lesquerde;139;4;143;66097
76;66;03;13;098;La Llagonne;220;10;230;66098
76;66;01;01;099;Llauro;317;2;319;66099
76;66;03;13;100;Llo;171;3;174;66100
76;66;02;01;101;Llupia;2074;42;2116;66101
76;66;03;02;102;Mantet;29;1;30;66102
76;66;03;02;103;Marquixanes;574;7;581;66103
76;66;03;13;104;Los Masos;982;12;994;66104
76;66;03;13;105;Matemale;277;5;282;66105
76;66;01;17;106;Maureillas-las-Illas;2568;49;2617;66106
76;66;03;15;107;Maury;794;6;800;66107
76;66;03;16;108;Millas;4264;69;4333;66108
76;66;03;13;109;Molitg-les-Bains;242;4;246;66109
76;66;03;16;111;Montalba-le-Château;149;2;151;66111
76;66;01;01;112;Montauriol;251;5;256;66112
76;66;01;02;113;Montbolo;177;2;179;66113
76;66;01;12;114;Montescot;1647;39;1686;66114
76;66;01;17;115;Montesquieu-des-Albères;1235;23;1258;66115
76;66;01;02;116;Montferrer;186;4;190;66116
76;66;03;13;117;Mont-Louis;148;9;157;66117
76;66;02;15;118;Montner;338;8;346;66118
76;66;03;13;119;Mosset;318;7;325;66119
76;66;03;13;120;Nahuja;76;1;77;66120
76;66;03;16;121;Néfiach;1287;36;1323;66121
76;66;03;13;122;Nohèdes;60;2;62;66122
76;66;03;13;123;Nyer;151;0;151;66123
76;66;03;13;124;Font-Romeu-Odeillo-Via;1840;183;2023;66124
76;66;03;13;125;Olette;351;5;356;66125
76;66;01;01;126;Oms;332;4;336;66126
76;66;02;15;127;Opoul-Périllos;1192;15;1207;66127
76;66;03;13;128;Oreilla;25;0;25;66128
76;66;01;12;129;Ortaffa;1591;20;1611;66129
76;66;03;13;130;Osséja;1350;75;1425;66130
76;66;03;13;132;Palau-de-Cerdagne;417;10;427;66132
76;66;01;05;133;Palau-del-Vidre;3094;45;3139;66133
76;66;01;01;134;Passa;970;10;980;66134
76;66;02;99;136;Perpignan;119344;1427;120771;66136
76;66;01;17;137;Le Perthus;549;3;552;66137
76;66;02;14;138;Peyrestortes;1527;25;1552;66138
76;66;03;15;139;Pézilla-de-Conflent;40;0;40;66139
76;66;02;14;140;Pézilla-la-Rivière;3812;55;3867;66140
76;66;02;04;141;Pia;9849;96;9945;66141
76;66;03;13;142;Planès;54;2;56;66142
76;66;03;15;143;Planèzes;93;2;95;66143
76;66;02;01;144;Pollestres;5229;85;5314;66144
76;66;02;01;145;Ponteilla;2841;44;2885;66145
76;66;03;13;146;Porta;115;7;122;66146
76;66;03;13;147;Porté-Puymorens;105;1;106;66147
76;66;01;05;148;Port-Vendres;4016;77;4093;66148
76;66;03;13;149;Prades;6028;339;6367;66149
76;66;01;02;150;Prats-de-Mollo-la-Preste;1175;19;1194;66150
76;66;03;15;151;Prats-de-Sournia;78;3;81;66151
76;66;03;15;152;Prugnanes;103;0;103;66152
76;66;03;02;153;Prunet-et-Belpuig;48;0;48;66153
76;66;03;13;154;Puyvalador;63;1;64;66154
76;66;03;02;155;Py;80;0;80;66155
76;66;03;15;156;Rabouillet;93;1;94;66156
76;66;03;13;157;Railleu;26;1;27;66157
76;66;03;15;158;Rasiguères;151;2;153;66158
76;66;03;13;159;Réal;63;0;63;66159
76;66;01;02;160;Reynès;1255;20;1275;66160
76;66;03;13;161;Ria-Sirach;1348;30;1378;66161
76;66;03;02;162;Rigarda;648;2;650;66162
76;66;02;15;164;Rivesaltes;8888;142;9030;66164
76;66;03;02;165;Rodès;628;6;634;66165
76;66;03;02;166;Sahorre;391;7;398;66166
76;66;03;13;167;Saillagouse;1146;27;1173;66167
76;66;01;05;168;Saint-André;3422;52;3474;66168
76;66;03;15;169;Saint-Arnac;111;1;112;66169
76;66;01;01;170;Sainte-Colombe-de-la-Commanderie;161;2;163;66170
76;66;01;03;171;Saint-Cyprien;11040;150;11190;66171
76;66;02;14;172;Saint-Estève;11719;160;11879;66172
76;66;03;16;173;Saint-Féliu-d'Amont;1194;20;1214;66173
76;66;02;16;174;Saint-Féliu-d'Avall;2874;45;2919;66174
76;66;01;17;175;Saint-Génis-des-Fontaines;2841;26;2867;66175
76;66;02;04;176;Saint-Hippolyte;3198;31;3229;66176
76;66;01;01;177;Saint-Jean-Lasseille;1541;17;1558;66177
76;66;01;17;178;Saint-Jean-Pla-de-Corts;2273;45;2318;66178
76;66;01;02;179;Saint-Laurent-de-Cerdans;1044;13;1057;66179
76;66;02;04;180;Saint-Laurent-de-la-Salanque;10071;102;10173;66180
76;66;03;13;181;Sainte-Léocadie;122;1;123;66181
76;66;02;07;182;Sainte-Marie-la-Mer;4821;62;4883;66182
76;66;01;02;183;Saint-Marsal;66;0;66;66183
76;66;03;15;184;Saint-Martin-de-Fenouillet;52;3;55;66184
76;66;03;02;185;Saint-Michel-de-Llotes;350;12;362;66185
76;66;02;03;186;Saint-Nazaire;2784;43;2827;66186
76;66;03;15;187;Saint-Paul-de-Fenouillet;1790;18;1808;66187
76;66;03;13;188;Saint-Pierre-dels-Forcats;263;10;273;66188
76;66;02;03;189;Saleilles;5564;105;5669;66189
76;66;02;15;190;Salses-le-Château;3514;12;3526;66190
76;66;03;13;191;Sansa;19;0;19;66191
76;66;03;13;192;Sauto;90;1;91;66192
76;66;03;13;193;Serdinya;232;5;237;66193
76;66;01;02;194;Serralongue;219;2;221;66194
76;66;02;16;195;Le Soler;7752;115;7867;66195
76;66;01;17;196;Sorède;3343;50;3393;66196
76;66;03;13;197;Souanyas;37;0;37;66197
76;66;03;15;198;Sournia;498;5;503;66198
76;66;01;02;199;Taillet;102;1;103;66199
76;66;03;15;201;Tarerach;43;1;44;66201
76;66;03;13;202;Targassonne;195;5;200;66202
76;66;01;02;203;Taulis;56;0;56;66203
76;66;03;02;204;Taurinya;332;11;343;66204
76;66;02;15;205;Tautavel;859;21;880;66205
76;66;01;02;206;Le Tech;93;0;93;66206
76;66;01;01;207;Terrats;720;10;730;66207
76;66;01;12;208;Théza;2127;99;2226;66208
76;66;03;13;209;Thuès-Entre-Valls;40;2;42;66209
76;66;01;01;210;Thuir;7924;135;8059;66210
76;66;01;01;211;Tordères;172;7;179;66211
76;66;02;04;212;Torreilles;3839;68;3907;66212
76;66;02;11;213;Toulouges;7192;124;7316;66213
76;66;01;01;214;Tresserre;1085;13;1098;66214
76;66;03;15;215;Trévillach;160;0;160;66215
76;66;03;15;216;Trilla;75;2;77;66216
76;66;01;01;217;Trouillas;2174;24;2198;66217
76;66;03;13;218;Ur;359;11;370;66218
76;66;03;13;219;Urbanya;50;1;51;66219
76;66;03;13;220;Valcebollère;38;1;39;66220
76;66;03;02;221;Valmanya;34;0;34;66221
76;66;03;02;222;Vernet-les-Bains;1450;46;1496;66222
76;66;03;13;223;Villefranche-de-Conflent;210;5;215;66223
76;66;02;07;224;Villelongue-de-la-Salanque;3248;36;3284;66224
76;66;01;17;225;Villelongue-dels-Monts;1780;61;1841;66225
76;66;01;01;226;Villemolaque;1390;24;1414;66226
76;66;02;12;227;Villeneuve-de-la-Raho;3977;67;4044;66227
76;66;02;14;228;Villeneuve-la-Rivière;1372;25;1397;66228
76;66;03;02;230;Vinça;2131;26;2157;66230
76;66;02;15;231;Vingrau;574;4;578;66231
76;66;03;15;232;Vira;26;0;26;66232
76;66;01;17;233;Vivès;175;4;179;66233
76;66;03;15;234;Le Vivier;69;0;69;66234
44;67;08;09;001;Achenheim;2338;32;2370;67001
44;67;04;08;002;Adamswiller;390;3;393;67002
44;67;05;11;003;Albé;441;16;457;67003
44;67;04;14;004;Sommerau;1530;28;1558;67004
44;67;04;02;005;Alteckendorf;850;18;868;67005
44;67;04;14;006;Altenheim;213;1;214;67006
44;67;03;10;008;Altorf;1363;22;1385;67008
44;67;04;08;009;Altwiller;380;13;393;67009
44;67;05;12;010;Andlau;1738;70;1808;67010
44;67;05;16;011;Artolsheim;992;12;1004;67011
44;67;02;23;012;Aschbach;647;18;665;67012
44;67;04;08;013;Asswiller;274;3;277;67013
44;67;03;10;016;Avolsheim;763;11;774;67016
44;67;04;08;017;Baerendorf;298;5;303;67017
44;67;03;14;018;Balbronn;670;9;679;67018
44;67;05;16;019;Baldenheim;1182;18;1200;67019
44;67;03;11;020;Barembach;838;7;845;67020
44;67;05;12;021;Barr;7197;193;7390;67021
44;67;05;11;022;Bassemberg;233;5;238;67022
44;67;02;05;023;Batzendorf;978;21;999;67023
44;67;02;23;025;Beinheim;1934;26;1960;67025
44;67;03;11;026;Bellefosse;163;3;166;67026
44;67;03;11;027;Belmont;177;0;177;67027
44;67;05;04;028;Benfeld;5801;95;5896;67028
44;67;04;08;029;Berg;360;4;364;67029
44;67;03;10;030;Bergbieten;722;7;729;67030
44;67;05;12;031;Bernardswiller;1437;44;1481;67031
44;67;05;12;032;Bernardvillé;212;7;219;67032
44;67;02;03;033;Bernolsheim;602;7;609;67033
44;67;04;02;034;Berstett;2460;41;2501;67034
44;67;02;05;035;Berstheim;444;15;459;67035
44;67;04;08;036;Bettwiller;304;7;311;67036
44;67;02;13;037;Biblisheim;365;5;370;67037
44;67;02;03;038;Bietlenheim;298;2;300;67038
44;67;02;03;039;Bilwisheim;515;11;526;67039
44;67;05;16;040;Bindernheim;1040;10;1050;67040
44;67;08;15;043;Bischheim;17353;209;17562;67043
44;67;04;08;044;Bischholtz;259;0;259;67044
44;67;03;10;045;Bischoffsheim;3329;58;3387;67045
44;67;02;01;046;Bischwiller;12746;137;12883;67046
44;67;04;08;047;Bissert;157;3;160;67047
44;67;02;13;048;Bitschhoffen;460;15;475;67048
44;67;08;09;049;Blaesheim;1301;20;1321;67049
44;67;03;11;050;Blancherupt;34;0;34;67050
44;67;05;12;051;Blienschwiller;313;11;324;67051
44;67;03;10;052;BÅ“rsch;2442;64;2506;67052
44;67;05;16;053;BÅ“senbiesen;321;10;331;67053
44;67;05;04;054;Bolsenheim;545;6;551;67054
44;67;05;04;055;Boofzheim;1381;19;1400;67055
44;67;05;16;056;Bootzheim;763;12;775;67056
44;67;04;02;057;Bosselshausen;171;6;177;67057
44;67;04;02;058;Bossendorf;391;4;395;67058
44;67;03;11;059;Bourg-Bruche;411;6;417;67059
44;67;05;12;060;Bourgheim;631;10;641;67060
44;67;04;02;061;Bouxwiller;3757;77;3834;67061
44;67;05;11;062;Breitenau;328;6;334;67062
44;67;05;11;063;Breitenbach;651;16;667;67063
44;67;08;09;065;Breuschwickersheim;1313;15;1328;67065
44;67;03;11;066;La Broque;2629;89;2718;67066
44;67;02;03;067;Brumath;10081;104;10185;67067
44;67;04;02;068;Buswiller;280;2;282;67068
44;67;02;23;069;Buhl;511;7;518;67069
44;67;04;08;070;Burbach;278;3;281;67070
44;67;04;08;071;Bust;464;11;475;67071
44;67;04;08;072;Butten;663;22;685;67072
44;67;05;16;073;Châtenois;4199;88;4287;67073
44;67;02;23;074;Cleebourg;667;19;686;67074
44;67;02;23;075;Climbach;429;7;436;67075
44;67;03;11;076;Colroy-la-Roche;476;9;485;67076
44;67;03;14;077;Cosswiller;583;14;597;67077
44;67;03;14;078;Crastatt;270;3;273;67078
44;67;02;23;079;CrÅ“ttwiller;181;3;184;67079
44;67;03;10;080;Dachstein;1840;20;1860;67080
44;67;03;10;081;Dahlenheim;785;12;797;67081
44;67;02;01;082;Dalhunden;1204;11;1215;67082
44;67;02;13;083;Dambach;754;12;766;67083
44;67;05;12;084;Dambach-la-Ville;2215;41;2256;67084
44;67;03;10;085;Dangolsheim;713;11;724;67085
44;67;05;04;086;Daubensand;447;10;457;67086
44;67;02;05;087;Dauendorf;1439;15;1454;67087
44;67;04;08;088;Dehlingen;351;7;358;67088
44;67;04;14;089;Dettwiller;2610;26;2636;67089
44;67;05;04;090;Diebolsheim;675;43;718;67090
44;67;04;08;091;Diedendorf;337;13;350;67091
44;67;05;11;092;Dieffenbach-au-Val;631;27;658;67092
44;67;02;13;093;Dieffenbach-lès-WÅ“rth;348;6;354;67093
44;67;05;16;094;Dieffenthal;253;2;255;67094
44;67;04;08;095;Diemeringen;1595;36;1631;67095
44;67;04;14;096;Dimbsthal;318;11;329;67096
44;67;04;02;097;Dingsheim;1233;17;1250;67097
44;67;03;11;098;Dinsheim-sur-Bruche;1492;19;1511;67098
44;67;04;08;099;Domfessel;281;4;285;67099
44;67;02;03;100;Donnenheim;352;1;353;67100
44;67;03;10;101;Dorlisheim;2613;32;2645;67101
44;67;04;02;102;Dossenheim-Kochersberg;300;5;305;67102
44;67;04;08;103;Dossenheim-sur-Zinsel;1038;25;1063;67103
44;67;02;23;104;Drachenbronn-Birlenbach;608;15;623;67104
44;67;04;08;105;Drulingen;1438;27;1465;67105
44;67;02;01;106;Drusenheim;5268;47;5315;67106
44;67;04;02;107;Duntzenheim;656;5;661;67107
44;67;03;10;108;Duppigheim;1638;18;1656;67108
44;67;04;02;109;Durningen;656;17;673;67109
44;67;02;13;110;Durrenbach;1081;17;1098;67110
44;67;04;08;111;Durstel;424;11;435;67111
44;67;03;10;112;Duttlenheim;2865;30;2895;67112
44;67;02;23;113;Eberbach-Seltz;422;7;429;67113
44;67;05;16;115;Ebersheim;2287;23;2310;67115
44;67;05;16;116;Ebersmunster;528;25;553;67116
44;67;04;14;117;Eckartswiller;434;11;445;67117
44;67;08;06;118;Eckbolsheim;7049;64;7113;67118
44;67;08;03;119;Eckwersheim;1344;20;1364;67119
44;67;05;12;120;Eichhoffen;527;11;538;67120
44;67;05;16;121;Elsenheim;810;10;820;67121
44;67;03;14;122;Wangenbourg-Engenthal;1332;15;1347;67122
44;67;02;13;123;Engwiller;494;1;495;67123
44;67;08;09;124;Entzheim;2453;25;2478;67124
44;67;05;12;125;Epfig;2247;76;2323;67125
44;67;04;08;126;Erckartswiller;299;6;305;67126
44;67;03;10;127;Ergersheim;1410;14;1424;67127
44;67;03;10;128;Ernolsheim-Bruche;1887;18;1905;67128
44;67;04;14;129;Ernolsheim-lès-Saverne;595;6;601;67129
44;67;05;04;130;Erstein;10661;123;10784;67130
44;67;08;07;131;Eschau;5424;53;5477;67131
44;67;02;13;132;Eschbach;944;11;955;67132
44;67;04;08;133;Eschbourg;471;6;477;67133
44;67;04;08;134;Eschwiller;191;0;191;67134
44;67;04;02;135;Ettendorf;762;5;767;67135
44;67;04;08;136;Eywiller;275;5;280;67136
44;67;08;09;137;Fegersheim;5734;66;5800;67137
44;67;04;02;138;Fessenheim-le-Bas;574;9;583;67138
44;67;03;10;139;Flexbourg;474;9;483;67139
44;67;02;01;140;Forstfeld;754;4;758;67140
44;67;02;13;141;Forstheim;598;4;602;67141
44;67;02;01;142;Fort-Louis;290;2;292;67142
44;67;05;11;143;Fouchy;643;19;662;67143
44;67;03;11;144;Fouday;337;3;340;67144
44;67;04;14;145;Friedolsheim;258;6;264;67145
44;67;05;04;146;Friesenheim;618;8;626;67146
44;67;02;13;147;FrÅ“schwiller;498;4;502;67147
44;67;04;08;148;Frohmuhl;168;4;172;67148
44;67;04;14;149;Furchhausen;421;7;428;67149
44;67;04;02;150;Furdenheim;1366;23;1389;67150
44;67;02;03;151;Gambsheim;5041;49;5090;67151
44;67;08;09;152;Geispolsheim;7561;79;7640;67152
44;67;04;02;153;Geiswiller-ZÅ“bersdorf;397;3;400;67153
44;67;05;04;154;Gerstheim;3449;55;3504;67154
44;67;05;12;155;Gertwiller;1258;17;1275;67155
44;67;02;03;156;Geudertheim;2586;31;2617;67156
44;67;04;08;159;GÅ“rlingen;209;6;215;67159
44;67;02;13;160;GÅ“rsdorf;1057;26;1083;67160
44;67;04;14;161;Gottenhouse;380;11;391;67161
44;67;04;14;162;Gottesheim;355;8;363;67162
44;67;04;02;163;Gougenheim;544;13;557;67163
44;67;05;12;164;Goxwiller;838;20;858;67164
44;67;03;11;165;Grandfontaine;385;7;392;67165
44;67;04;02;166;Grassendorf;250;4;254;67166
44;67;03;10;167;Grendelbruch;1218;16;1234;67167
44;67;03;11;168;Gresswiller;1666;24;1690;67168
44;67;02;03;169;Gries;2874;34;2908;67169
44;67;03;10;172;Griesheim-près-Molsheim;2228;40;2268;67172
44;67;04;02;173;Griesheim-sur-Souffel;1201;16;1217;67173
44;67;02;13;174;Gumbrechtshoffen;1167;8;1175;67174
44;67;02;13;176;Gundershoffen;3712;62;3774;67176
44;67;02;13;177;Gunstett;641;10;651;67177
44;67;04;08;178;Gungwiller;277;5;282;67178
44;67;04;14;179;Haegen;650;8;658;67179
44;67;02;05;180;Haguenau;35196;561;35757;67180
44;67;04;02;181;Handschuheim;272;6;278;67181
44;67;08;09;182;Hangenbieten;1647;24;1671;67182
44;67;04;08;183;Harskirchen;877;20;897;67183
44;67;02;23;184;Hatten;1910;25;1935;67184
44;67;04;14;185;Hattmatt;703;4;707;67185
44;67;02;13;186;Hegeney;433;7;440;67186
44;67;05;16;187;Heidolsheim;540;8;548;67187
44;67;03;11;188;Heiligenberg;697;11;708;67188
44;67;05;12;189;Heiligenstein;961;22;983;67189
44;67;04;14;190;Hengwiller;195;2;197;67190
44;67;04;08;191;Herbitzheim;1840;26;1866;67191
44;67;05;04;192;Herbsheim;937;10;947;67192
44;67;02;01;194;Herrlisheim;4731;73;4804;67194
44;67;05;16;195;Hessenheim;619;10;629;67195
44;67;05;16;196;Hilsenheim;2649;31;2680;67196
44;67;05;04;197;Hindisheim;1510;21;1531;67197
44;67;04;08;198;Hinsbourg;111;3;114;67198
44;67;04;08;199;Hinsingen;82;1;83;67199
44;67;05;04;200;Hipsheim;1001;8;1009;67200
44;67;04;08;201;Hirschland;307;7;314;67201
44;67;04;02;202;Hochfelden;4048;38;4086;67202
44;67;02;05;203;Hochstett;384;5;389;67203
44;67;08;06;204;HÅ“nheim;11304;81;11385;67204
44;67;02;03;205;HÅ“rdt;4514;51;4565;67205
44;67;02;23;206;Hoffen;1118;18;1136;67206
44;67;03;14;208;HohengÅ“ft;547;7;554;67208
44;67;04;02;209;Hohfrankenheim;273;2;275;67209
44;67;05;12;210;Le Hohwald;505;13;518;67210
44;67;08;09;212;Holtzheim;3703;30;3733;67212
44;67;02;23;213;Hunspach;632;16;648;67213
44;67;04;02;214;Hurtigheim;978;7;985;67214
44;67;02;05;215;Huttendorf;497;3;500;67215
44;67;05;04;216;Huttenheim;2672;38;2710;67216
44;67;05;04;217;Ichtratzheim;351;4;355;67217
44;67;08;07;218;Illkirch-Graffenstaden;26698;691;27389;67218
44;67;04;02;220;Ingenheim;327;2;329;67220
44;67;02;23;221;Ingolsheim;347;5;352;67221
44;67;04;08;222;Ingwiller;4048;37;4085;67222
44;67;05;10;223;Innenheim;1183;7;1190;67223
44;67;04;02;225;Issenhausen;113;2;115;67225
44;67;04;02;226;Ittenheim;2112;24;2136;67226
44;67;05;12;227;Itterswiller;237;4;241;67227
44;67;04;02;228;Neugartheim-Ittlenheim;795;17;812;67228
44;67;03;14;229;Jetterswiller;199;2;201;67229
44;67;02;01;230;Kaltenhouse;2450;19;2469;67230
44;67;02;01;231;Kauffenheim;212;2;214;67231
44;67;02;23;232;Keffenach;204;6;210;67232
44;67;05;04;233;Kertzfeld;1203;20;1223;67233
44;67;04;08;234;Keskastel;1510;30;1540;67234
44;67;02;23;235;Kesseldorf;427;2;429;67235
44;67;04;02;236;Kienheim;549;10;559;67236
44;67;02;03;237;Kilstett;2515;35;2550;67237
44;67;02;13;238;Kindwiller;638;7;645;67238
44;67;05;16;239;Kintzheim;1660;32;1692;67239
44;67;03;10;240;Kirchheim;719;3;722;67240
44;67;04;08;241;Kirrberg;147;4;151;67241
44;67;04;02;242;Kirrwiller;526;5;531;67242
44;67;04;14;244;KleingÅ“ft;154;3;157;67244
44;67;03;14;245;KnÅ“rsheim;207;3;210;67245
44;67;05;04;246;Kogenheim;1267;18;1285;67246
44;67;08;09;247;Kolbsheim;973;21;994;67247
44;67;05;12;248;Krautergersheim;1715;26;1741;67248
44;67;02;03;249;Krautwiller;239;7;246;67249
44;67;02;03;250;Kriegsheim;793;18;811;67250
44;67;02;03;252;Kurtzenhouse;1079;12;1091;67252
44;67;04;02;253;Kuttolsheim;637;10;647;67253
44;67;02;13;254;Kutzenhausen;913;16;929;67254
44;67;05;11;255;Lalaye;478;8;486;67255
44;67;08;06;256;Lampertheim;3405;53;3458;67256
44;67;02;13;257;Lampertsloch;706;15;721;67257
44;67;04;14;258;Landersheim;193;3;196;67258
44;67;02;13;259;Langensoultzbach;920;11;931;67259
44;67;02;13;260;Laubach;321;5;326;67260
44;67;02;23;261;Lauterbourg;2331;27;2358;67261
44;67;02;13;263;Lembach;1548;42;1590;67263
44;67;02;01;264;Leutenheim;829;12;841;67264
44;67;04;08;265;Lichtenberg;550;7;557;67265
44;67;05;04;266;Limersheim;664;8;672;67266
44;67;08;09;267;Lingolsheim;19439;150;19589;67267
44;67;08;09;268;Lipsheim;2664;30;2694;67268
44;67;04;14;269;Littenheim;297;3;300;67269
44;67;04;02;270;Lixhausen;390;1;391;67270
44;67;02;13;271;Lobsann;648;7;655;67271
44;67;04;14;272;Lochwiller;395;6;401;67272
44;67;04;08;273;Lohr;515;6;521;67273
44;67;04;08;274;Lorentzen;246;2;248;67274
44;67;04;14;275;Lupstein;806;13;819;67275
44;67;03;11;276;Lutzelhouse;1879;28;1907;67276
44;67;05;16;277;Mackenheim;760;11;771;67277
44;67;04;08;278;Mackwiller;547;13;560;67278
44;67;04;14;279;Maennolsheim;233;5;238;67279
44;67;05;11;280;Maisonsgoutte;798;18;816;67280
44;67;05;16;281;Marckolsheim;4159;65;4224;67281
44;67;03;10;282;Marlenheim;4250;65;4315;67282
44;67;04;14;283;Marmoutier;2712;43;2755;67283
44;67;05;04;285;Matzenheim;1461;108;1569;67285
44;67;05;12;286;Meistratzheim;1500;19;1519;67286
44;67;04;02;287;Melsheim;584;6;590;67287
44;67;02;23;288;Memmelshoffen;324;4;328;67288
44;67;04;08;289;Menchhoffen;635;10;645;67289
44;67;02;13;290;Merkwiller-Pechelbronn;922;17;939;67290
44;67;02;13;291;Mertzwiller;3363;40;3403;67291
44;67;02;13;292;Mietesheim;669;12;681;67292
44;67;04;02;293;Minversheim;652;11;663;67293
44;67;05;12;295;Mittelbergheim;620;24;644;67295
44;67;08;06;296;Mittelhausbergen;2086;24;2110;67296
44;67;02;03;298;Mittelschaeffolsheim;569;8;577;67298
44;67;03;10;299;Mollkirch;905;25;930;67299
44;67;03;10;300;Molsheim;9343;132;9475;67300
44;67;02;03;301;Mommenheim;2126;20;2146;67301
44;67;04;14;302;Monswiller;2032;37;2069;67302
44;67;02;13;303;Morsbronn-les-Bains;684;12;696;67303
44;67;02;05;304;Morschwiller;576;13;589;67304
44;67;02;23;305;Mothern;1955;21;1976;67305
44;67;03;11;306;Muhlbach-sur-Bruche;643;54;697;67306
44;67;04;08;307;Mulhausen;463;5;468;67307
44;67;02;23;308;Munchhausen;802;9;811;67308
44;67;08;06;309;Mundolsheim;4749;62;4811;67309
44;67;05;16;310;Mussig;1169;34;1203;67310
44;67;05;16;311;Muttersholtz;2136;28;2164;67311
44;67;04;02;312;Mutzenhouse;477;9;486;67312
44;67;03;11;313;Mutzig;6063;53;6116;67313
44;67;03;11;314;Natzwiller;531;8;539;67314
44;67;02;23;315;Neewiller-près-Lauterbourg;668;14;682;67315
44;67;05;11;317;Neubois;671;17;688;67317
44;67;02;01;319;Neuhaeusel;365;3;368;67319
44;67;05;11;320;Neuve-Eglise;623;10;633;67320
44;67;03;11;321;Neuviller-la-Roche;331;8;339;67321
44;67;04;08;322;Neuwiller-lès-Saverne;1102;13;1115;67322
44;67;02;13;324;Niederbronn-les-Bains;4381;68;4449;67324
44;67;03;11;325;Niederhaslach;1398;17;1415;67325
44;67;08;06;326;Niederhausbergen;1663;13;1676;67326
44;67;02;23;327;Niederlauterbach;961;22;983;67327
44;67;02;13;328;Niedermodern;877;7;884;67328
44;67;05;12;329;Niedernai;1268;22;1290;67329
44;67;02;23;330;NiederrÅ“dern;927;9;936;67330
44;67;02;05;331;Niederschaeffolsheim;1380;13;1393;67331
44;67;04;08;333;Niedersoultzbach;292;5;297;67333
44;67;02;13;334;Niedersteinbach;115;1;116;67334
44;67;03;10;335;Nordheim;925;16;941;67335
44;67;05;04;336;Nordhouse;1740;30;1770;67336
44;67;05;12;337;Nothalten;456;16;472;67337
44;67;05;04;338;Obenheim;1349;23;1372;67338
44;67;02;23;339;Betschdorf;4183;47;4230;67339
44;67;02;13;340;Oberbronn;1554;27;1581;67340
44;67;02;13;341;Oberdorf-Spachbach;390;2;392;67341
44;67;03;11;342;Oberhaslach;1760;29;1789;67342
44;67;08;06;343;Oberhausbergen;5363;56;5419;67343
44;67;02;23;344;Oberhoffen-lès-Wissembourg;318;4;322;67344
44;67;02;01;345;Oberhoffen-sur-Moder;3497;27;3524;67345
44;67;02;23;346;Oberlauterbach;547;11;558;67346
44;67;04;02;347;Obermodern-Zutzendorf;1685;22;1707;67347
44;67;05;12;348;Obernai;11765;456;12221;67348
44;67;02;23;349;OberrÅ“dern;531;9;540;67349
44;67;08;09;350;Oberschaeffolsheim;2279;24;2303;67350
44;67;02;23;351;Seebach;1699;38;1737;67351
44;67;04;02;352;Obersoultzbach;409;8;417;67352
44;67;02;13;353;Obersteinbach;231;2;233;67353
44;67;03;10;354;Odratzheim;515;9;524;67354
44;67;04;08;355;Oermingen;1167;28;1195;67355
44;67;02;01;356;Offendorf;2518;23;2541;67356
44;67;02;13;358;Offwiller;802;13;815;67358
44;67;02;05;359;Ohlungen;1305;23;1328;67359
44;67;05;16;360;Ohnenheim;1071;14;1085;67360
44;67;02;03;361;Olwisheim;500;7;507;67361
44;67;05;16;362;Orschwiller;589;5;594;67362
44;67;08;09;363;Osthoffen;816;17;833;67363
44;67;05;04;364;Osthouse;930;17;947;67364
44;67;08;07;365;Ostwald;12723;129;12852;67365
44;67;04;14;366;Ottersthal;782;18;800;67366
44;67;04;14;367;Otterswiller;1312;32;1344;67367
44;67;03;10;368;Ottrott;1537;31;1568;67368
44;67;04;08;369;Ottwiller;260;5;265;67369
44;67;04;08;370;Petersbach;660;12;672;67370
44;67;04;08;371;La Petite-Pierre;624;4;628;67371
44;67;02;89;372;Val-de-Moder;5040;59;5099;67372
44;67;04;08;373;Pfalzweyer;318;4;322;67373
44;67;04;02;375;Pfulgriesheim;1307;17;1324;67375
44;67;03;11;377;Plaine;997;11;1008;67377
44;67;08;07;378;Plobsheim;4465;42;4507;67378
44;67;02;13;379;Preuschdorf;896;15;911;67379
44;67;04;14;380;Printzheim;203;4;207;67380
44;67;04;08;381;Puberg;359;5;364;67381
44;67;04;02;382;Quatzenheim;782;18;800;67382
44;67;03;14;383;Rangen;183;5;188;67383
44;67;03;11;384;Ranrupt;313;6;319;67384
44;67;04;08;385;Ratzwiller;245;2;247;67385
44;67;04;08;386;Rauwiller;209;2;211;67386
44;67;05;12;387;Reichsfeld;298;9;307;67387
44;67;02;13;388;Reichshoffen;5402;84;5486;67388
44;67;08;06;389;Reichstett;4397;41;4438;67389
44;67;04;14;391;Reinhardsmunster;448;6;454;67391
44;67;04;08;392;Reipertswiller;850;12;862;67392
44;67;02;23;394;Retschwiller;279;6;285;67394
44;67;04;14;395;Reutenbourg;393;10;403;67395
44;67;04;08;396;Rexingen;201;1;202;67396
44;67;05;04;397;Rhinau;2670;31;2701;67397
44;67;05;16;398;Richtolsheim;360;2;362;67398
44;67;02;23;400;Riedseltz;1108;20;1128;67400
44;67;04;08;401;Rimsdorf;306;10;316;67401
44;67;04;02;403;Ringendorf;439;11;450;67403
44;67;02;23;404;Rittershoffen;908;16;924;67404
44;67;02;01;405;RÅ“schwoog;2281;50;2331;67405
44;67;04;02;406;Rohr;340;3;343;67406
44;67;02;01;407;Rohrwiller;1613;13;1626;67407
44;67;03;14;408;Romanswiller;1214;17;1231;67408
44;67;02;01;409;Roppenheim;1010;8;1018;67409
44;67;03;10;410;Rosenwiller;661;14;675;67410
44;67;03;10;411;Rosheim;5221;112;5333;67411
44;67;05;04;412;Rossfeld;1024;9;1033;67412
44;67;04;08;413;Rosteig;522;11;533;67413
44;67;03;11;414;Rothau;1550;20;1570;67414
44;67;02;13;415;Rothbach;470;1;471;67415
44;67;02;23;416;Rott;469;10;479;67416
44;67;02;03;417;Rottelsheim;297;9;306;67417
44;67;02;01;418;Rountzenheim-Auenheim;1929;35;1964;67418
44;67;03;11;420;Russ;1240;16;1256;67420
44;67;03;11;421;Saales;828;12;840;67421
44;67;05;16;422;Saasenheim;592;10;602;67422
44;67;04;14;423;Saessolsheim;586;7;593;67423
44;67;03;11;424;Saint-Blaise-la-Roche;237;0;237;67424
44;67;04;14;425;Saint-Jean-Saverne;533;13;546;67425
44;67;05;11;426;Saint-Martin;362;1;363;67426
44;67;05;11;427;Saint-Maurice;341;14;355;67427
44;67;03;10;428;Saint-Nabor;492;12;504;67428
44;67;05;12;429;Saint-Pierre;627;12;639;67429
44;67;05;11;430;Saint-Pierre-Bois;763;25;788;67430
44;67;02;23;432;Salmbach;584;11;595;67432
44;67;05;04;433;Sand;1376;10;1386;67433
44;67;04;08;434;Sarre-Union;2796;43;2839;67434
44;67;04;08;435;Sarrewerden;837;21;858;67435
44;67;03;11;436;Saulxures;501;12;513;67436
44;67;04;14;437;Saverne;11378;306;11684;67437
44;67;05;04;438;Schaeffersheim;821;13;834;67438
44;67;02;23;440;Schaffhouse-près-Seltz;553;12;565;67440
44;67;04;02;441;Schalkendorf;330;5;335;67441
44;67;03;10;442;Scharrachbergheim-Irmstett;1242;61;1303;67442
44;67;02;23;443;Scheibenhard;842;20;862;67443
44;67;04;02;444;Scherlenheim;121;3;124;67444
44;67;05;16;445;Scherwiller;3217;53;3270;67445
44;67;04;08;446;Schillersdorf;430;11;441;67446
44;67;08;15;447;Schiltigheim;33780;198;33978;67447
44;67;03;11;448;Schirmeck;2149;49;2198;67448
44;67;02;01;449;Schirrhein;2258;21;2279;67449
44;67;02;01;450;Schirrhoffen;695;16;711;67450
44;67;02;23;451;Schleithal;1394;32;1426;67451
44;67;04;02;452;Schnersheim;1713;32;1745;67452
44;67;05;16;453;SchÅ“nau;613;8;621;67453
44;67;04;08;454;SchÅ“nbourg;400;8;408;67454
44;67;02;23;455;SchÅ“nenbourg;696;11;707;67455
44;67;04;08;456;Schopperten;450;10;460;67456
44;67;02;05;458;Schweighouse-sur-Moder;4942;61;5003;67458
44;67;04;14;459;Schwenheim;746;17;763;67459
44;67;04;02;460;Schwindratzheim;1715;22;1737;67460
44;67;05;16;461;Schwobsheim;327;14;341;67461
44;67;05;16;462;Sélestat;19242;265;19507;67462
44;67;02;23;463;Seltz;3162;34;3196;67463
44;67;05;04;464;Sermersheim;949;13;962;67464
44;67;02;01;465;Sessenheim;2324;33;2357;67465
44;67;02;23;466;Siegen;509;9;518;67466
44;67;04;08;467;Siewiller;383;7;390;67467
44;67;04;08;468;Siltzheim;623;16;639;67468
44;67;03;11;470;Solbach;99;1;100;67470
44;67;08;06;471;Souffelweyersheim;7994;62;8056;67471
44;67;02;01;472;Soufflenheim;4827;55;4882;67472
44;67;03;10;473;Soultz-les-Bains;961;18;979;67473
44;67;02;23;474;Soultz-sous-Forêts;3190;35;3225;67474
44;67;04;08;475;Sparsbach;230;3;233;67475
44;67;02;01;476;Stattmatten;740;6;746;67476
44;67;05;11;477;Steige;607;18;625;67477
44;67;04;14;478;Steinbourg;1940;28;1968;67478
44;67;02;23;479;Steinseltz;597;22;619;67479
44;67;03;11;480;Still;1811;26;1837;67480
44;67;05;12;481;Stotzheim;1089;14;1103;67481
44;67;08;99;482;Strasbourg;287228;2878;290106;67482
44;67;04;08;483;Struth;233;4;237;67483
44;67;02;23;484;Stundwiller;487;10;497;67484
44;67;04;02;485;Stutzheim-Offenheim;1593;26;1619;67485
44;67;05;16;486;Sundhouse;1851;24;1875;67486
44;67;02;23;487;Surbourg;1714;25;1739;67487
44;67;04;08;488;Thal-Drulingen;186;4;190;67488
44;67;04;14;489;Thal-Marmoutier;811;19;830;67489
44;67;05;11;490;Thanvillé;586;18;604;67490
44;67;04;08;491;Tieffenbach;249;0;249;67491
44;67;03;14;492;Traenheim;649;16;665;67492
44;67;05;11;493;Triembach-au-Val;440;10;450;67493
44;67;02;23;494;Trimbach;584;11;595;67494
44;67;04;02;495;Truchtersheim;4267;99;4366;67495
44;67;02;05;497;Uhlwiller;677;14;691;67497
44;67;02;13;498;Uhrwiller;705;6;711;67498
44;67;05;11;499;Urbeis;318;14;332;67499
44;67;03;11;500;Urmatt;1457;35;1492;67500
44;67;05;04;501;Uttenheim;561;4;565;67501
44;67;02;13;502;Uttenhoffen;209;2;211;67502
44;67;04;02;503;Uttwiller;160;2;162;67503
44;67;05;12;504;Valff;1397;15;1412;67504
44;67;05;16;505;La Vancelle;401;13;414;67505
44;67;08;03;506;Vendenheim;5971;69;6040;67506
44;67;05;11;507;Villé;1802;33;1835;67507
44;67;04;08;508;VÅ“llerdingen;417;19;436;67508
44;67;04;08;509;Volksberg;351;3;354;67509
44;67;02;05;510;Wahlenheim;599;1;600;67510
44;67;02;13;511;Walbourg;948;274;1222;67511
44;67;03;11;513;Waldersbach;129;1;130;67513
44;67;04;08;514;Waldhambach;632;9;641;67514
44;67;04;14;515;Waldolwisheim;568;9;577;67515
44;67;04;02;516;Waltenheim-sur-Zorn;665;8;673;67516
44;67;03;10;517;Wangen;670;11;681;67517
44;67;08;03;519;La Wantzenau;5881;112;5993;67519
44;67;03;14;520;Wasselonne;5711;65;5776;67520
44;67;04;08;521;Weinbourg;450;3;453;67521
44;67;04;08;522;Weislingen;546;7;553;67522
44;67;02;03;523;Weitbruch;2766;37;2803;67523
44;67;04;08;524;Weiterswiller;521;8;529;67524
44;67;03;14;525;Westhoffen;1636;26;1662;67525
44;67;05;04;526;Westhouse;1571;18;1589;67526
44;67;04;14;527;Westhouse-Marmoutier;335;8;343;67527
44;67;04;08;528;Weyer;565;9;574;67528
44;67;02;03;529;Weyersheim;3398;35;3433;67529
44;67;04;02;530;Wickersheim-Wilshausen;377;6;383;67530
44;67;03;11;531;Wildersbach;285;6;291;67531
44;67;04;02;532;Willgottheim;1088;18;1106;67532
44;67;04;02;534;Wilwisheim;732;3;735;67534
44;67;04;08;535;Wimmenau;1057;21;1078;67535
44;67;02;13;536;Windstein;158;1;159;67536
44;67;02;13;537;Wingen;446;6;452;67537
44;67;04;08;538;Wingen-sur-Moder;1585;21;1606;67538
44;67;04;02;539;Wingersheim les Quatre Bans;2330;42;2372;67539
44;67;02;05;540;Wintershouse;873;12;885;67540
44;67;02;23;541;Wintzenbach;533;2;535;67541
44;67;04;02;542;Wintzenheim-Kochersberg;482;3;485;67542
44;67;03;11;543;Wisches;2089;29;2118;67543
44;67;02;23;544;Wissembourg;7487;213;7700;67544
44;67;05;04;545;Witternheim;503;7;510;67545
44;67;02;05;546;Wittersheim;671;5;676;67546
44;67;05;16;547;Wittisheim;2057;25;2082;67547
44;67;04;02;548;Wiwersheim;881;13;894;67548
44;67;02;13;550;WÅ“rth;1726;23;1749;67550
44;67;08;06;551;Wolfisheim;4174;56;4230;67551
44;67;04;08;552;Wolfskirchen;346;10;356;67552
44;67;04;14;553;Wolschheim;317;4;321;67553
44;67;03;10;554;Wolxheim;969;13;982;67554
44;67;03;14;555;Zehnacker;249;3;252;67555
44;67;03;14;556;Zeinheim;203;3;206;67556
44;67;05;12;557;Zellwiller;812;12;824;67557
44;67;02;13;558;Zinswiller;748;13;761;67558
44;67;04;08;559;Zittersheim;249;2;251;67559
44;68;02;06;001;Algolsheim;1124;13;1137;68001
44;68;01;09;002;Altenach;389;4;393;68002
44;68;01;01;004;Altkirch;5659;130;5789;68004
44;68;02;15;005;Ammerschwihr;1761;48;1809;68005
44;68;01;09;006;Bernwiller;1197;28;1225;68006
44;68;02;05;007;Andolsheim;2182;73;2255;68007
44;68;02;06;008;Appenwihr;578;11;589;68008
44;68;02;06;009;Artzenheim;863;11;874;68009
44;68;01;01;010;Aspach;1120;20;1140;68010
44;68;06;03;011;Aspach-le-Bas;1317;26;1343;68011
44;68;06;03;012;Aspach-Michelbach;1771;44;1815;68012
44;68;04;14;013;Attenschwiller;986;22;1008;68013
44;68;02;15;014;Aubure;370;9;379;68014
44;68;04;13;015;Baldersheim;2667;48;2715;68015
44;68;02;06;016;Balgau;985;19;1004;68016
44;68;01;09;017;Ballersdorf;816;17;833;68017
44;68;01;09;018;Balschwiller;731;16;747;68018
44;68;02;06;019;Baltzenheim;566;8;574;68019
44;68;04;13;020;Bantzenheim;1594;33;1627;68020
44;68;04;02;021;Bartenheim;3987;85;4072;68021
44;68;04;13;022;Battenheim;1594;14;1608;68022
44;68;02;15;023;Beblenheim;939;24;963;68023
44;68;01;09;024;Bellemagny;162;6;168;68024
44;68;01;01;025;Bendorf;236;3;239;68025
44;68;02;15;026;Bennwihr;1393;28;1421;68026
44;68;01;01;027;Berentzwiller;341;9;350;68027
44;68;02;15;028;Bergheim;2070;48;2118;68028
44;68;06;07;029;Bergholtz;1096;32;1128;68029
44;68;06;07;030;Bergholtzzell;424;14;438;68030
44;68;04;17;032;Berrwiller;1195;36;1231;68032
44;68;01;01;033;Bettendorf;441;8;449;68033
44;68;01;01;034;Bettlach;312;16;328;68034
44;68;01;01;035;Biederthal;323;14;337;68035
44;68;02;06;036;Biesheim;2530;55;2585;68036
44;68;06;06;037;Biltzheim;467;7;474;68037
44;68;02;05;038;Bischwihr;1118;26;1144;68038
44;68;01;01;039;Bisel;546;15;561;68039
44;68;06;03;040;Bitschwiller-lès-Thann;1988;37;2025;68040
44;68;02;06;041;Blodelsheim;1999;26;2025;68041
44;68;04;14;042;Blotzheim;4661;116;4777;68042
44;68;04;17;043;Bollwiller;4122;57;4179;68043
44;68;02;15;044;Le Bonhomme;741;30;771;68044
44;68;06;03;045;Bourbach-le-Bas;555;16;571;68045
44;68;06;03;046;Bourbach-le-Haut;417;10;427;68046
44;68;01;01;049;Bouxwiller;439;15;454;68049
44;68;01;09;050;Bréchaumont;404;13;417;68050
44;68;02;16;051;Breitenbach-Haut-Rhin;823;16;839;68051
44;68;01;09;052;Bretten;184;3;187;68052
44;68;04;02;054;Brinckheim;417;8;425;68054
44;68;04;02;055;Bruebach;1052;33;1085;68055
44;68;04;02;056;Brunstatt-Didenheim;8163;214;8377;68056
44;68;01;09;057;Buethwiller;279;5;284;68057
44;68;06;07;058;Buhl;3354;37;3391;68058
44;68;06;09;059;Burnhaupt-le-Bas;1921;45;1966;68059
44;68;06;09;060;Burnhaupt-le-Haut;1749;46;1795;68060
44;68;04;14;061;Buschwiller;1060;17;1077;68061
44;68;01;01;062;Carspach;2045;105;2150;68062
44;68;06;03;063;Cernay;11476;208;11684;68063
44;68;04;13;064;Chalampé;970;19;989;68064
44;68;01;09;065;Chavannes-sur-l'Etang;708;10;718;68065
44;68;02;98;066;Colmar;68682;1074;69756;68066
44;68;01;01;067;Courtavon;354;2;356;68067
44;68;01;09;068;Dannemarie;2262;36;2298;68068
44;68;02;06;069;Dessenheim;1491;32;1523;68069
44;68;01;09;071;Diefmatten;297;6;303;68071
44;68;04;02;072;Dietwiller;1430;53;1483;68072
44;68;06;09;073;Dolleren;479;11;490;68073
44;68;01;01;074;Durlinsdorf;558;7;565;68074
44;68;01;01;075;Durmenach;824;17;841;68075
44;68;02;06;076;Durrenentzen;964;11;975;68076
44;68;01;09;077;Eglingen;371;10;381;68077
44;68;02;16;078;Eguisheim;1721;41;1762;68078
44;68;01;09;079;Elbach;255;0;255;68079
44;68;01;01;080;Emlingen;302;3;305;68080
44;68;01;01;081;Saint-Bernard;570;9;579;68081
44;68;06;06;082;Ensisheim;7512;70;7582;68082
44;68;02;16;083;Eschbach-au-Val;364;13;377;68083
44;68;04;02;084;Eschentzwiller;1479;48;1527;68084
44;68;01;09;085;Eteimbes;378;5;383;68085
44;68;01;09;086;Falkwiller;207;10;217;68086
44;68;01;01;087;Feldbach;461;11;472;68087
44;68;04;17;088;Feldkirch;997;20;1017;68088
44;68;06;03;089;Fellering;1601;25;1626;68089
44;68;01;01;090;Ferrette;812;13;825;68090
44;68;02;06;091;Fessenheim;2267;47;2314;68091
44;68;01;01;092;Fislis;393;6;399;68092
44;68;04;02;093;Flaxlanden;1438;48;1486;68093
44;68;04;14;094;Folgensbourg;941;14;955;68094
44;68;02;05;095;Fortschwihr;1168;40;1208;68095
44;68;01;01;096;Franken;367;4;371;68096
44;68;02;15;097;Fréland;1316;32;1348;68097
44;68;01;09;098;Friesen;650;7;657;68098
44;68;01;01;099;FrÅ“ningen;778;18;796;68099
44;68;01;09;100;Fulleren;339;14;353;68100
44;68;04;08;101;Galfingue;821;18;839;68101
44;68;06;03;102;Geishouse;439;10;449;68102
44;68;04;02;103;Geispitzen;502;9;511;68103
44;68;02;06;104;Geiswasser;296;5;301;68104
44;68;01;09;105;Gildwiller;259;15;274;68105
44;68;06;03;106;Goldbach-Altenbach;279;6;285;68106
44;68;01;09;107;Gommersdorf;374;8;382;68107
44;68;02;16;109;Griesbach-au-Val;696;14;710;68109
44;68;02;05;110;Grussenheim;806;18;824;68110
44;68;06;16;111;Gueberschwihr;854;25;879;68111
44;68;06;07;112;Guebwiller;11020;305;11325;68112
44;68;02;15;113;Guémar;1422;28;1450;68113
44;68;01;09;114;Guevenatten;142;1;143;68114
44;68;06;09;115;Guewenheim;1291;21;1312;68115
44;68;06;16;116;Gundolsheim;716;22;738;68116
44;68;02;16;117;Gunsbach;889;18;907;68117
44;68;04;13;118;Habsheim;4999;87;5086;68118
44;68;01;09;119;Hagenbach;743;16;759;68119
44;68;04;14;120;Hagenthal-le-Bas;1245;28;1273;68120
44;68;04;14;121;Hagenthal-le-Haut;706;19;725;68121
44;68;06;07;122;Hartmannswiller;637;10;647;68122
44;68;06;16;123;Hattstatt;784;28;812;68123
44;68;01;01;124;Hausgauen;380;10;390;68124
44;68;01;09;125;Hecken;518;9;527;68125
44;68;04;14;126;Hégenheim;3369;73;3442;68126
44;68;01;01;127;Heidwiller;645;14;659;68127
44;68;01;01;128;Heimersdorf;662;15;677;68128
44;68;04;08;129;Heimsbrunn;1327;50;1377;68129
44;68;02;06;130;Heiteren;1036;20;1056;68130
44;68;01;01;131;Heiwiller;165;1;166;68131
44;68;04;02;132;Helfrantzkirch;716;18;734;68132
44;68;02;16;134;Herrlisheim-près-Colmar;1859;28;1887;68134
44;68;04;14;135;Hésingue;2770;54;2824;68135
44;68;02;06;136;Hettenschlag;327;11;338;68136
44;68;01;09;137;Hindlingen;621;9;630;68137
44;68;01;01;138;Hirsingue;2120;52;2172;68138
44;68;01;01;139;Hirtzbach;1462;22;1484;68139
44;68;02;06;140;Hirtzfelden;1302;15;1317;68140
44;68;01;01;141;Hochstatt;2170;58;2228;68141
44;68;02;16;142;Hohrod;375;12;387;68142
44;68;02;05;143;Porte du Ried;1823;59;1882;68143
44;68;04;13;144;Hombourg;1346;26;1372;68144
44;68;02;05;145;Horbourg-Wihr;6234;118;6352;68145
44;68;02;05;146;Houssen;2327;23;2350;68146
44;68;02;15;147;Hunawihr;606;8;614;68147
44;68;01;01;148;Hundsbach;359;8;367;68148
44;68;04;14;149;Huningue;7261;97;7358;68149
44;68;02;16;150;Husseren-les-Châteaux;514;13;527;68150
44;68;06;03;151;Husseren-Wesserling;1048;11;1059;68151
44;68;01;01;152;Illfurth;2473;39;2512;68152
44;68;02;15;153;Illhaeusern;730;14;744;68153
44;68;04;12;154;Illzach;14784;201;14985;68154
44;68;02;04;155;Ingersheim;4680;75;4755;68155
44;68;06;07;156;Issenheim;3418;47;3465;68156
44;68;02;05;157;Jebsheim;1367;39;1406;68157
44;68;01;01;158;Jettingen;500;15;515;68158
44;68;06;07;159;Jungholtz;911;25;936;68159
44;68;04;02;160;Kappelen;585;24;609;68160
44;68;02;15;161;Katzenthal;537;23;560;68161
44;68;02;15;162;Kaysersberg Vignoble;4394;92;4486;68162
44;68;04;02;163;Kembs;5496;102;5598;68163
44;68;01;01;165;Kiffis;242;10;252;68165
44;68;04;08;166;Kingersheim;13263;150;13413;68166
44;68;06;09;167;Kirchberg;734;22;756;68167
44;68;04;14;168;KnÅ“ringue;376;7;383;68168
44;68;01;01;169;KÅ“stlach;506;10;516;68169
44;68;04;02;170;KÅ“tzingue;586;24;610;68170
44;68;06;03;171;Kruth;945;12;957;68171
44;68;02;06;172;Kunheim;1795;30;1825;68172
44;68;02;15;173;Labaroche;2122;76;2198;68173
44;68;04;02;174;Landser;1650;25;1675;68174
44;68;02;15;175;Lapoutroie;1871;40;1911;68175
44;68;01;09;176;Largitzen;324;4;328;68176
44;68;06;07;177;Lautenbach;1492;38;1530;68177
44;68;06;07;178;Lautenbachzell;950;14;964;68178
44;68;06;09;179;Lauw;917;15;932;68179
44;68;06;03;180;Leimbach;909;29;938;68180
44;68;01;01;181;Levoncourt;248;4;252;68181
44;68;04;14;182;Leymen;1212;27;1239;68182
44;68;04;14;183;Liebenswiller;183;4;187;68183
44;68;01;01;184;Liebsdorf;303;9;312;68184
44;68;02;15;185;Lièpvre;1684;32;1716;68185
44;68;01;01;186;Ligsdorf;307;10;317;68186
44;68;01;01;187;Linsdorf;333;10;343;68187
44;68;06;07;188;Linthal;584;19;603;68188
44;68;02;06;189;Logelheim;855;26;881;68189
44;68;01;01;190;Lucelle;33;0;33;68190
44;68;01;01;191;Luemschwiller;760;23;783;68191
44;68;01;09;192;Valdieu-Lutran;427;7;434;68192
44;68;02;16;193;Luttenbach-près-Munster;751;9;760;68193
44;68;01;01;194;Lutter;283;5;288;68194
44;68;04;08;195;Lutterbach;6247;98;6345;68195
44;68;01;09;196;Magny;300;5;305;68196
44;68;04;02;197;Magstatt-le-Bas;485;10;495;68197
44;68;04;02;198;Magstatt-le-Haut;286;8;294;68198
44;68;06;03;199;Malmerspach;502;2;504;68199
44;68;01;09;200;Manspach;533;12;545;68200
44;68;06;09;201;Masevaux-Niederbruck;3720;79;3799;68201
44;68;01;09;202;Mertzen;202;4;206;68202
44;68;06;07;203;Merxheim;1247;26;1273;68203
44;68;02;16;204;Metzeral;1042;15;1057;68204
44;68;06;06;205;Meyenheim;1830;19;1849;68205
44;68;04;14;207;Michelbach-le-Bas;697;9;706;68207
44;68;04;14;208;Michelbach-le-Haut;597;11;608;68208
44;68;02;15;209;Mittelwihr;834;16;850;68209
44;68;02;16;210;Mittlach;327;1;328;68210
44;68;06;03;211;Mitzach;386;8;394;68211
44;68;01;01;212;MÅ“rnach;519;12;531;68212
44;68;06;03;213;Mollau;341;10;351;68213
44;68;01;09;214;Montreux-Jeune;378;8;386;68214
44;68;01;09;215;Montreux-Vieux;908;7;915;68215
44;68;01;09;216;Mooslargue;409;6;415;68216
44;68;06;03;217;Moosch;1640;20;1660;68217
44;68;04;08;218;Morschwiller-le-Bas;3692;76;3768;68218
44;68;06;09;219;Le Haut Soultzbach;881;24;905;68219
44;68;01;01;221;Muespach;926;13;939;68221
44;68;01;01;222;Muespach-le-Haut;1057;19;1076;68222
44;68;02;16;223;Muhlbach-sur-Munster;782;14;796;68223
44;68;04;99;224;Mulhouse;108312;1219;109531;68224
44;68;02;06;225;Munchhouse;1561;28;1589;68225
44;68;02;16;226;Munster;4699;84;4783;68226
44;68;02;05;227;Muntzenheim;1286;34;1320;68227
44;68;06;06;228;Munwiller;464;12;476;68228
44;68;06;07;229;Murbach;163;3;166;68229
44;68;02;06;230;Nambsheim;584;7;591;68230
44;68;02;06;231;Neuf-Brisach;1963;16;1979;68231
44;68;04;14;232;Neuwiller;484;7;491;68232
44;68;06;06;234;Niederentzen;733;11;744;68234
44;68;06;06;235;Niederhergheim;1147;16;1163;68235
44;68;02;16;237;Niedermorschwihr;558;15;573;68237
44;68;04;13;238;Niffer;945;25;970;68238
44;68;06;09;239;Oberbruck;390;15;405;68239
44;68;01;01;240;Illtal;1319;19;1338;68240
44;68;06;06;241;Oberentzen;665;9;674;68241
44;68;06;06;242;Oberhergheim;1245;26;1271;68242
44;68;01;01;243;Oberlarg;140;1;141;68243
44;68;02;16;244;Obermorschwihr;358;6;364;68244
44;68;01;01;245;Obermorschwiller;412;15;427;68245
44;68;02;06;246;Obersaasheim;1018;13;1031;68246
44;68;06;03;247;Oderen;1260;14;1274;68247
44;68;01;01;248;Oltingue;673;20;693;68248
44;68;02;15;249;Orbey;3467;66;3533;68249
44;68;06;07;250;Orschwihr;1041;18;1059;68250
44;68;06;16;251;Osenbach;859;22;881;68251
44;68;02;15;252;Ostheim;1654;30;1684;68252
44;68;04;13;253;Ottmarsheim;1973;30;2003;68253
44;68;04;13;254;Petit-Landau;827;18;845;68254
44;68;06;16;255;Pfaffenheim;1386;42;1428;68255
44;68;04;08;256;Pfastatt;9723;131;9854;68256
44;68;01;09;257;Pfetterhouse;966;23;989;68257
44;68;04;17;258;Pulversheim;3017;77;3094;68258
44;68;01;01;259;Raedersdorf;515;7;522;68259
44;68;06;07;260;Raedersheim;1113;26;1139;68260
44;68;06;03;261;Rammersmatt;229;6;235;68261
44;68;06;03;262;Ranspach;801;17;818;68262
44;68;04;14;263;Ranspach-le-Bas;635;13;648;68263
44;68;04;14;264;Ranspach-le-Haut;628;11;639;68264
44;68;04;02;265;Rantzwiller;797;23;820;68265
44;68;06;06;266;Réguisheim;1990;30;2020;68266
44;68;04;08;267;Reiningue;1979;25;2004;68267
44;68;01;09;268;Retzwiller;704;10;714;68268
44;68;02;15;269;Ribeauvillé;4665;176;4841;68269
44;68;04;08;270;Richwiller;3692;59;3751;68270
44;68;04;13;271;Riedisheim;12520;326;12846;68271
44;68;01;01;273;Riespach;632;40;672;68273
44;68;06;07;274;Rimbach-près-Guebwiller;188;0;188;68274
44;68;06;09;275;Rimbach-près-Masevaux;446;11;457;68275
44;68;06;07;276;Rimbachzell;192;2;194;68276
44;68;02;15;277;Riquewihr;1090;19;1109;68277
44;68;04;13;278;Rixheim;14204;201;14405;68278
44;68;06;03;279;Roderen;902;30;932;68279
44;68;02;15;280;Rodern;374;6;380;68280
44;68;02;06;281;Roggenhouse;466;13;479;68281
44;68;01;09;282;Romagny;280;5;285;68282
44;68;02;15;283;Rombach-le-Franc;771;23;794;68283
44;68;01;01;284;Roppentzwiller;696;10;706;68284
44;68;02;15;285;Rorschwihr;371;8;379;68285
44;68;04;14;286;Rosenau;2371;49;2420;68286
44;68;06;16;287;Rouffach;4302;236;4538;68287
44;68;01;01;288;Ruederbach;401;4;405;68288
44;68;04;17;289;Ruelisheim;2329;37;2366;68289
44;68;02;06;290;Rustenhart;888;16;904;68290
44;68;02;06;291;Rumersheim-le-Haut;1059;27;1086;68291
44;68;06;03;292;Saint-Amarin;2233;43;2276;68292
44;68;01;09;293;Saint-Cosme;83;1;84;68293
44;68;02;15;294;Sainte-Croix-aux-Mines;1908;30;1938;68294
44;68;02;05;295;Sainte-Croix-en-Plaine;3029;66;3095;68295
44;68;02;15;296;Saint-Hippolyte;993;14;1007;68296
44;68;04;14;297;Saint-Louis;22413;287;22700;68297
44;68;02;15;298;Sainte-Marie-aux-Mines;5054;127;5181;68298
44;68;01;09;299;Saint-Ulrich;312;0;312;68299
44;68;04;13;300;Sausheim;5479;125;5604;68300
44;68;04;02;301;Schlierbach;1269;25;1294;68301
44;68;06;03;302;Schweighouse-Thann;752;30;782;68302
44;68;01;01;303;Schwoben;229;7;236;68303
44;68;06;09;304;Sentheim;1561;39;1600;68304
44;68;01;09;305;Seppois-le-Bas;1390;28;1418;68305
44;68;01;09;306;Seppois-le-Haut;507;8;515;68306
44;68;06;09;307;Sewen;498;10;508;68307
44;68;06;09;308;Sickert;325;12;337;68308
44;68;04;02;309;Sierentz;3842;76;3918;68309
44;68;02;16;311;Sondernach;598;12;610;68311
44;68;01;01;312;Sondersdorf;318;6;324;68312
44;68;06;09;313;Soppe-le-Bas;775;11;786;68313
44;68;06;07;315;Soultz-Haut-Rhin;7048;134;7182;68315
44;68;02;16;316;Soultzbach-les-Bains;730;21;751;68316
44;68;02;16;317;Soultzeren;1106;19;1125;68317
44;68;06;16;318;Soultzmatt;2392;52;2444;68318
44;68;01;01;320;Spechbach;1369;47;1416;68320
44;68;04;17;321;Staffelfelden;4046;62;4108;68321
44;68;06;03;322;Steinbach;1349;29;1378;68322
44;68;04;02;323;Steinbrunn-le-Bas;809;24;833;68323
44;68;04;02;324;Steinbrunn-le-Haut;611;17;628;68324
44;68;01;01;325;Steinsoultz;764;9;773;68325
44;68;01;09;326;Sternenberg;153;5;158;68326
44;68;04;02;327;Stetten;350;7;357;68327
44;68;06;03;328;Storckensohn;201;1;202;68328
44;68;02;16;329;Stosswihr;1349;34;1383;68329
44;68;01;09;330;Strueth;338;8;346;68330
44;68;02;05;331;Sundhoffen;1939;58;1997;68331
44;68;01;01;332;Tagolsheim;949;13;962;68332
44;68;01;01;333;Tagsdorf;296;6;302;68333
44;68;06;03;334;Thann;7767;148;7915;68334
44;68;02;15;335;Thannenkirch;464;6;470;68335
44;68;01;09;336;Traubach-le-Bas;459;8;467;68336
44;68;01;09;337;Traubach-le-Haut;605;11;616;68337
44;68;02;16;338;Turckheim;3831;80;3911;68338
44;68;01;09;340;Ueberstrass;373;15;388;68340
44;68;04;02;341;Uffheim;946;30;976;68341
44;68;06;03;342;Uffholtz;1698;43;1741;68342
44;68;04;17;343;Ungersheim;2381;34;2415;68343
44;68;06;03;344;Urbès;438;10;448;68344
44;68;02;06;345;Urschenheim;757;27;784;68345
44;68;01;01;347;Vieux-Ferrette;693;22;715;68347
44;68;06;03;348;Vieux-Thann;2815;51;2866;68348
44;68;04;14;349;Village-Neuf;4421;95;4516;68349
44;68;02;16;350;VÅ“gtlinshoffen;477;15;492;68350
44;68;02;06;351;Vogelgrun;639;13;652;68351
44;68;02;06;352;Volgelsheim;2680;24;2704;68352
44;68;04;02;353;Wahlbach;491;17;508;68353
44;68;02;16;354;Walbach;920;37;957;68354
44;68;01;01;355;Waldighofen;1543;28;1571;68355
44;68;01;01;356;Walheim;880;21;901;68356
44;68;04;02;357;Waltenheim;514;17;531;68357
44;68;02;16;358;Wasserbourg;471;11;482;68358
44;68;06;03;359;Wattwiller;1663;59;1722;68359
44;68;02;06;360;Weckolsheim;653;4;657;68360
44;68;06;09;361;Wegscheid;320;5;325;68361
44;68;04;14;362;Wentzwiller;771;15;786;68362
44;68;01;01;363;Werentzhouse;587;12;599;68363
44;68;06;16;364;Westhalten;992;19;1011;68364
44;68;02;16;365;Wettolsheim;1745;64;1809;68365
44;68;02;05;366;Wickerschwihr;711;30;741;68366
44;68;02;06;367;Widensolen;1178;21;1199;68367
44;68;02;16;368;Wihr-au-Val;1242;35;1277;68368
44;68;06;03;370;Wildenstein;169;2;171;68370
44;68;01;01;371;Willer;310;9;319;68371
44;68;06;03;372;Willer-sur-Thur;1780;39;1819;68372
44;68;01;01;373;Winkel;300;12;312;68373
44;68;02;16;374;Wintzenheim;7853;408;8261;68374
44;68;04;17;375;Wittelsheim;10362;137;10499;68375
44;68;04;17;376;Wittenheim;14776;111;14887;68376
44;68;01;01;377;Wittersdorf;794;19;813;68377
44;68;01;09;378;Wolfersdorf;380;4;384;68378
44;68;02;06;379;Wolfgantzen;1036;20;1056;68379
44;68;01;01;380;Wolschwiller;443;11;454;68380
44;68;06;07;381;Wuenheim;799;16;815;68381
44;68;04;02;382;Zaessingue;379;4;383;68382
44;68;02;15;383;Zellenberg;320;8;328;68383
44;68;04;02;384;Zillisheim;2538;61;2599;68384
44;68;02;16;385;Zimmerbach;837;25;862;68385
44;68;04;02;386;Zimmersheim;1041;22;1063;68386
84;69;02;10;001;Affoux;391;3;394;69001
84;69;02;11;002;Aigueperse;245;1;246;69002
84;69;01;00;003;Albigny-sur-Saône;2947;42;2989;69003
84;69;02;04;004;Alix;768;24;792;69004
84;69;02;01;005;Ambérieux;584;9;593;69005
84;69;02;11;006;Amplepuis;4919;119;5038;69006
84;69;01;08;007;Ampuis;2749;45;2794;69007
84;69;02;10;008;Ancy;668;15;683;69008
84;69;02;01;009;Anse;7538;164;7702;69009
84;69;02;02;010;L'Arbresle;6410;196;6606;69010
84;69;02;03;012;Les Ardillats;611;15;626;69012
84;69;02;07;013;Arnas;3897;82;3979;69013
84;69;01;12;014;Aveize;1129;22;1151;69014
84;69;02;11;016;Azolette;121;0;121;69016
84;69;02;04;017;Bagnols;745;21;766;69017
84;69;02;03;018;Beaujeu;2148;32;2180;69018
84;69;02;03;019;Belleville-en-Beaujolais;13314;277;13591;69019
84;69;02;04;020;Belmont-d'Azergues;681;19;700;69020
84;69;02;02;021;Bessenay;2340;80;2420;69021
84;69;02;02;022;Bibost;558;16;574;69022
84;69;02;07;023;Blacé;1635;25;1660;69023
84;69;02;04;024;Val d'Oingt;4122;103;4225;69024
84;69;02;04;026;Le Breuil;548;10;558;69026
84;69;01;05;027;Brignais;12097;175;12272;69027
84;69;01;05;028;Brindas;6478;111;6589;69028
84;69;01;00;029;Bron;42244;401;42645;69029
84;69;01;02;030;Brullioles;818;15;833;69030
84;69;01;02;031;Brussieu;1379;104;1483;69031
84;69;02;04;032;Bully;1988;36;2024;69032
84;69;01;00;033;Cailloux-sur-Fontaines;2883;74;2957;69033
84;69;01;00;034;Caluire-et-Cuire;43294;622;43916;69034
84;69;02;03;035;Cenves;381;7;388;69035
84;69;02;03;036;Cercié;1138;22;1160;69036
84;69;02;10;037;Chambost-Allières;833;12;845;69037
84;69;01;02;038;Chambost-Longessaigne;928;25;953;69038
84;69;02;04;039;Chamelet;694;10;704;69039
84;69;01;00;040;Champagne-au-Mont-d'Or;5748;48;5796;69040
84;69;01;12;042;La Chapelle-sur-Coise;566;15;581;69042
84;69;01;05;043;Chaponost;8846;173;9019;69043
84;69;01;00;044;Charbonnières-les-Bains;5170;146;5316;69044
84;69;02;03;045;Charentay;1248;68;1316;69045
84;69;01;00;046;Charly;4563;138;4701;69046
84;69;02;04;047;Charnay;1051;21;1072;69047
84;69;02;01;049;Chasselay;2791;65;2856;69049
84;69;02;04;050;Châtillon;2113;42;2155;69050
84;69;01;08;051;Chaussan;1170;33;1203;69051
84;69;02;01;052;Chazay-d'Azergues;4132;113;4245;69052
84;69;02;03;053;Chénas;543;13;556;69053
84;69;02;11;054;Chénelette;343;2;345;69054
84;69;02;01;055;Les Chères;1448;27;1475;69055
84;69;02;04;056;Chessy;2107;52;2159;69056
84;69;02;02;057;Chevinay;582;13;595;69057
84;69;02;03;058;Chiroubles;384;9;393;69058
84;69;02;01;059;Civrieux-d'Azergues;1537;28;1565;69059
84;69;02;11;060;Claveisolles;576;83;659;69060
84;69;02;04;061;Cogny;1188;34;1222;69061
84;69;01;12;062;Coise;778;23;801;69062
84;69;01;00;063;Collonges-au-Mont-d'Or;4315;86;4401;69063
84;69;01;08;064;Condrieu;3957;83;4040;69064
84;69;02;03;065;Corcelles-en-Beaujolais;965;15;980;69065
84;69;02;11;066;Cours;4390;80;4470;69066
84;69;02;02;067;Courzieu;1168;21;1189;69067
84;69;01;00;068;Couzon-au-Mont-d'Or;2454;48;2502;69068
84;69;01;00;069;Craponne;11248;184;11432;69069
84;69;02;11;070;Cublize;1266;28;1294;69070
84;69;01;00;071;Curis-au-Mont-d'Or;1179;27;1206;69071
84;69;01;00;072;Dardilly;8752;612;9364;69072
84;69;02;07;074;Denicé;1550;40;1590;69074
84;69;02;10;075;Dième;193;2;195;69075
84;69;02;01;076;Dommartin;2595;101;2696;69076
84;69;02;03;077;Dracé;965;12;977;69077
84;69;01;12;078;Duerne;837;16;853;69078
84;69;01;08;080;Echalas;1901;16;1917;69080
84;69;01;00;081;Ecully;18948;385;19333;69081
84;69;02;03;082;Emeringes;270;8;278;69082
84;69;02;02;083;Eveux;1164;39;1203;69083
84;69;02;03;084;Fleurie;1282;22;1304;69084
84;69;01;00;085;Fleurieu-sur-Saône;1492;42;1534;69085
84;69;02;02;086;Fleurieux-sur-l'Arbresle;2290;63;2353;69086
84;69;01;00;087;Fontaines-Saint-Martin;3033;73;3106;69087
84;69;01;00;088;Fontaines-sur-Saône;7066;97;7163;69088
84;69;01;00;089;Francheville;14906;258;15164;69089
84;69;02;04;090;Frontenas;809;24;833;69090
84;69;01;00;091;Givors;20285;104;20389;69091
84;69;02;07;092;Gleizé;7496;345;7841;69092
84;69;02;10;093;Grandris;1187;19;1206;69093
84;69;01;05;094;Grézieu-la-Varenne;6062;115;6177;69094
84;69;01;12;095;Grézieu-le-Marché;827;17;844;69095
84;69;01;00;096;Grigny;9706;75;9781;69096
84;69;01;08;097;Les Haies;772;20;792;69097
84;69;01;02;098;Les Halles;508;7;515;69098
84;69;01;02;099;Haute-Rivoire;1442;28;1470;69099
84;69;01;00;100;Irigny;8750;121;8871;69100
84;69;02;10;102;Joux;734;12;746;69102
84;69;02;03;103;Juliénas;899;22;921;69103
84;69;02;03;104;Jullié;432;9;441;69104
84;69;02;07;105;Lacenas;1021;37;1058;69105
84;69;02;01;106;Lachassagne;1181;24;1205;69106
84;69;02;10;107;Lamure-sur-Azergues;1055;66;1121;69107
84;69;02;03;108;Lancié;1043;22;1065;69108
84;69;02;03;109;Lantignié;861;27;888;69109
84;69;01;12;110;Larajasse;1862;30;1892;69110
84;69;02;04;111;Légny;673;17;690;69111
84;69;02;01;112;Lentilly;6480;155;6635;69112
84;69;02;04;113;Létra;901;27;928;69113
84;69;02;07;115;Limas;4871;98;4969;69115
84;69;01;00;116;Limonest;3648;102;3750;69116
84;69;01;00;117;Lissieu;3134;75;3209;69117
84;69;01;08;118;Loire-sur-Rhône;2618;32;2650;69118
84;69;01;08;119;Longes;977;8;985;69119
84;69;01;02;120;Longessaigne;595;16;611;69120
84;69;02;01;121;Lozanne;2729;45;2774;69121
84;69;02;01;122;Lucenay;1916;53;1969;69122
84;69;02;03;124;Marchampt;459;9;468;69124
84;69;02;01;125;Marcilly-d'Azergues;876;15;891;69125
84;69;02;01;126;Marcy;768;28;796;69126
84;69;01;00;127;Marcy-l'Etoile;3549;64;3613;69127
84;69;02;11;130;Meaux-la-Montagne;233;3;236;69130
84;69;01;05;131;Messimy;3402;85;3487;69131
84;69;01;12;132;Meys;847;15;862;69132
84;69;01;09;133;Millery;4318;80;4398;69133
84;69;02;04;134;Moiré;227;10;237;69134
84;69;02;11;135;Deux-Grosnes;1911;53;1964;69135
84;69;01;09;136;Montagny;3118;55;3173;69136
84;69;02;07;137;Montmelas-Saint-Sorlin;516;7;523;69137
84;69;01;02;138;Montromant;445;9;454;69138
84;69;01;02;139;Montrottier;1378;77;1455;69139
84;69;02;01;140;Morancé;1995;46;2041;69140
84;69;01;08;141;Mornant;6144;172;6316;69141
84;69;01;00;142;La Mulatière;6524;73;6597;69142
84;69;01;00;143;Neuville-sur-Saône;7562;88;7650;69143
84;69;02;03;145;Odenas;921;25;946;69145
84;69;01;09;148;Orliénas;2541;71;2612;69148
84;69;01;00;149;Oullins;26553;278;26831;69149
84;69;02;07;151;Le Perréon;1524;32;1556;69151
84;69;01;00;152;Pierre-Bénite;10397;60;10457;69152
84;69;01;00;153;Poleymieux-au-Mont-d'Or;1377;28;1405;69153
84;69;01;12;154;Pollionnay;2845;53;2898;69154
84;69;01;12;155;Pomeys;1132;31;1163;69155
84;69;02;01;156;Pommiers;2713;82;2795;69156
84;69;02;10;157;Vindry-sur-Turdine;5279;88;5367;69157
84;69;02;04;159;Porte des Pierres Dorées;3907;93;4000;69159
84;69;02;11;160;Poule-les-Echarmeaux;1065;18;1083;69160
84;69;02;11;161;Propières;487;11;498;69161
84;69;02;03;162;Quincié-en-Beaujolais;1331;34;1365;69162
84;69;01;00;163;Quincieux;3495;50;3545;69163
84;69;02;11;164;Ranchal;322;10;332;69164
84;69;02;03;165;Régnié-Durette;1126;25;1151;69165
84;69;01;08;166;Riverie;328;2;330;69166
84;69;02;07;167;Rivolet;589;11;600;69167
84;69;01;00;168;Rochetaillée-sur-Saône;1536;41;1577;69168
84;69;02;11;169;Ronno;639;23;662;69169
84;69;01;12;170;Rontalon;1157;18;1175;69170
84;69;02;02;171;Sain-Bel;2363;26;2389;69171
84;69;02;07;172;Salles-Arbuissonnas-en-Beaujolais;761;27;788;69172
84;69;02;10;173;Sarcey;1016;25;1041;69173
84;69;02;10;174;Les Sauvages;614;11;625;69174
84;69;02;02;175;Savigny;1996;56;2052;69175
84;69;01;08;176;Soucieu-en-Jarrest;4590;84;4674;69176
84;69;02;02;177;Sourcieux-les-Mines;2064;46;2110;69177
84;69;01;02;178;Souzy;825;20;845;69178
84;69;01;08;179;Beauvallon;4055;74;4129;69179
84;69;01;12;180;Saint-André-la-Côte;288;9;297;69180
84;69;02;10;181;Saint-Appolinaire;223;1;224;69181
84;69;02;11;182;Saint-Bonnet-des-Bruyères;356;2;358;69182
84;69;02;11;183;Saint-Bonnet-le-Troncy;317;2;319;69183
84;69;01;12;184;Sainte-Catherine;991;21;1012;69184
84;69;02;11;186;Saint-Clément-de-Vers;213;4;217;69186
84;69;01;02;187;Saint-Clément-les-Places;654;21;675;69187
84;69;02;10;188;Saint-Clément-sur-Valsonne;908;9;917;69188
84;69;01;08;189;Sainte-Colombe;1884;29;1913;69189
84;69;01;12;190;Sainte-Consorce;2028;87;2115;69190
84;69;01;00;191;Saint-Cyr-au-Mont-d'Or;5747;142;5889;69191
84;69;02;07;192;Saint-Cyr-le-Chatoux;153;7;160;69192
84;69;01;08;193;Saint-Cyr-sur-le-Rhône;1269;32;1301;69193
84;69;01;00;194;Saint-Didier-au-Mont-d'Or;7006;158;7164;69194
84;69;02;03;196;Saint-Didier-sur-Beaujeu;617;11;628;69196
84;69;02;07;197;Saint-Etienne-des-Oullières;2210;48;2258;69197
84;69;02;03;198;Saint-Etienne-la-Varenne;756;11;767;69198
84;69;01;00;199;Saint-Fons;19617;61;19678;69199
84;69;02;10;200;Saint-Forgeux;1472;31;1503;69200
84;69;01;02;201;Sainte-Foy-l'Argentière;1286;25;1311;69201
84;69;01;00;202;Sainte-Foy-lès-Lyon;22175;392;22567;69202
84;69;01;02;203;Saint-Genis-l'Argentière;1018;17;1035;69203
84;69;01;00;204;Saint-Genis-Laval;20914;477;21391;69204
84;69;01;00;205;Saint-Genis-les-Ollières;5158;92;5250;69205
84;69;02;07;206;Saint-Georges-de-Reneins;4409;92;4501;69206
84;69;01;00;207;Saint-Germain-au-Mont-d'Or;3001;47;3048;69207
84;69;02;04;208;Saint-Germain-Nuelles;2262;60;2322;69208
84;69;02;11;209;Saint-Igny-de-Vers;566;16;582;69209
84;69;02;04;212;Saint-Jean-des-Vignes;479;11;490;69212
84;69;02;11;214;Saint-Jean-la-Bussière;1204;25;1229;69214
84;69;02;07;215;Saint-Julien;879;20;899;69215
84;69;02;02;216;Saint-Julien-sur-Bibost;566;11;577;69216
84;69;02;10;217;Saint-Just-d'Avray;748;22;770;69217
84;69;02;03;218;Saint-Lager;1048;17;1065;69218
84;69;01;08;219;Saint-Laurent-d'Agny;2133;63;2196;69219
84;69;01;02;220;Saint-Laurent-de-Chamousset;1805;113;1918;69220
84;69;02;10;225;Saint-Marcel-l'Eclairé;541;14;555;69225
84;69;01;12;227;Saint-Martin-en-Haut;3853;189;4042;69227
84;69;01;08;228;Chabanière;4224;93;4317;69228
84;69;02;11;229;Saint-Nizier-d'Azergues;800;14;814;69229
84;69;02;04;230;Sainte-Paule;320;6;326;69230
84;69;02;02;231;Saint-Pierre-la-Palud;2596;60;2656;69231
84;69;01;00;233;Saint-Romain-au-Mont-d'Or;1228;50;1278;69233
84;69;02;10;234;Saint-Romain-de-Popey;1583;73;1656;69234
84;69;01;08;235;Saint-Romain-en-Gal;1967;106;2073;69235
84;69;01;08;236;Saint-Romain-en-Gier;590;7;597;69236
84;69;01;12;238;Saint-Symphorien-sur-Coise;3710;96;3806;69238
84;69;02;04;239;Saint-Vérand;1212;25;1237;69239
84;69;02;11;240;Saint-Vincent-de-Reins;617;6;623;69240
84;69;01;09;241;Taluyers;2590;61;2651;69241
84;69;02;03;242;Taponas;927;13;940;69242
84;69;02;10;243;Tarare;10490;273;10763;69243
84;69;01;00;244;Tassin-la-Demi-Lune;22286;351;22637;69244
84;69;02;04;245;Ternand;710;25;735;69245
84;69;02;04;246;Theizé;1295;35;1330;69246
84;69;02;11;248;Thizy-les-Bourgs;6020;126;6146;69248
84;69;01;12;249;Thurins;3053;63;3116;69249
84;69;01;00;250;La Tour-de-Salvagny;4117;99;4216;69250
84;69;01;08;252;Trèves;745;9;754;69252
84;69;01;08;253;Tupin-et-Semons;637;10;647;69253
84;69;02;10;254;Valsonne;971;10;981;69254
84;69;01;12;255;Vaugneray;6080;111;6191;69255
84;69;01;00;256;Vaulx-en-Velin;52795;221;53016;69256
84;69;02;07;257;Vaux-en-Beaujolais;1086;19;1105;69257
84;69;02;03;258;Vauxrenard;322;7;329;69258
84;69;01;00;259;Vénissieux;67285;266;67551;69259
84;69;01;00;260;Vernaison;4999;56;5055;69260
84;69;02;03;261;Vernay;104;1;105;69261
84;69;01;02;263;Villechenève;881;19;900;69263
84;69;02;13;264;Villefranche-sur-Saône;36291;419;36710;69264
84;69;02;04;265;Ville-sur-Jarnioux;802;33;835;69265
84;69;01;00;266;Villeurbanne;152212;1082;153294;69266
84;69;02;03;267;Villié-Morgon;2137;114;2251;69267
84;69;01;05;268;Vourles;3367;91;3458;69268
84;69;01;12;269;Yzeron;992;24;1016;69269
84;69;01;09;270;Chaponnay;4355;67;4422;69270
84;69;01;00;271;Chassieu;10638;152;10790;69271
84;69;01;09;272;Communay;4242;85;4327;69272
84;69;01;00;273;Corbas;11196;73;11269;69273
84;69;01;00;275;Décines-Charpieu;28930;139;29069;69275
84;69;01;00;276;Feyzin;9902;52;9954;69276
84;69;01;06;277;Genas;13181;221;13402;69277
84;69;01;00;278;Genay;5509;105;5614;69278
84;69;01;00;279;Jonage;6076;76;6152;69279
84;69;01;06;280;Jons;1528;13;1541;69280
84;69;01;09;281;Marennes;1912;23;1935;69281
84;69;01;00;282;Meyzieu;34640;301;34941;69282
84;69;01;00;283;Mions;13707;146;13853;69283
84;69;01;00;284;Montanay;3230;116;3346;69284
84;69;01;06;285;Pusignan;4191;38;4229;69285
84;69;01;00;286;Rillieux-la-Pape;30697;366;31063;69286
84;69;01;06;287;Saint-Bonnet-de-Mure;6875;108;6983;69287
84;69;01;06;288;Saint-Laurent-de-Mure;5458;67;5525;69288
84;69;01;06;289;Saint-Pierre-de-Chandieu;4579;82;4661;69289
84;69;01;00;290;Saint-Priest;46927;284;47211;69290
84;69;01;09;291;Saint-Symphorien-d'Ozon;5789;56;5845;69291
84;69;01;00;292;Sathonay-Camp;6497;63;6560;69292
84;69;01;00;293;Sathonay-Village;2369;48;2417;69293
84;69;01;09;294;Sérézin-du-Rhône;2772;37;2809;69294
84;69;01;09;295;Simandres;1810;9;1819;69295
84;69;01;00;296;Solaize;2986;33;3019;69296
84;69;01;09;297;Ternay;5512;74;5586;69297
84;69;01;06;298;Toussieu;3188;28;3216;69298
84;69;01;06;299;Colombier-Saugnieu;2700;42;2742;69299
84;69;01;00;381;Lyon 1er Arrondissement;29641;782;30423;69381
84;69;01;00;382;Lyon 2e Arrondissement;31303;386;31689;69382
84;69;01;00;383;Lyon 3e Arrondissement;102725;1006;103731;69383
84;69;01;00;384;Lyon 4e Arrondissement;36064;406;36470;69384
84;69;01;00;385;Lyon 5e Arrondissement;49664;1085;50749;69385
84;69;01;00;386;Lyon 6e Arrondissement;52862;884;53746;69386
84;69;01;00;387;Lyon 7e Arrondissement;82573;493;83066;69387
84;69;01;00;388;Lyon 8e Arrondissement;86154;1022;87176;69388
84;69;01;00;389;Lyon 9e Arrondissement;51983;537;52520;69389
27;70;01;13;001;Abelcourt;357;4;361;70001
27;70;02;05;002;Aboncourt-Gesincourt;209;7;216;70002
27;70;02;01;003;Achey;69;2;71;70003
27;70;01;06;004;Adelans-et-le-Val-de-Bithaine;307;2;309;70004
27;70;01;17;005;Aillevans;134;2;136;70005
27;70;01;13;006;Aillevillers-et-Lyaumont;1490;102;1592;70006
27;70;01;08;007;Ailloncourt;304;6;310;70007
27;70;01;13;008;Ainvelle;148;2;150;70008
27;70;02;05;009;Aisey-et-Richecourt;102;1;103;70009
27;70;01;05;010;Alaincourt;104;1;105;70010
27;70;01;10;011;Amage;317;4;321;70011
27;70;02;11;012;Amance;656;11;667;70012
27;70;01;05;013;Ambiévillers;67;0;67;70013
27;70;01;07;014;Amblans-et-Velotte;399;6;405;70014
27;70;02;11;015;Amoncourt;274;6;280;70015
27;70;01;10;016;Amont-et-Effreney;162;2;164;70016
27;70;01;11;017;Anchenoncourt-et-Chazel;240;2;242;70017
27;70;02;02;018;Ancier;512;4;516;70018
27;70;02;15;019;Andelarre;143;4;147;70019
27;70;02;15;020;Andelarrot;244;2;246;70020
27;70;01;07;021;Andornay;191;5;196;70021
27;70;02;02;022;Angirey;147;3;150;70022
27;70;01;11;023;Anjeux;143;3;146;70023
27;70;02;02;024;Apremont;446;14;460;70024
27;70;02;05;025;Arbecey;242;4;246;70025
27;70;02;02;026;Arc-lès-Gray;2533;26;2559;70026
27;70;02;01;027;Argillières;71;1;72;70027
27;70;02;14;028;Aroz;143;3;146;70028
27;70;01;07;029;Arpenans;239;2;241;70029
27;70;02;09;030;Arsans;45;1;46;70030
27;70;01;17;031;Athesans-Etroitefontaine;644;17;661;70031
27;70;02;01;032;Attricourt;45;0;45;70032
27;70;02;05;035;Augicourt;177;4;181;70035
27;70;02;12;036;Aulx-lès-Cromary;159;2;161;70036
27;70;02;01;037;Autet;258;21;279;70037
27;70;02;12;038;Authoison;315;9;324;70038
27;70;02;09;039;Autoreille;355;4;359;70039
27;70;02;17;040;Autrey-lès-Cerre;239;3;242;70040
27;70;02;01;041;Autrey-lès-Gray;377;9;386;70041
27;70;01;17;042;Autrey-le-Vay;103;1;104;70042
27;70;02;01;043;Auvet-et-la-Chapelotte;237;3;240;70043
27;70;02;11;044;Auxon;408;12;420;70044
27;70;02;09;045;Avrigney-Virey;419;7;426;70045
27;70;01;07;046;Les Aynans;367;7;374;70046
27;70;02;14;047;Baignes;107;2;109;70047
27;70;02;09;048;Bard-lès-Pesmes;139;3;142;70048
27;70;02;05;049;Barges;97;2;99;70049
27;70;02;12;050;La Barre;98;0;98;70050
27;70;01;05;051;La Basse-Vaivre;34;0;34;70051
27;70;01;11;052;Bassigney;121;3;124;70052
27;70;02;14;053;Les Bâties;77;1;78;70053
27;70;02;02;054;Battrans;241;4;245;70054
27;70;01;08;055;Baudoncourt;500;7;507;70055
27;70;02;11;056;Baulay;310;1;311;70056
27;70;02;09;057;Bay;149;2;151;70057
27;70;02;14;058;Beaujeu-Saint-Vallier-Pierrejux-et-Quitteur;931;14;945;70058
27;70;02;12;059;Beaumotte-Aubertans;470;8;478;70059
27;70;02;09;060;Beaumotte-lès-Pin;294;3;297;70060
27;70;01;10;061;Belfahy;85;0;85;70061
27;70;01;10;062;Belmont;142;5;147;70062
27;70;01;10;063;Belonchamp;210;3;213;70063
27;70;01;04;064;Belverne;149;3;152;70064
27;70;02;12;065;Besnans;77;1;78;70065
27;70;02;05;066;Betaucourt;180;1;181;70066
27;70;01;06;067;Betoncourt-lès-Brotte;126;0;126;70067
27;70;01;11;069;Betoncourt-Saint-Pancras;46;0;46;70069
27;70;02;05;070;Betoncourt-sur-Mance;28;2;30;70070
27;70;01;10;071;Beulotte-Saint-Laurent;56;0;56;70071
27;70;01;17;072;Beveuge;83;2;85;70072
27;70;02;05;074;Blondefontaine;244;3;247;70074
27;70;02;09;075;Bonboillon;199;2;201;70075
27;70;02;09;076;Bonnevent-Velloreille;376;8;384;70076
27;70;02;17;077;Borey;221;4;225;70077
27;70;02;05;078;Bougey;93;2;95;70078
27;70;02;11;079;Bougnon;524;12;536;70079
27;70;02;01;080;Bouhans-et-Feurg;238;4;242;70080
27;70;01;06;081;Bouhans-lès-Lure;324;4;328;70081
27;70;02;12;082;Bouhans-lès-Montbozon;130;2;132;70082
27;70;01;11;083;Bouligney;404;10;414;70083
27;70;02;12;084;Boulot;663;10;673;70084
27;70;02;12;085;Boult;680;13;693;70085
27;70;02;05;086;Bourbévelle;75;0;75;70086
27;70;02;11;087;Bourguignon-lès-Conflans;147;3;150;70087
27;70;02;14;088;Bourguignon-lès-la-Charité;117;2;119;70088
27;70;02;05;089;Bourguignon-lès-Morey;46;0;46;70089
27;70;02;14;090;Boursières;60;2;62;70090
27;70;02;05;091;Bousseraucourt;47;1;48;70091
27;70;02;09;092;Bresilley;177;3;180;70092
27;70;01;08;093;Breuches;654;8;662;70093
27;70;01;10;094;Breuchotte;301;5;306;70094
27;70;02;11;095;Breurey-lès-Faverney;654;11;665;70095
27;70;01;03;096;Brevilliers;635;17;652;70096
27;70;01;13;097;Briaucourt;238;8;246;70097
27;70;01;08;098;Brotte-lès-Luxeuil;211;4;215;70098
27;70;02;01;099;Brotte-lès-Ray;76;1;77;70099
27;70;02;01;100;Broye-les-Loups-et-Verfontaine;133;0;133;70100
27;70;02;09;101;Broye-Aubigney-Montseugny;501;5;506;70101
27;70;02;09;102;Brussey;277;10;287;70102
27;70;01;10;103;La Bruyère;221;3;224;70103
27;70;02;09;104;Bucey-lès-Gy;590;13;603;70104
27;70;02;14;105;Bucey-lès-Traves;137;1;138;70105
27;70;02;11;106;Buffignécourt;113;2;115;70106
27;70;02;12;107;Bussières;437;4;441;70107
27;70;02;12;109;Buthiers;306;2;308;70109
27;70;02;17;111;Calmoutier;275;3;278;70111
27;70;02;05;112;Cemboing;174;5;179;70112
27;70;02;12;113;Cenans;132;3;135;70113
27;70;02;05;114;Cendrecourt;205;2;207;70114
27;70;02;17;115;Cerre-lès-Noroy;236;5;241;70115
27;70;01;03;116;Chagey;617;12;629;70116
27;70;01;03;117;Châlonvillars;1238;33;1271;70117
27;70;02;12;118;Chambornay-lès-Bellevaux;194;2;196;70118
27;70;02;09;119;Chambornay-lès-Pin;357;12;369;70119
27;70;01;03;120;Champagney;3745;72;3817;70120
27;70;01;04;121;Champey;878;16;894;70121
27;70;02;01;122;Champlitte;1633;32;1665;70122
27;70;02;02;124;Champtonnay;92;1;93;70124
27;70;02;02;125;Champvans;176;2;178;70125
27;70;02;09;126;Chancey;197;6;203;70126
27;70;02;14;127;Chantes;110;6;116;70127
27;70;01;08;128;La Chapelle-lès-Luxeuil;387;3;390;70128
27;70;02;14;129;La Chapelle-Saint-Quillain;162;3;165;70129
27;70;02;09;130;Charcenne;318;8;326;70130
27;70;02;01;132;Chargey-lès-Gray;704;67;771;70132
27;70;02;05;133;Chargey-lès-Port;235;7;242;70133
27;70;02;15;134;Chariez;204;2;206;70134
27;70;02;05;135;Charmes-Saint-Valbert;34;1;35;70135
27;70;02;15;136;Charmoille;489;9;498;70136
27;70;02;12;137;Chassey-lès-Montbozon;215;8;223;70137
27;70;02;14;138;Chassey-lès-Scey;124;3;127;70138
27;70;01;06;140;Châteney;67;1;68;70140
27;70;01;06;141;Châtenois;118;2;120;70141
27;70;02;09;142;Chaumercenne;190;2;192;70142
27;70;02;05;143;Chauvirey-le-Châtel;124;6;130;70143
27;70;02;05;144;Chauvirey-le-Vieil;33;1;34;70144
27;70;02;12;145;Chaux-la-Lotière;480;10;490;70145
27;70;02;11;146;Chaux-lès-Port;164;4;168;70146
27;70;01;04;147;Chavanne;228;4;232;70147
27;70;02;14;148;Chemilly;86;1;87;70148
27;70;01;04;149;Chenebier;693;17;710;70149
27;70;02;09;150;Chenevrey-et-Morogne;320;2;322;70150
27;70;02;09;151;Chevigney;36;0;36;70151
27;70;02;09;152;Choye;475;37;512;70152
27;70;02;05;153;Cintrey;96;1;97;70153
27;70;02;12;154;Cirey;371;6;377;70154
27;70;01;08;155;Citers;799;15;814;70155
27;70;02;09;156;Citey;111;1;112;70156
27;70;01;03;157;Clairegoutte;361;10;371;70157
27;70;02;14;158;Clans;105;1;106;70158
27;70;02;12;159;Cognières;89;0;89;70159
27;70;01;04;160;Coisevaux;317;19;336;70160
27;70;02;17;162;Colombe-lès-Vesoul;459;13;472;70162
27;70;02;16;163;Colombier;443;8;451;70163
27;70;02;17;164;Colombotte;89;2;91;70164
27;70;02;05;165;Combeaufontaine;542;42;584;70165
27;70;02;16;166;Comberjon;154;5;159;70166
27;70;02;11;167;Conflandey;353;13;366;70167
27;70;01;13;168;Conflans-sur-Lanterne;620;17;637;70168
27;70;02;05;169;Confracourt;220;5;225;70169
27;70;02;11;170;Contréglise;122;2;124;70170
27;70;01;13;171;Corbenay;1263;29;1292;70171
27;70;01;10;172;La Corbière;109;0;109;70172
27;70;02;12;174;Cordonnet;143;2;145;70174
27;70;02;05;175;Cornot;136;3;139;70175
27;70;01;10;176;Corravillers;191;3;194;70176
27;70;02;05;177;Corre;603;15;618;70177
27;70;01;07;178;La Côte;526;10;536;70178
27;70;02;16;179;Coulevon;168;3;171;70179
27;70;01;17;180;Courchaton;441;10;451;70180
27;70;02;09;181;Courcuire;132;0;132;70181
27;70;01;04;182;Courmont;142;0;142;70182
27;70;02;01;183;Courtesoult-et-Gatey;60;0;60;70183
27;70;01;04;184;Couthenans;707;21;728;70184
27;70;02;02;185;Cresancey;187;9;196;70185
27;70;01;06;186;La Creuse;73;1;74;70186
27;70;01;17;187;Crevans-et-la-Chapelle-lès-Granges;263;3;266;70187
27;70;01;06;188;Creveney;54;1;55;70188
27;70;02;12;189;Cromary;250;4;254;70189
27;70;02;11;190;Cubry-lès-Faverney;181;3;184;70190
27;70;02;09;192;Cugney;206;2;208;70192
27;70;02;09;193;Cult;232;3;235;70193
27;70;01;11;194;Cuve;134;8;142;70194
27;70;01;06;195;Dambenoît-lès-Colombe;272;4;276;70195
27;70;01;11;196;Dampierre-lès-Conflans;250;9;259;70196
27;70;02;12;197;Dampierre-sur-Linotte;794;15;809;70197
27;70;02;01;198;Dampierre-sur-Salon;1240;25;1265;70198
27;70;02;17;199;Dampvalley-lès-Colombe;116;0;116;70199
27;70;01;11;200;Dampvalley-Saint-Pancras;39;1;40;70200
27;70;02;01;201;Delain;209;1;210;70201
27;70;01;05;202;Demangevelle;273;7;280;70202
27;70;02;17;203;La Demie;149;2;151;70203
27;70;02;01;204;Denèvre;156;4;160;70204
27;70;01;03;205;Echavanne;202;2;204;70205
27;70;01;03;206;Echenans-sous-Mont-Vaudois;555;7;562;70206
27;70;02;15;207;Echenoz-la-Méline;3249;69;3318;70207
27;70;02;12;208;Echenoz-le-Sec;292;5;297;70208
27;70;01;10;210;Ecromagny;154;5;159;70210
27;70;02;01;211;Ecuelle;65;2;67;70211
27;70;01;13;213;Ehuns;225;5;230;70213
27;70;02;11;214;Equevilley;122;5;127;70214
27;70;01;03;215;Errevet;244;11;255;70215
27;70;01;08;216;Esboz-Brest;439;24;463;70216
27;70;01;10;217;Esmoulières;97;1;98;70217
27;70;02;02;218;Esmoulins;134;1;135;70218
27;70;01;17;219;Esprels;735;15;750;70219
27;70;02;02;220;Essertenne-et-Cecey;407;6;413;70220
27;70;01;04;221;Etobon;288;4;292;70221
27;70;02;14;222;Etrelles-et-la-Montbleuse;78;1;79;70222
27;70;02;09;224;Etuz;674;14;688;70224
27;70;02;01;225;Fahy-lès-Autrey;104;2;106;70225
27;70;01;17;226;Fallon;309;3;312;70226
27;70;01;10;227;Faucogney-et-la-Mer;477;15;492;70227
27;70;02;11;228;Faverney;980;11;991;70228
27;70;01;07;229;Faymont;260;6;266;70229
27;70;02;01;230;Fédry;98;4;102;70230
27;70;02;01;231;Ferrières-lès-Ray;35;0;35;70231
27;70;02;14;232;Ferrières-lès-Scey;130;5;135;70232
27;70;01;10;233;Les Fessey;135;2;137;70233
27;70;02;12;234;Filain;226;11;237;70234
27;70;02;11;235;Flagy;145;4;149;70235
27;70;02;11;236;Fleurey-lès-Faverney;467;9;476;70236
27;70;02;01;237;Fleurey-lès-Lavoncourt;97;0;97;70237
27;70;01;13;238;Fleurey-lès-Saint-Loup;137;4;141;70238
27;70;02;12;239;Fondremand;201;5;206;70239
27;70;01;13;240;Fontaine-lès-Luxeuil;1327;24;1351;70240
27;70;01;11;242;Fontenois-la-Ville;133;0;133;70242
27;70;02;12;243;Fontenois-lès-Montbozon;337;12;349;70243
27;70;02;05;244;Fouchécourt;111;0;111;70244
27;70;01;88;245;Fougerolles-Saint-Valbert;3797;123;3920;70245
27;70;02;01;247;Fouvent-Saint-Andoche;212;3;215;70247
27;70;01;03;248;Frahier-et-Chatebier;1379;35;1414;70248
27;70;01;13;249;Francalmont;119;3;122;70249
27;70;01;06;250;Franchevelle;451;6;457;70250
27;70;02;01;251;Francourt;100;4;104;70251
27;70;02;01;252;Framont;178;3;181;70252
27;70;02;14;253;Frasne-le-Château;297;28;325;70253
27;70;01;03;254;Frédéric-Fontaine;253;7;260;70254
27;70;02;14;255;Fresne-Saint-Mamès;497;4;501;70255
27;70;01;10;256;Fresse;710;12;722;70256
27;70;02;14;257;Fretigney-et-Velloreille;742;14;756;70257
27;70;01;08;258;Froideconche;1990;46;2036;70258
27;70;01;06;259;Froideterre;370;6;376;70259
27;70;01;07;260;Frotey-lès-Lure;686;20;706;70260
27;70;02;16;261;Frotey-lès-Vesoul;1361;33;1394;70261
27;70;01;07;262;Genevreuille;161;4;165;70262
27;70;01;06;263;Genevrey;238;2;240;70263
27;70;01;17;264;Georfans;50;0;50;70264
27;70;02;02;265;Germigney;151;5;156;70265
27;70;02;05;267;Gevigney-et-Mercey;485;7;492;70267
27;70;02;09;268;Gézier-et-Fontenelay;213;4;217;70268
27;70;01;11;269;Girefontaine;35;1;36;70269
27;70;01;17;271;Gouhenans;374;11;385;70271
27;70;02;05;272;Gourgeon;186;11;197;70272
27;70;01;17;273;Grammont;67;1;68;70273
27;70;02;01;274;Grandecourt;48;0;48;70274
27;70;02;14;275;Grandvelle-et-le-Perrenot;393;5;398;70275
27;70;01;17;276;Granges-la-Ville;184;8;192;70276
27;70;01;17;277;Granges-le-Bourg;381;9;390;70277
27;70;02;11;278;Grattery;215;4;219;70278
27;70;02;02;279;Gray;5553;424;5977;70279
27;70;02;02;280;Gray-la-Ville;937;36;973;70280
27;70;02;09;282;Gy;1012;20;1032;70282
27;70;01;10;283;Haut-du-Them-Château-Lambert;442;7;449;70283
27;70;01;13;284;Hautevelle;268;8;276;70284
27;70;01;97;285;Héricourt;10646;272;10918;70285
27;70;02;09;286;Hugier;128;3;131;70286
27;70;01;05;287;Hurecourt;44;0;44;70287
27;70;02;12;288;Hyet;120;1;121;70288
27;70;02;02;289;Igny;210;2;212;70289
27;70;01;11;290;Jasney;203;6;209;70290
27;70;02;05;291;Jonvelle;124;3;127;70291
27;70;02;05;292;Jussey;1548;34;1582;70292
27;70;02;05;293;Lambrey;77;2;79;70293
27;70;01;10;294;Lantenot;357;4;361;70294
27;70;01;10;295;La Lanterne-et-les-Armonts;220;5;225;70295
27;70;02;12;296;Larians-et-Munans;271;2;273;70296
27;70;02;01;297;Larret;60;0;60;70297
27;70;02;05;298;Lavigney;117;0;117;70298
27;70;02;01;299;Lavoncourt;311;2;313;70299
27;70;02;14;301;Lieffrans;56;0;56;70301
27;70;02;09;302;Lieucourt;77;1;78;70302
27;70;02;17;303;Liévans;153;1;154;70303
27;70;01;06;304;Linexert;122;1;123;70304
27;70;02;01;305;LÅ“uilley;103;2;105;70305
27;70;01;07;306;Lomont;460;13;473;70306
27;70;01;17;307;Longevelle;124;7;131;70307
27;70;01;10;308;La Longine;222;6;228;70308
27;70;02;12;309;Loulans-Verchamp;453;10;463;70309
27;70;01;98;310;Lure;8046;185;8231;70310
27;70;01;08;311;Luxeuil-les-Bains;6623;273;6896;70311
27;70;01;03;312;Luze;759;21;780;70312
27;70;01;07;313;Lyoffans;395;5;400;70313
27;70;01;10;314;Magnivray;168;6;174;70314
27;70;01;13;315;Magnoncourt;408;11;419;70315
27;70;02;12;316;Le Magnoray;83;4;87;70316
27;70;01;17;317;Les Magny;141;4;145;70317
27;70;01;07;318;Magny-Danigon;431;15;446;70318
27;70;01;07;319;Magny-Jobert;124;3;127;70319
27;70;02;05;320;Magny-lès-Jussey;98;3;101;70320
27;70;01;07;321;Magny-Vernois;1400;29;1429;70321
27;70;01;13;322;Mailleroncourt-Charette;284;6;290;70322
27;70;01;11;323;Mailleroncourt-Saint-Pancras;197;1;198;70323
27;70;02;14;324;Mailley-et-Chazelot;645;15;660;70324
27;70;02;12;325;Maizières;372;3;375;70325
27;70;02;12;326;La Malachère;309;3;312;70326
27;70;02;09;327;Malans;134;3;137;70327
27;70;01;06;328;Malbouhans;327;6;333;70328
27;70;02;05;329;Malvillers;61;4;65;70329
27;70;01;03;330;Mandrevillars;287;7;294;70330
27;70;02;02;331;Mantoche;440;20;460;70331
27;70;01;17;332;Marast;56;1;57;70332
27;70;02;09;334;Marnay;1508;24;1532;70334
27;70;02;12;335;Maussans;62;2;64;70335
27;70;01;17;336;Mélecey;137;3;140;70336
27;70;02;05;337;Melin;59;1;60;70337
27;70;01;11;338;Melincourt;228;7;235;70338
27;70;01;10;339;Mélisey;1674;31;1705;70339
27;70;02;01;340;Membrey;214;27;241;70340
27;70;02;11;341;Menoux;300;3;303;70341
27;70;02;14;342;Mercey-sur-Saône;136;1;137;70342
27;70;02;11;343;Mersuay;285;5;290;70343
27;70;01;13;344;Meurcourt;339;9;348;70344
27;70;01;17;347;Mignavillers;356;8;364;70347
27;70;01;07;348;Moffans-et-Vacheresse;620;12;632;70348
27;70;01;17;349;Moimay;235;3;238;70349
27;70;02;05;350;Molay;65;0;65;70350
27;70;01;07;351;Mollans;228;3;231;70351
27;70;01;10;352;La Montagne;37;0;37;70352
27;70;02;09;353;Montagney;503;8;511;70353
27;70;02;12;355;Montarlot-lès-Rioz;302;4;306;70355
27;70;02;09;356;Montboillon;278;6;284;70356
27;70;02;12;357;Montbozon;543;87;630;70357
27;70;02;16;358;Montcey;272;4;276;70358
27;70;02;05;359;Montcourt;55;0;55;70359
27;70;01;05;360;Montdoré;78;1;79;70360
27;70;01;10;361;Montessaux;158;5;163;70361
27;70;02;05;362;Montigny-lès-Cherlieu;138;4;142;70362
27;70;02;15;363;Montigny-lès-Vesoul;645;15;660;70363
27;70;02;17;364;Montjustin-et-Velotte;119;1;120;70364
27;70;02;09;366;Villers-Chemin-et-Mont-lès-Etrelles;123;0;123;70366
27;70;02;15;367;Mont-le-Vernois;184;4;188;70367
27;70;02;01;368;Montot;132;3;135;70368
27;70;02;01;369;Mont-Saint-Léger;48;0;48;70369
27;70;02;01;371;Montureux-et-Prantigny;203;1;204;70371
27;70;02;11;372;Montureux-lès-Baulay;152;4;156;70372
27;70;02;05;373;La Roche-Morey;285;4;289;70373
27;70;02;09;374;Motey-Besuche;95;2;97;70374
27;70;02;02;376;Nantilly;463;10;473;70376
27;70;02;16;378;Navenne;1623;50;1673;70378
27;70;02;13;380;Neurey-en-Vaux;176;4;180;70380
27;70;02;17;381;Neurey-lès-la-Demie;341;10;351;70381
27;70;02;12;383;Neuvelle-lès-Cromary;417;4;421;70383
27;70;02;14;384;Neuvelle-lès-la-Charité;224;3;227;70384
27;70;01;06;385;La Neuvelle-lès-Lure;333;10;343;70385
27;70;02;05;386;La Neuvelle-lès-Scey;177;2;179;70386
27;70;02;14;387;Noidans-le-Ferroux;662;10;672;70387
27;70;02;15;388;Noidans-lès-Vesoul;1978;75;2053;70388
27;70;02;02;389;Noiron;58;2;60;70389
27;70;02;17;390;Noroy-le-Bourg;502;11;513;70390
27;70;02;05;392;Oigney;34;2;36;70392
27;70;02;14;393;Oiselay-et-Grachaux;430;6;436;70393
27;70;02;02;394;Onay;60;4;64;70394
27;70;01;17;395;Oppenans;52;0;52;70395
27;70;01;17;396;Oricourt;39;2;41;70396
27;70;02;12;397;Ormenans;81;0;81;70397
27;70;01;08;398;Ormoiche;66;0;66;70398
27;70;02;05;399;Ormoy;208;7;215;70399
27;70;02;05;400;Ouge;108;2;110;70400
27;70;02;14;401;Ovanches;132;1;133;70401
27;70;02;01;402;Oyrières;371;11;382;70402
27;70;01;07;403;Palante;243;3;246;70403
27;70;01;05;404;Passavant-la-Rochère;576;16;592;70404
27;70;02;12;405;Pennesières;194;4;198;70405
27;70;02;01;406;Percey-le-Grand;76;1;77;70406
27;70;02;12;407;Perrouse;272;5;277;70407
27;70;02;09;408;Pesmes;1068;29;1097;70408
27;70;02;01;409;Pierrecourt;115;2;117;70409
27;70;02;09;410;Pin;699;3;702;70410
27;70;01;11;411;La Pisseure;38;0;38;70411
27;70;01;11;412;Plainemont;71;0;71;70412
27;70;01;03;413;Plancher-Bas;1903;36;1939;70413
27;70;01;03;414;Plancher-les-Mines;960;15;975;70414
27;70;02;11;415;Polaincourt-et-Clairefontaine;658;9;667;70415
27;70;01;07;416;Pomoy;204;5;209;70416
27;70;02;14;417;Pontcey;306;3;309;70417
27;70;02;14;418;La Romaine;518;4;522;70418
27;70;01;05;419;Pont-du-Bois;107;4;111;70419
27;70;01;17;420;Pont-sur-l'Ognon;63;0;63;70420
27;70;02;11;421;Port-sur-Saône;2954;55;3009;70421
27;70;02;01;422;Poyans;145;1;146;70422
27;70;02;05;423;Preigney;113;3;116;70423
27;70;01;10;425;La Proiselière-et-Langle;148;6;154;70425
27;70;02;11;426;Provenchère;251;7;258;70426
27;70;02;05;427;Purgerot;335;9;344;70427
27;70;02;15;428;Pusey;1455;49;1504;70428
27;70;02;15;429;Pusy-et-Epenoux;547;14;561;70429
27;70;02;05;430;La Quarte;69;1;70;70430
27;70;02;12;431;Quenoche;249;3;252;70431
27;70;01;06;432;Quers;326;7;333;70432
27;70;02;16;433;Quincey;1396;38;1434;70433
27;70;01;10;435;Raddon-et-Chapendu;829;22;851;70435
27;70;02;05;436;Raincourt;116;0;116;70436
27;70;02;05;437;Ranzevelle;16;0;16;70437
27;70;02;01;438;Ray-sur-Saône;212;3;215;70438
27;70;02;14;439;Raze;355;7;362;70439
27;70;02;01;440;Recologne;33;2;35;70440
27;70;02;12;441;Recologne-lès-Rioz;253;3;256;70441
27;70;02;01;442;Renaucourt;109;3;112;70442
27;70;02;09;443;La Grande-Résie;89;1;90;70443
27;70;02;09;444;La Résie-Saint-Martin;163;1;164;70444
27;70;01;10;445;Rignovelle;115;1;116;70445
27;70;02;01;446;Rigny;604;9;613;70446
27;70;02;12;447;Rioz;2297;75;2372;70447
27;70;02;01;448;Roche-et-Raucourt;152;2;154;70448
27;70;02;12;449;Roche-sur-Linotte-et-Sorans-les-Cordiers;62;0;62;70449
27;70;02;05;450;La Rochelle;40;0;40;70450
27;70;01;06;451;Ronchamp;2735;28;2763;70451
27;70;02;14;452;Rosey;254;3;257;70452
27;70;01;10;453;La Rosière;81;3;84;70453
27;70;02;05;454;Rosières-sur-Mance;48;2;50;70454
27;70;01;07;455;Roye;1493;24;1517;70455
27;70;02;12;456;Ruhans;148;5;153;70456
27;70;02;14;457;Rupt-sur-Saône;107;3;110;70457
27;70;01;10;459;Saint-Barthélemy;1101;25;1126;70459
27;70;01;10;460;Saint-Bresson;430;9;439;70460
27;70;02;02;461;Saint-Broing;116;2;118;70461
27;70;01;17;462;Saint-Ferjeux;80;2;82;70462
27;70;02;14;463;Saint-Gand;144;1;145;70463
27;70;01;06;464;Saint-Germain;1353;23;1376;70464
27;70;02;02;466;Saint-Loup-Nantouard;124;3;127;70466
27;70;01;13;467;Saint-Loup-sur-Semouse;3150;66;3216;70467
27;70;02;05;468;Saint-Marcel;90;1;91;70468
27;70;01;10;469;Sainte-Marie-en-Chanois;211;4;215;70469
27;70;01;13;470;Sainte-Marie-en-Chaux;160;2;162;70470
27;70;02;14;471;Sainte-Reine;25;1;26;70471
27;70;02;11;472;Saint-Rémy-en-Comté;485;4;489;70472
27;70;01;08;473;Saint-Sauveur;1929;32;1961;70473
27;70;01;17;474;Saint-Sulpice;127;2;129;70474
27;70;02;11;476;Saponcourt;65;1;66;70476
27;70;01;04;477;Saulnot;773;13;786;70477
27;70;01;06;478;Saulx;888;15;903;70478
27;70;02;02;479;Sauvigney-lès-Gray;98;4;102;70479
27;70;02;09;480;Sauvigney-lès-Pesmes;134;6;140;70480
27;70;02;01;481;Savoyeux;205;4;209;70481
27;70;02;14;482;Scey-sur-Saône-et-Saint-Albin;1543;25;1568;70482
27;70;02;11;483;Scye;137;5;142;70483
27;70;01;17;484;Secenans;178;3;181;70484
27;70;01;05;485;Selles;202;5;207;70485
27;70;02;05;486;Semmadon;111;3;114;70486
27;70;01;17;487;Senargent-Mignafans;291;3;294;70487
27;70;02;11;488;Senoncourt;194;1;195;70488
27;70;01;10;489;Servance-Miellin;788;6;794;70489
27;70;01;06;490;Servigney;123;1;124;70490
27;70;02;14;491;Seveux-Motey;480;14;494;70491
27;70;02;14;492;Soing-Cubry-Charentenay;579;10;589;70492
27;70;02;12;493;Sorans-lès-Breurey;462;8;470;70493
27;70;02;09;494;Sornay;347;6;353;70494
27;70;02;05;496;Tartécourt;25;1;26;70496
27;70;01;10;498;Ternuay-Melay-et-Saint-Hilaire;460;14;474;70498
27;70;02;01;499;Theuley;103;2;105;70499
27;70;02;12;500;Thieffrans;167;11;178;70500
27;70;02;12;501;Thiénans;98;3;101;70501
27;70;02;01;502;Tincey-et-Pontrebeau;85;0;85;70502
27;70;02;12;503;Traitiéfontaine;162;2;164;70503
27;70;02;14;504;Traves;360;13;373;70504
27;70;02;02;505;Le Tremblois;162;7;169;70505
27;70;01;04;506;Trémoins;388;13;401;70506
27;70;02;12;507;Trésilley;246;6;252;70507
27;70;02;09;509;Tromarey;113;0;113;70509
27;70;02;09;510;Vadans;130;3;133;70510
27;70;02;01;511;Vaite;226;3;229;70511
27;70;01;13;512;La Vaivre;219;5;224;70512
27;70;02;15;513;Vaivre-et-Montoille;2418;55;2473;70513
27;70;02;09;514;Valay;670;11;681;70514
27;70;01;07;515;Le Val-de-Gouhenans;67;1;68;70515
27;70;02;17;516;Vallerois-le-Bois;245;3;248;70516
27;70;02;17;517;Vallerois-Lorioz;395;18;413;70517
27;70;02;11;518;Le Val-Saint-Eloi;98;2;100;70518
27;70;02;12;519;Vandelans;110;0;110;70519
27;70;02;01;520;Vanne;115;3;118;70520
27;70;02;09;521;Vantoux-et-Longevelle;183;4;187;70521
27;70;02;16;522;Varogne;158;3;161;70522
27;70;02;01;523;Vars;197;3;200;70523
27;70;02;11;524;Vauchoux;113;3;116;70524
27;70;02;01;525;Vauconcourt-Nervezain;211;3;214;70525
27;70;01;05;526;Vauvillers;625;14;639;70526
27;70;02;14;527;Vaux-le-Moncelot;75;1;76;70527
27;70;02;02;528;Velesmes-Echevanne;486;9;495;70528
27;70;02;02;529;Velet;385;16;401;70529
27;70;01;17;530;Vellechevreux-et-Courbenans;120;0;120;70530
27;70;02;09;531;Velleclaire;104;1;105;70531
27;70;02;12;532;Vellefaux;519;6;525;70532
27;70;02;09;533;Vellefrey-et-Vellefrange;121;0;121;70533
27;70;02;16;534;Vellefrie;125;1;126;70534
27;70;02;14;535;Velleguindry-et-Levrecey;153;1;154;70535
27;70;02;14;536;Velle-le-Châtel;132;2;134;70536
27;70;01;06;537;Velleminfroy;294;6;300;70537
27;70;02;14;538;Vellemoz;82;0;82;70538
27;70;02;14;539;Vellexon-Queutrey-et-Vaudey;455;12;467;70539
27;70;02;09;540;Velloreille-lès-Choye;80;4;84;70540
27;70;01;13;541;Velorcey;204;4;208;70541
27;70;02;09;542;Venère;209;5;214;70542
27;70;01;17;544;La Vergenne;115;2;117;70544
27;70;02;11;545;Venisey;127;3;130;70545
27;70;02;01;546;Vereux;219;22;241;70546
27;70;01;04;547;Verlans;168;3;171;70547
27;70;02;05;548;Vernois-sur-Mance;141;1;142;70548
27;70;02;14;549;La Vernotte;78;1;79;70549
27;70;02;99;550;Vesoul;14914;749;15663;70550
27;70;01;17;552;Villafans;215;3;218;70552
27;70;01;17;553;Villargent;116;2;118;70553
27;70;02;05;554;Villars-le-Pautel;191;1;192;70554
27;70;01;13;555;La Villedieu-en-Fontenette;171;1;172;70555
27;70;02;09;557;Villefrancon;133;4;137;70557
27;70;02;16;558;La Villeneuve-Bellenoye-et-la-Maize;140;2;142;70558
27;70;02;16;559;Villeparois;195;4;199;70559
27;70;02;12;560;Villers-Bouton;165;2;167;70560
27;70;01;17;561;Villersexel;1423;108;1531;70561
27;70;01;17;562;Villers-la-Ville;154;3;157;70562
27;70;02;17;563;Villers-le-Sec;533;13;546;70563
27;70;01;13;564;Villers-lès-Luxeuil;310;16;326;70564
27;70;02;12;565;Villers-Pater;52;2;54;70565
27;70;02;11;566;Villers-sur-Port;200;5;205;70566
27;70;01;04;567;Villers-sur-Saulnot;134;9;143;70567
27;70;02;01;568;Villers-Vaudey;57;4;61;70568
27;70;02;16;569;Vilory;61;1;62;70569
27;70;01;13;571;Visoncourt;39;3;42;70571
27;70;02;05;572;Vitrey-sur-Mance;290;5;295;70572
27;70;01;10;573;La Voivre;125;1;126;70573
27;70;02;01;574;Volon;57;0;57;70574
27;70;02;12;575;Voray-sur-l'Ognon;841;16;857;70575
27;70;02;05;576;Vougécourt;151;1;152;70576
27;70;01;07;577;Vouhenans;379;9;388;70577
27;70;02;09;578;Vregille;174;2;176;70578
27;70;01;04;579;Vyans-le-Val;428;16;444;70579
27;70;02;14;580;Vy-le-Ferroux;152;5;157;70580
27;70;01;07;581;Vy-lès-Lure;704;16;720;70581
27;70;02;14;582;Vy-lès-Rupt;81;0;81;70582
27;70;02;12;583;Vy-lès-Filain;130;1;131;70583
27;71;04;14;001;L'Abergement-de-Cuisery;799;15;814;71001
27;71;04;24;002;L'Abergement-Sainte-Colombe;1243;20;1263;71002
27;71;02;16;003;Allerey-sur-Saône;795;6;801;71003
27;71;02;24;004;Allériot;1164;25;1189;71004
27;71;02;04;005;Aluze;251;10;261;71005
27;71;03;10;006;Amanzé;185;5;190;71006
27;71;05;11;007;Ameugny;167;4;171;71007
27;71;03;10;008;Anglure-sous-Dun;151;7;158;71008
27;71;01;01;009;Anost;719;14;733;71009
27;71;01;02;010;Antully;864;10;874;71010
27;71;03;25;011;Anzy-le-Duc;444;86;530;71011
27;71;03;25;012;Artaix;331;15;346;71012
27;71;04;26;013;Authumes;272;5;277;71013
27;71;01;96;014;Autun;12987;1022;14009;71014
27;71;01;02;015;Auxy;914;29;943;71015
27;71;05;19;016;Azé;1082;27;1109;71016
27;71;03;09;017;Ballore;95;4;99;71017
27;71;04;14;018;Bantanges;547;11;558;71018
27;71;02;17;019;Barizey;143;7;150;71019
27;71;01;01;020;Barnay;98;2;100;71020
27;71;03;09;021;Baron;291;22;313;71021
27;71;03;10;022;Baudemont;625;9;634;71022
27;71;04;24;023;Baudrières;956;26;982;71023
27;71;03;25;024;Baugy;509;17;526;71024
27;71;03;09;025;Beaubery;358;8;366;71025
27;71;02;29;026;Beaumont-sur-Grosne;337;13;350;71026
27;71;04;26;027;Beaurepaire-en-Bresse;721;7;728;71027
27;71;04;26;028;Beauvernois;106;3;109;71028
27;71;04;26;029;Bellevesvre;292;4;296;71029
27;71;05;11;030;Bergesserin;203;4;207;71030
27;71;05;11;031;Berzé-le-Châtel;59;1;60;71031
27;71;05;19;032;Berzé-la-Ville;690;14;704;71032
27;71;02;16;033;Bey;861;19;880;71033
27;71;02;17;034;Bissey-sous-Cruchaud;335;7;342;71034
27;71;05;19;035;Bissy-la-Mâconnaise;204;3;207;71035
27;71;02;11;036;Bissy-sous-Uxelles;69;0;69;71036
27;71;02;17;037;Bissy-sur-Fley;84;6;90;71037
27;71;01;03;038;Les Bizots;468;13;481;71038
27;71;05;11;039;Blanot;181;1;182;71039
27;71;01;03;040;Blanzy;6060;140;6200;71040
27;71;03;10;041;Bois-Sainte-Marie;190;2;192;71041
27;71;05;11;042;Bonnay;318;7;325;71042
27;71;02;16;043;Les Bordes;83;3;86;71043
27;71;04;26;044;Bosjean;296;6;302;71044
27;71;04;26;045;Bouhans;179;6;185;71045
27;71;01;02;046;La Boulaye;94;0;94;71046
27;71;03;15;047;Bourbon-Lancy;4713;72;4785;71047
27;71;03;25;048;Bourg-le-Comte;175;2;177;71048
27;71;05;08;050;Bourgvilain;340;7;347;71050
27;71;02;04;051;Bouzeron;130;7;137;71051
27;71;02;29;052;Boyer;729;11;740;71052
27;71;02;16;054;Bragny-sur-Saône;685;13;698;71054
27;71;04;20;056;Branges;2354;37;2391;71056
27;71;05;11;057;Bray;124;3;127;71057
27;71;02;29;058;Bresse-sur-Grosne;185;11;196;71058
27;71;01;13;059;Le Breuil;3538;67;3605;71059
27;71;03;10;060;Briant;228;2;230;71060
27;71;04;14;061;Brienne;460;16;476;71061
27;71;01;02;062;Brion;292;8;300;71062
27;71;01;02;063;Broye;753;14;767;71063
27;71;04;20;064;Bruailles;985;25;1010;71064
27;71;05;11;065;Buffières;273;8;281;71065
27;71;05;19;066;Burgy;119;3;122;71066
27;71;02;11;067;Burnand;124;3;127;71067
27;71;05;11;068;Burzy;57;2;59;71068
27;71;05;19;069;Bussières;579;27;606;71069
27;71;02;17;070;Buxy;2138;85;2223;71070
27;71;03;25;071;Céron;263;8;271;71071
27;71;02;17;072;Cersot;141;2;143;71072
27;71;02;04;073;Chagny;5528;80;5608;71073
27;71;05;08;074;Chaintré;564;19;583;71074
27;71;03;15;075;Chalmoux;627;11;638;71075
27;71;02;97;076;Chalon-sur-Saône;45056;1521;46577;71076
27;71;03;25;077;Chambilly;513;4;517;71077
27;71;02;04;078;Chamilly;151;3;154;71078
27;71;04;14;079;Champagnat;463;11;474;71079
27;71;02;29;080;Champagny-sous-Uxelles;97;0;97;71080
27;71;02;05;081;Champforgeuil;2588;56;2644;71081
27;71;03;09;082;Champlecy;223;3;226;71082
27;71;05;08;084;Chânes;529;11;540;71084
27;71;02;04;085;Change;222;2;224;71085
27;71;03;09;086;Changy;466;9;475;71086
27;71;02;11;087;Chapaize;165;1;166;71087
27;71;03;18;088;La Chapelle-au-Mans;226;12;238;71088
27;71;02;29;089;La Chapelle-de-Bragny;238;2;240;71089
27;71;05;08;090;La Chapelle-de-Guinchay;4171;53;4224;71090
27;71;05;08;091;La Chapelle-du-Mont-de-France;189;2;191;71091
27;71;04;20;092;La Chapelle-Naude;504;13;517;71092
27;71;04;26;093;La Chapelle-Saint-Sauveur;662;18;680;71093
27;71;05;29;094;La Chapelle-sous-Brancion;139;2;141;71094
27;71;03;10;095;La Chapelle-sous-Dun;437;10;447;71095
27;71;01;02;096;La Chapelle-sous-Uchon;192;2;194;71096
27;71;04;14;097;La Chapelle-Thècle;480;12;492;71097
27;71;01;02;098;Charbonnat;250;4;254;71098
27;71;05;19;099;Charbonnières;316;14;330;71099
27;71;05;29;100;Chardonnay;203;0;203;71100
27;71;04;26;101;Charette-Varennes;452;8;460;71101
27;71;02;27;102;La Charmée;688;24;712;71102
27;71;01;02;103;Charmoy;274;6;280;71103
27;71;02;16;104;Charnay-lès-Chalon;190;7;197;71104
27;71;05;21;105;Charnay-lès-Mâcon;7742;297;8039;71105
27;71;03;09;106;Charolles;2888;438;3326;71106
27;71;02;04;107;Charrecey;331;10;341;71107
27;71;05;08;108;Chasselas;168;5;173;71108
27;71;02;04;109;Chassey-le-Camp;352;2;354;71109
27;71;03;10;110;Chassigny-sous-Dun;565;10;575;71110
27;71;03;18;111;Chassy;305;11;316;71111
27;71;05;11;112;Château;228;8;236;71112
27;71;03;10;113;Châteauneuf;98;0;98;71113
27;71;02;17;115;Châtel-Moron;92;4;96;71115
27;71;03;10;116;Châtenay;169;2;171;71116
27;71;02;24;117;Châtenoy-en-Bresse;1095;31;1126;71117
27;71;02;07;118;Châtenoy-le-Royal;6148;143;6291;71118
27;71;02;04;119;Chaudenay;1119;24;1143;71119
27;71;03;10;120;Chauffailles;3703;69;3772;71120
27;71;04;26;121;La Chaux;316;3;319;71121
27;71;02;04;122;Cheilly-lès-Maranges;557;15;572;71122
27;71;03;25;123;Chenay-le-Châtel;373;4;377;71123
27;71;02;17;124;Chenôves;203;7;210;71124
27;71;05;11;125;Chérizet;20;0;20;71125
27;71;05;19;126;Chevagny-les-Chevrières;584;23;607;71126
27;71;05;11;127;Chevagny-sur-Guye;60;5;65;71127
27;71;05;11;128;Chiddes;88;5;93;71128
27;71;01;01;129;Chissey-en-Morvan;271;7;278;71129
27;71;05;11;130;Chissey-lès-Mâcon;229;6;235;71130
27;71;02;16;131;Ciel;851;13;864;71131
27;71;01;28;132;Ciry-le-Noble;2260;30;2290;71132
27;71;03;10;133;La Clayette;1637;58;1695;71133
27;71;05;08;134;Navour-sur-Grosne;661;21;682;71134
27;71;05;19;135;Clessé;891;20;911;71135
27;71;03;18;136;Clessy;276;8;284;71136
27;71;05;11;137;Cluny;4929;247;5176;71137
27;71;02;03;139;Collonge-en-Charollais;144;0;144;71139
27;71;01;01;140;Collonge-la-Madeleine;50;0;50;71140
27;71;03;09;141;Colombier-en-Brionnais;310;6;316;71141
27;71;01;02;142;La Comelle;240;4;244;71142
27;71;04;14;143;Condal;459;8;467;71143
27;71;01;01;144;Cordesse;191;5;196;71144
27;71;02;11;145;Cormatin;564;5;569;71145
27;71;05;11;146;Cortambert;232;7;239;71146
27;71;05;11;147;Cortevaix;251;6;257;71147
27;71;03;10;148;Coublanc;843;17;860;71148
27;71;01;04;149;Couches;1323;29;1352;71149
27;71;05;08;150;Crêches-sur-Saône;3089;86;3175;71150
27;71;01;01;151;Créot;78;4;82;71151
27;71;03;18;152;Cressy-sur-Somme;180;9;189;71152
27;71;01;98;153;Le Creusot;21269;298;21567;71153
27;71;02;05;154;Crissey;2469;62;2531;71154
27;71;03;15;155;Cronat;519;16;535;71155
27;71;05;19;156;Cruzille;262;65;327;71156
27;71;04;14;157;Cuiseaux;1829;31;1860;71157
27;71;04;14;158;Cuisery;1571;40;1611;71158
27;71;02;17;159;Culles-les-Roches;202;8;210;71159
27;71;03;10;160;Curbigny;310;9;319;71160
27;71;03;18;161;Curdin;319;6;325;71161
27;71;01;01;162;Curgy;1153;44;1197;71162
27;71;05;11;163;Curtil-sous-Buffières;90;1;91;71163
27;71;02;11;164;Curtil-sous-Burnand;129;3;132;71164
27;71;01;01;165;Cussy-en-Morvan;378;8;386;71165
27;71;03;18;166;Cuzy;112;4;116;71166
27;71;02;16;167;Damerey;552;20;572;71167
27;71;04;26;168;Dampierre-en-Bresse;174;1;175;71168
27;71;05;08;169;Davayé;700;107;807;71169
27;71;02;16;170;Demigny;1794;40;1834;71170
27;71;02;04;171;Dennevy;305;9;314;71171
27;71;01;02;172;Dettey;85;1;86;71172
27;71;04;26;173;Devrouze;311;4;315;71173
27;71;02;04;174;Dezize-lès-Maranges;173;4;177;71174
27;71;04;26;175;Diconne;338;4;342;71175
27;71;03;15;176;Digoin;7741;249;7990;71176
27;71;04;14;177;Dommartin-lès-Cuiseaux;802;12;814;71177
27;71;05;08;178;Dompierre-les-Ormes;889;31;920;71178
27;71;03;18;179;Dompierre-sous-Sanvignes;81;1;82;71179
27;71;05;11;181;Donzy-le-Pertuis;168;4;172;71181
27;71;02;17;182;Dracy-le-Fort;1458;52;1510;71182
27;71;01;04;183;Dracy-lès-Couches;153;3;156;71183
27;71;01;01;184;Dracy-Saint-Loup;608;9;617;71184
27;71;03;09;185;Dyo;332;14;346;71185
27;71;02;16;186;Ecuelles;262;5;267;71186
27;71;01;03;187;Ecuisses;1580;34;1614;71187
27;71;01;01;188;Epertully;60;1;61;71188
27;71;02;27;189;Epervans;1616;52;1668;71189
27;71;01;01;190;Epinac;2164;30;2194;71190
27;71;01;04;191;Essertenne;472;10;482;71191
27;71;01;02;192;Etang-sur-Arroux;1811;148;1959;71192
27;71;02;29;193;Etrigny;473;11;484;71193
27;71;02;05;194;Farges-lès-Chalon;790;15;805;71194
27;71;05;29;195;Farges-lès-Mâcon;220;1;221;71195
27;71;04;20;196;Le Fay;634;8;642;71196
27;71;04;14;198;Flacey-en-Bresse;412;7;419;71198
27;71;05;11;199;Flagy;174;8;182;71199
27;71;03;10;200;Fleury-la-Montagne;704;17;721;71200
27;71;02;17;201;Fley;196;7;203;71201
27;71;02;04;202;Fontaines;1877;364;2241;71202
27;71;03;09;203;Fontenay;52;1;53;71203
27;71;02;05;204;Fragnes-La Loyère;1487;43;1530;71204
27;71;04;26;205;Frangy-en-Bresse;651;9;660;71205
27;71;04;14;206;La Frette;239;4;243;71206
27;71;04;26;207;Fretterans;288;11;299;71207
27;71;04;26;208;Frontenard;210;4;214;71208
27;71;04;14;209;Frontenaud;728;14;742;71209
27;71;05;08;210;Fuissé;373;19;392;71210
27;71;01;28;212;Génelard;1387;33;1420;71212
27;71;04;14;213;La Genête;569;17;586;71213
27;71;02;03;214;Genouilly;420;11;431;71214
27;71;02;16;215;Gergy;2581;72;2653;71215
27;71;02;17;216;Germagny;197;5;202;71216
27;71;05;08;217;Germolles-sur-Grosne;125;5;130;71217
27;71;03;10;218;Gibles;581;21;602;71218
27;71;02;29;219;Gigny-sur-Saône;547;15;562;71219
27;71;03;15;220;Gilly-sur-Loire;473;3;476;71220
27;71;02;17;221;Givry;3684;161;3845;71221
27;71;01;03;222;Gourdon;899;26;925;71222
27;71;01;02;223;La Grande-Verrière;563;8;571;71223
27;71;03;09;224;Grandvaux;82;6;88;71224
27;71;02;17;225;Granges;525;13;538;71225
27;71;05;29;226;Grevilly;30;0;30;71226
27;71;03;18;227;Grury;513;8;521;71227
27;71;02;24;228;Guerfand;210;0;210;71228
27;71;03;15;229;Les Guerreaux;231;1;232;71229
27;71;03;18;230;Gueugnon;6760;194;6954;71230
27;71;05;11;231;La Guiche;630;11;641;71231
27;71;03;25;232;Hautefond;202;14;216;71232
27;71;03;25;233;L'Hôpital-le-Mercier;304;7;311;71233
27;71;04;14;234;Huilly-sur-Seille;341;6;347;71234
27;71;05;19;235;Hurigny;1954;108;2062;71235
27;71;05;19;236;Igé;879;21;900;71236
27;71;01;01;237;Igornay;524;7;531;71237
27;71;03;10;238;Iguerande;986;18;1004;71238
27;71;03;18;239;Issy-l'Evêque;697;11;708;71239
27;71;05;11;240;Jalogny;384;15;399;71240
27;71;02;17;241;Jambles;486;18;504;71241
27;71;05;03;242;Joncy;521;11;532;71242
27;71;04;14;243;Joudes;371;4;375;71243
27;71;04;14;244;Jouvençon;438;2;440;71244
27;71;02;29;245;Jugy;322;6;328;71245
27;71;04;20;246;Juif;250;3;253;71246
27;71;02;17;247;Jully-lès-Buxy;365;10;375;71247
27;71;05;29;248;Lacrost;710;20;730;71248
27;71;02;29;249;Laives;991;37;1028;71249
27;71;05;19;250;Laizé;1087;49;1136;71250
27;71;01;02;251;Laizy;590;13;603;71251
27;71;02;29;252;Lalheue;370;14;384;71252
27;71;02;24;253;Lans;928;26;954;71253
27;71;04;26;254;Lays-sur-le-Doubs;151;1;152;71254
27;71;03;15;255;Lesme;179;2;181;71255
27;71;04;24;256;Lessard-en-Bresse;539;12;551;71256
27;71;02;16;257;Lessard-le-National;653;12;665;71257
27;71;05;08;258;Leynes;509;15;524;71258
27;71;03;10;259;Ligny-en-Brionnais;363;7;370;71259
27;71;04;14;261;Loisy;662;16;678;71261
27;71;02;16;262;Longepierre;161;4;165;71262
27;71;04;20;263;Louhans;6433;225;6658;71263
27;71;05;11;264;Lournand;328;9;337;71264
27;71;01;01;266;Lucenay-l'Evêque;315;3;318;71266
27;71;05;19;267;Lugny;859;84;943;71267
27;71;03;09;268;Lugny-lès-Charolles;350;10;360;71268
27;71;02;27;269;Lux;2067;33;2100;71269
27;71;05;99;270;Mâcon;33908;755;34663;71270
27;71;03;10;271;Mailly;149;5;154;71271
27;71;02;11;272;Malay;199;9;208;71272
27;71;03;15;273;Maltat;283;6;289;71273
27;71;02;29;274;Mancey;388;10;398;71274
27;71;03;25;275;Marcigny;1727;31;1758;71275
27;71;03;09;276;Marcilly-la-Gueurce;128;5;133;71276
27;71;02;17;277;Marcilly-lès-Buxy;665;19;684;71277
27;71;01;03;278;Marigny;155;5;160;71278
27;71;03;09;279;Le Rousset-Marizy;628;19;647;71279
27;71;03;18;280;Marly-sous-Issy;87;2;89;71280
27;71;03;18;281;Marly-sur-Arroux;307;14;321;71281
27;71;01;02;282;Marmagne;1243;34;1277;71282
27;71;02;27;283;Marnay;537;7;544;71283
27;71;05;29;284;Martailly-lès-Brancion;143;7;150;71284
27;71;03;09;285;Martigny-le-Comte;410;6;416;71285
27;71;01;03;286;Mary;263;4;267;71286
27;71;05;11;287;Massilly;328;6;334;71287
27;71;05;08;289;Matour;1145;22;1167;71289
27;71;05;11;290;Mazille;377;68;445;71290
27;71;03;25;291;Melay;968;23;991;71291
27;71;02;17;292;Mellecey;1322;45;1367;71292
27;71;04;14;293;Ménetreuil;409;10;419;71293
27;71;02;17;294;Mercurey;1212;171;1383;71294
27;71;04;26;295;Mervans;1505;25;1530;71295
27;71;02;17;296;Messey-sur-Grosne;749;19;768;71296
27;71;01;02;297;Mesvres;754;22;776;71297
27;71;05;19;299;Milly-Lamartine;316;7;323;71299
27;71;04;14;300;Le Miroir;621;8;629;71300
27;71;03;15;301;Mont;170;2;172;71301
27;71;02;17;302;Montagny-lès-Buxy;215;9;224;71302
27;71;04;20;303;Montagny-près-Louhans;485;6;491;71303
27;71;05;19;305;Montbellet;828;15;843;71305
27;71;01;23;306;Montceau-les-Mines;17678;308;17986;71306
27;71;03;25;307;Montceaux-l'Etoile;290;7;297;71307
27;71;02;29;308;Montceaux-Ragny;31;1;32;71308
27;71;01;12;309;Montcenis;1924;60;1984;71309
27;71;01;03;310;Montchanin;4964;89;5053;71310
27;71;04;20;311;Montcony;256;5;261;71311
27;71;02;24;312;Montcoy;255;1;256;71312
27;71;01;01;313;Monthelon;381;15;396;71313
27;71;04;26;314;Montjay;206;0;206;71314
27;71;02;16;315;Mont-lès-Seurre;183;2;185;71315
27;71;05;08;316;Montmelard;371;7;378;71316
27;71;03;18;317;Montmort;183;3;186;71317
27;71;04;14;318;Montpont-en-Bresse;1100;20;1120;71318
27;71;04;20;319;Montret;779;16;795;71319
27;71;01;03;320;Mont-Saint-Vincent;315;3;318;71320
27;71;01;04;321;Morey;192;4;196;71321
27;71;01;01;322;Morlet;52;1;53;71322
27;71;03;09;323;Mornay;136;0;136;71323
27;71;02;17;324;Moroges;579;23;602;71324
27;71;03;15;325;La Motte-Saint-Jean;1206;34;1240;71325
27;71;04;26;326;Mouthier-en-Bresse;418;7;425;71326
27;71;03;10;327;Mussy-sous-Dun;343;8;351;71327
27;71;02;29;328;Nanton;631;12;643;71328
27;71;02;16;329;Navilly;410;9;419;71329
27;71;03;18;330;Neuvy-Grandchamp;754;15;769;71330
27;71;03;25;331;Nochize;117;1;118;71331
27;71;04;14;332;Ormes;469;5;474;71332
27;71;02;24;333;Oslon;1222;39;1261;71333
27;71;03;09;334;Oudry;383;9;392;71334
27;71;03;09;335;Ouroux-sous-le-Bois-Sainte-Marie;66;0;66;71335
27;71;04;24;336;Ouroux-sur-Saône;3110;80;3190;71336
27;71;03;10;337;Oyé;303;8;311;71337
27;71;05;29;338;Ozenay;216;2;218;71338
27;71;03;09;339;Ozolles;391;8;399;71339
27;71;03;09;340;Palinges;1507;26;1533;71340
27;71;02;16;341;Palleau;254;2;256;71341
27;71;03;25;342;Paray-le-Monial;9214;417;9631;71342
27;71;02;04;343;Paris-l'Hôpital;318;4;322;71343
27;71;05;11;344;Passy;66;2;68;71344
27;71;05;19;345;Péronne;672;11;683;71345
27;71;01;28;346;Perrecy-les-Forges;1568;26;1594;71346
27;71;01;04;347;Perreuil;553;15;568;71347
27;71;03;15;348;Perrigny-sur-Loire;131;3;134;71348
27;71;01;01;349;La Petite-Verrière;51;1;52;71349
27;71;05;08;350;Pierreclos;874;30;904;71350
27;71;04;26;351;Pierre-de-Bresse;1938;31;1969;71351
27;71;04;26;352;Le Planois;88;3;91;71352
27;71;05;29;353;Plottes;525;7;532;71353
27;71;03;25;354;Poisson;570;22;592;71354
27;71;02;16;355;Pontoux;280;7;287;71355
27;71;01;09;356;Pouilloux;974;17;991;71356
27;71;04;26;357;Pourlans;217;0;217;71357
27;71;05;11;358;Pressy-sous-Dondin;102;3;105;71358
27;71;05;29;359;Préty;568;10;578;71359
27;71;05;19;360;Prissé;1910;46;1956;71360
27;71;03;09;361;Prizy;58;5;63;71361
27;71;05;08;362;Pruzilly;344;5;349;71362
27;71;02;03;363;Le Puley;88;5;93;71363
27;71;04;26;364;La Racineuse;176;1;177;71364
27;71;04;14;365;Rancy;591;8;599;71365
27;71;04;14;366;Ratenelle;380;8;388;71366
27;71;04;20;367;Ratte;366;5;371;71367
27;71;01;01;368;Reclesne;303;16;319;71368
27;71;02;04;369;Remigny;430;7;437;71369
27;71;03;18;370;Rigny-sur-Arroux;626;11;637;71370
27;71;05;19;371;La Roche-Vineuse;1577;41;1618;71371
27;71;05;08;372;Romanèche-Thorins;2021;33;2054;71372
27;71;04;14;373;Romenay;1704;21;1725;71373
27;71;02;17;374;Rosey;162;2;164;71374
27;71;01;01;376;Roussillon-en-Morvan;275;8;283;71376
27;71;05;29;377;Royer;128;2;130;71377
27;71;02;04;378;Rully;1557;35;1592;71378
27;71;04;20;379;Sagy;1233;21;1254;71379
27;71;04;26;380;Saillenard;789;17;806;71380
27;71;05;11;381;Sailly;74;0;74;71381
27;71;03;15;382;Saint-Agnan;697;15;712;71382
27;71;05;19;383;Saint-Albain;534;5;539;71383
27;71;02;29;384;Saint-Ambreuil;506;8;514;71384
27;71;05;08;385;Saint-Amour-Bellevue;566;20;586;71385
27;71;04;20;386;Saint-André-en-Bresse;94;0;94;71386
27;71;05;11;387;Saint-André-le-Désert;249;9;258;71387
27;71;03;09;388;Saint-Aubin-en-Charollais;467;20;487;71388
27;71;03;15;389;Saint-Aubin-sur-Loire;281;5;286;71389
27;71;01;23;390;Saint-Berain-sous-Sanvignes;1084;22;1106;71390
27;71;02;04;391;Saint-Bérain-sur-Dheune;555;17;572;71391
27;71;02;17;392;Saint-Boil;491;9;500;71392
27;71;03;10;393;Saint-Bonnet-de-Cray;491;17;508;71393
27;71;03;09;394;Saint-Bonnet-de-Joux;765;22;787;71394
27;71;03;09;395;Saint-Bonnet-de-Vieille-Vigne;209;2;211;71395
27;71;04;26;396;Saint-Bonnet-en-Bresse;488;4;492;71396
27;71;05;11;397;Sainte-Cécile;283;8;291;71397
27;71;04;24;398;Saint-Christophe-en-Bresse;1044;31;1075;71398
27;71;03;10;399;Saint-Christophe-en-Brionnais;532;15;547;71399
27;71;05;11;400;Saint-Clément-sur-Guye;129;4;133;71400
27;71;04;14;401;Sainte-Croix-en-Bresse;629;13;642;71401
27;71;02;29;402;Saint-Cyr;750;25;775;71402
27;71;02;17;403;Saint-Denis-de-Vaux;260;10;270;71403
27;71;02;17;404;Saint-Désert;896;22;918;71404
27;71;02;16;405;Saint-Didier-en-Bresse;198;1;199;71405
27;71;03;10;406;Saint-Didier-en-Brionnais;126;9;135;71406
27;71;01;02;407;Saint-Didier-sur-Arroux;221;4;225;71407
27;71;03;10;408;Saint-Edmond;428;9;437;71408
27;71;01;02;409;Saint-Emiland;310;9;319;71409
27;71;04;20;410;Saint-Etienne-en-Bresse;794;15;809;71410
27;71;01;02;411;Saint-Eugène;154;8;162;71411
27;71;01;03;412;Saint-Eusèbe;1200;24;1224;71412
27;71;01;13;413;Saint-Firmin;833;10;843;71413
27;71;01;01;414;Saint-Forgeot;443;17;460;71414
27;71;03;10;415;Sainte-Foy;138;2;140;71415
27;71;05;19;416;Saint-Gengoux-de-Scissé;592;6;598;71416
27;71;02;11;417;Saint-Gengoux-le-National;1058;7;1065;71417
27;71;04;26;419;Saint-Germain-du-Bois;1895;42;1937;71419
27;71;04;24;420;Saint-Germain-du-Plain;2310;51;2361;71420
27;71;03;09;421;Saint-Germain-en-Brionnais;185;7;192;71421
27;71;02;17;422;Saint-Germain-lès-Buxy;276;9;285;71422
27;71;02;16;423;Saint-Gervais-en-Vallière;433;5;438;71423
27;71;01;01;424;Saint-Gervais-sur-Couches;211;3;214;71424
27;71;02;04;425;Saint-Gilles;279;11;290;71425
27;71;02;17;426;Sainte-Hélène;540;11;551;71426
27;71;05;11;427;Saint-Huruge;51;1;52;71427
27;71;03;10;428;Saint-Igny-de-Roche;763;26;789;71428
27;71;02;17;430;Saint-Jean-de-Vaux;395;16;411;71430
27;71;01;04;431;Saint-Jean-de-Trézy;377;13;390;71431
27;71;03;09;433;Saint-Julien-de-Civry;491;14;505;71433
27;71;03;10;434;Saint-Julien-de-Jonzy;345;7;352;71434
27;71;01;03;435;Saint-Julien-sur-Dheune;243;9;252;71435
27;71;01;03;436;Saint-Laurent-d'Andenay;1004;20;1024;71436
27;71;03;10;437;Saint-Laurent-en-Brionnais;323;11;334;71437
27;71;01;01;438;Saint-Léger-du-Bois;529;19;548;71438
27;71;03;25;439;Saint-Léger-lès-Paray;748;19;767;71439
27;71;01;02;440;Saint-Léger-sous-Beuvray;374;9;383;71440
27;71;05;08;441;Saint-Léger-sous-la-Bussière;279;4;283;71441
27;71;02;04;442;Saint-Léger-sur-Dheune;1567;22;1589;71442
27;71;02;16;443;Saint-Loup-Géanges;1640;57;1697;71443
27;71;02;27;444;Saint-Loup-de-Varennes;1199;30;1229;71444
27;71;02;27;445;Saint-Marcel;6190;180;6370;71445
27;71;05;11;446;Saint-Marcelin-de-Cray;189;6;195;71446
27;71;02;17;447;Saint-Mard-de-Vaux;273;14;287;71447
27;71;05;19;448;Saint-Martin-Belle-Roche;1389;33;1422;71448
27;71;02;17;449;Saint-Martin-d'Auxy;120;6;126;71449
27;71;01;02;450;Saint-Martin-de-Commune;101;6;107;71450
27;71;03;10;451;Saint-Martin-de-Lixy;94;0;94;71451
27;71;05;11;452;Saint-Martin-de-Salencey;96;1;97;71452
27;71;03;25;453;Saint-Martin-du-Lac;242;11;253;71453
27;71;04;20;454;Saint-Martin-du-Mont;187;8;195;71454
27;71;02;17;455;Saint-Martin-du-Tartre;159;4;163;71455
27;71;02;24;456;Saint-Martin-en-Bresse;1911;68;1979;71456
27;71;02;16;457;Saint-Martin-en-Gâtinois;120;2;122;71457
27;71;05;03;458;Saint-Martin-la-Patrouille;61;0;61;71458
27;71;02;17;459;Saint-Martin-sous-Montaigu;340;17;357;71459
27;71;05;19;460;Saint-Maurice-de-Satonnay;468;23;491;71460
27;71;02;17;461;Saint-Maurice-des-Champs;62;1;63;71461
27;71;02;16;462;Saint-Maurice-en-Rivière;528;11;539;71462
27;71;03;10;463;Saint-Maurice-lès-Châteauneuf;571;12;583;71463
27;71;01;04;464;Saint-Maurice-lès-Couches;184;4;188;71464
27;71;01;03;465;Saint-Micaud;274;9;283;71465
27;71;01;02;466;Saint-Nizier-sur-Arroux;122;4;126;71466
27;71;01;13;468;Saint-Pierre-de-Varennes;848;16;864;71468
27;71;05;08;469;Saint-Pierre-le-Vieux;364;10;374;71469
27;71;05;08;470;Saint-Point;347;14;361;71470
27;71;02;17;471;Saint-Privé;92;1;93;71471
27;71;01;02;472;Saint-Prix;209;8;217;71472
27;71;03;10;473;Saint-Racho;150;1;151;71473
27;71;03;18;474;Sainte-Radegonde;147;2;149;71474
27;71;02;27;475;Saint-Rémy;6615;157;6772;71475
27;71;01;09;477;Saint-Romain-sous-Gourdon;484;9;493;71477
27;71;03;18;478;Saint-Romain-sous-Versigny;85;2;87;71478
27;71;01;13;479;Saint-Sernin-du-Bois;1758;36;1794;71479
27;71;02;04;480;Saint-Sernin-du-Plain;596;13;609;71480
27;71;05;08;481;Saint-Symphorien-d'Ancelles;1150;20;1170;71481
27;71;01;02;482;Saint-Symphorien-de-Marmagne;836;11;847;71482
27;71;03;10;483;Saint-Symphorien-des-Bois;425;12;437;71483
27;71;04;20;484;Saint-Usuge;1282;29;1311;71484
27;71;02;17;485;Saint-Vallerin;258;14;272;71485
27;71;01;28;486;Saint-Vallier;8576;172;8748;71486
27;71;05;08;487;Saint-Vérand;162;3;165;71487
27;71;05;11;488;Saint-Vincent-des-Prés;104;3;107;71488
27;71;04;20;489;Saint-Vincent-en-Bresse;570;9;579;71489
27;71;03;09;490;Saint-Vincent-Bragny;1015;17;1032;71490
27;71;03;25;491;Saint-Yan;1156;24;1180;71491
27;71;05;11;492;Saint-Ythaire;126;2;128;71492
27;71;01;01;493;Saisy;343;7;350;71493
27;71;05;19;494;La Salle;526;14;540;71494
27;71;05;11;495;Salornay-sur-Guye;874;12;886;71495
27;71;02;04;496;Sampigny-lès-Maranges;143;10;153;71496
27;71;05;21;497;Sancé;2150;54;2204;71497
27;71;02;17;498;Santilly;132;6;138;71498
27;71;01;28;499;Sanvignes-les-Mines;4316;81;4397;71499
27;71;03;10;500;Sarry;93;3;96;71500
27;71;02;17;501;Sassangy;142;3;145;71501
27;71;02;16;502;Sassenay;1577;45;1622;71502
27;71;02;17;503;Saules;128;3;131;71503
27;71;02;16;504;Saunières;80;2;82;71504
27;71;02;17;505;Savianges;76;1;77;71505
27;71;04;26;506;Savigny-en-Revermont;1137;17;1154;71506
27;71;02;11;507;Savigny-sur-Grosne;169;1;170;71507
27;71;04;14;508;Savigny-sur-Seille;406;9;415;71508
27;71;01;01;509;La Celle-en-Morvan;476;6;482;71509
27;71;03;10;510;Semur-en-Brionnais;610;19;629;71510
27;71;02;29;512;Sennecey-le-Grand;3012;68;3080;71512
27;71;05;19;513;Senozan;1127;36;1163;71513
27;71;04;26;514;Sens-sur-Seille;419;5;424;71514
27;71;02;17;515;Sercy;100;3;103;71515
27;71;04;26;516;Serley;607;7;614;71516
27;71;02;16;517;Sermesse;232;3;235;71517
27;71;05;08;518;Serrières;274;9;283;71518
27;71;04;26;519;Serrigny-en-Bresse;189;4;193;71519
27;71;02;27;520;Sevrey;1290;25;1315;71520
27;71;05;11;521;Sigy-le-Châtel;106;2;108;71521
27;71;04;14;522;Simandre;1737;19;1756;71522
27;71;04;20;523;Simard;1188;12;1200;71523
27;71;05;11;524;Sivignon;173;7;180;71524
27;71;05;19;525;Sologny;576;11;587;71525
27;71;05;08;526;Solutré-Pouilly;361;7;368;71526
27;71;01;01;527;Sommant;210;4;214;71527
27;71;04;20;528;Sornay;2001;45;2046;71528
27;71;03;09;529;Suin;257;7;264;71529
27;71;01;01;530;Sully;488;14;502;71530
27;71;01;02;531;La Tagnière;215;1;216;71531
27;71;05;11;532;Taizé;194;3;197;71532
27;71;03;10;533;Tancon;532;18;550;71533
27;71;04;26;534;Le Tartre;112;5;117;71534
27;71;01;01;535;Tavernay;507;11;518;71535
27;71;01;02;537;Thil-sur-Arroux;131;0;131;71537
27;71;04;26;538;Thurey;439;11;450;71538
27;71;01;01;539;Tintry;79;2;81;71539
27;71;01;12;540;Torcy;2813;39;2852;71540
27;71;04;26;541;Torpes;374;4;378;71541
27;71;03;18;542;Toulon-sur-Arroux;1510;27;1537;71542
27;71;05;29;543;Tournus;5489;338;5827;71543
27;71;02;16;544;Toutenant;194;5;199;71544
27;71;05;08;545;Tramayes;1056;19;1075;71545
27;71;05;08;546;Trambly;404;8;412;71546
27;71;05;08;547;Trivy;259;7;266;71547
27;71;04;24;548;Tronchy;249;2;251;71548
27;71;05;29;549;La Truchère;214;6;220;71549
27;71;05;29;550;Uchizy;825;14;839;71550
27;71;01;02;551;Uchon;91;5;96;71551
27;71;03;18;552;Uxeau;520;13;533;71552
27;71;03;10;553;Vareilles;275;5;280;71553
27;71;03;10;554;Varenne-l'Arconce;113;3;116;71554
27;71;02;27;555;Varennes-le-Grand;2317;48;2365;71555
27;71;05;22;556;Varennes-lès-Mâcon;566;8;574;71556
27;71;03;15;557;Varenne-Saint-Germain;728;17;745;71557
27;71;04;14;558;Varennes-Saint-Sauveur;1132;26;1158;71558
27;71;03;10;559;Varennes-sous-Dun;539;14;553;71559
27;71;03;10;561;Vauban;225;9;234;71561
27;71;03;09;562;Vaudebarrier;212;33;245;71562
27;71;02;11;563;Vaux-en-Pré;74;1;75;71563
27;71;03;09;564;Vendenesse-lès-Charolles;746;20;766;71564
27;71;03;18;565;Vendenesse-sur-Arroux;569;12;581;71565
27;71;02;16;566;Verdun-sur-le-Doubs;1060;8;1068;71566
27;71;05;08;567;Vergisson;257;7;264;71567
27;71;04;20;568;Vérissey;57;0;57;71568
27;71;02;16;570;Verjux;516;14;530;71570
27;71;05;08;571;Verosvres;447;26;473;71571
27;71;02;29;572;Vers;233;0;233;71572
27;71;03;25;573;Versaugues;192;5;197;71573
27;71;05;19;574;Verzé;813;27;840;71574
27;71;05;29;576;Le Villars;279;5;284;71576
27;71;02;24;577;Villegaudin;219;4;223;71577
27;71;02;16;578;Clux-Villeneuve;313;11;324;71578
27;71;02;17;579;Villeneuve-en-Montagne;167;2;169;71579
27;71;04;20;580;Vincelles;418;10;428;71580
27;71;03;25;581;Vindecy;254;5;259;71581
27;71;05;11;582;La Vineuse sur Fregande;650;18;668;71582
27;71;05;08;583;Vinzelles;718;23;741;71583
27;71;05;19;584;Viré;1189;28;1217;71584
27;71;02;05;585;Virey-le-Grand;1366;71;1437;71585
27;71;03;09;586;Viry;258;4;262;71586
27;71;03;25;588;Vitry-en-Charollais;1099;38;1137;71588
27;71;03;15;589;Vitry-sur-Loire;423;8;431;71589
27;71;03;25;590;Volesvres;632;23;655;71590
27;71;05;19;591;Fleurville;521;8;529;71591
52;72;03;11;001;Aigné;1698;37;1735;72001
52;72;02;09;002;Aillières-Beauvoir;205;3;208;72002
52;72;03;16;003;Allonnes;11167;109;11276;72003
52;72;01;07;004;Amné;585;3;588;72004
52;72;02;20;005;Ancinnes;936;22;958;72005
52;72;02;09;006;Arçonnay;1899;232;2131;72006
52;72;02;19;007;Ardenay-sur-Mérize;497;11;508;72007
52;72;03;15;008;Arnage;5503;123;5626;72008
52;72;01;06;009;Arthezé;362;8;370;72009
52;72;01;17;010;Asnières-sur-Vègre;400;11;411;72010
52;72;02;20;011;Assé-le-Boisne;906;17;923;72011
52;72;02;20;012;Assé-le-Riboul;490;10;500;72012
52;72;01;08;013;Aubigné-Racan;2115;27;2142;72013
52;72;02;09;015;Les Aulneaux;114;0;114;72015
52;72;01;17;016;Auvers-le-Hamon;1478;35;1513;72016
52;72;01;07;017;Auvers-sous-Montfaucon;237;3;240;72017
52;72;02;09;018;Avesnes-en-Saosnois;87;1;88;72018
52;72;01;07;019;Avessé;377;9;386;72019
52;72;02;05;020;Avezé;705;17;722;72020
52;72;01;17;021;Avoise;585;7;592;72021
52;72;01;17;022;Le Bailleul;1221;27;1248;72022
52;72;03;01;023;Ballon-Saint Mars;2253;30;2283;72023
52;72;03;01;024;La Bazoge;3646;61;3707;72024
52;72;01;06;025;Bazouges Cré sur Loir;1993;54;2047;72025
52;72;02;01;026;Beaufay;1506;16;1522;72026
52;72;01;03;027;Beaumont-sur-Dême;327;8;335;72027
52;72;01;03;028;Beaumont-Pied-de-BÅ“uf;484;7;491;72028
52;72;02;20;029;Beaumont-sur-Sarthe;1967;28;1995;72029
52;72;02;05;031;Beillé;529;3;532;72031
52;72;02;18;032;Berfay;333;10;343;72032
52;72;02;20;034;Bérus;442;12;454;72034
52;72;02;18;035;Bessé-sur-Braye;2117;45;2162;72035
52;72;02;20;036;Béthon;309;4;313;72036
52;72;02;09;037;Blèves;120;1;121;72037
52;72;02;05;038;BoÃ«ssé-le-Sec;575;1;576;72038
52;72;02;01;039;Bonnétable;3791;57;3848;72039
52;72;02;05;040;La Bosse;142;2;144;72040
52;72;02;05;041;BouÃ«r;344;5;349;72041
52;72;02;18;042;Bouloire;2102;25;2127;72042
52;72;02;20;043;Bourg-le-Roi;327;7;334;72043
52;72;01;06;044;Bousse;436;5;441;72044
52;72;01;07;045;Brains-sur-Gée;829;13;842;72045
52;72;02;19;046;Le Breil-sur-Mérize;1544;27;1571;72046
52;72;03;02;047;Brette-les-Pins;2128;135;2263;72047
52;72;02;01;048;Briosne-lès-Sables;527;4;531;72048
52;72;01;08;049;La Bruère-sur-Loir;247;1;248;72049
52;72;01;07;050;Brûlon;1521;29;1550;72050
52;72;01;08;051;Cérans-Foulletourte;3369;36;3405;72051
52;72;01;03;052;Chahaignes;678;9;687;72052
52;72;03;02;053;Challes;1227;14;1241;72053
52;72;03;02;054;Champagné;3756;68;3824;72054
52;72;02;09;056;Champfleur;1336;24;1360;72056
52;72;02;18;057;Champrond;72;3;75;72057
52;72;03;02;058;Changé;6552;197;6749;72058
52;72;01;07;059;Chantenay-Villedieu;841;19;860;72059
52;72;01;08;060;La Chapelle-aux-Choux;261;3;264;72060
52;72;01;06;061;La Chapelle-d'Aligné;1701;25;1726;72061
52;72;02;05;062;La Chapelle-du-Bois;858;24;882;72062
52;72;02;18;064;La Chapelle-Huon;528;10;538;72064
52;72;03;11;065;La Chapelle-Saint-Aubin;2302;66;2368;72065
52;72;02;07;066;La Chapelle-Saint-Fray;426;7;433;72066
52;72;02;05;067;La Chapelle-Saint-Rémy;990;16;1006;72067
52;72;01;03;068;La Chartre-sur-le-Loir;1384;16;1400;72068
52;72;01;07;070;Chassillé;247;7;254;72070
52;72;01;03;071;Montval-sur-Loir;6038;245;6283;72071
52;72;01;08;072;Château-l'Hermitage;252;2;254;72072
52;72;03;16;073;Chaufour-Notre-Dame;1072;22;1094;72073
52;72;01;07;074;Chemiré-en-Charnie;210;4;214;72074
52;72;01;21;075;Chemiré-le-Gaudin;993;26;1019;72075
52;72;02;09;076;Chenay;241;2;243;72076
52;72;01;08;077;Chenu;426;7;433;72077
52;72;02;20;078;Chérancé;356;3;359;72078
52;72;02;20;079;Chérisay;312;3;315;72079
52;72;02;05;080;Cherré-Au;2731;80;2811;72080
52;72;01;07;083;Chevillé;382;11;393;72083
52;72;01;06;084;Clermont-Créans;1259;35;1294;72084
52;72;02;18;085;Cogners;182;2;184;72085
52;72;02;09;086;Commerveil;138;4;142;72086
52;72;02;18;087;Conflans-sur-Anille;477;14;491;72087
52;72;02;09;088;Congé-sur-Orne;334;11;345;72088
52;72;02;07;089;Conlie;1863;38;1901;72089
52;72;02;19;090;Connerré;2952;59;3011;72090
52;72;02;09;091;Contilly;133;2;135;72091
52;72;02;05;093;Cormes;903;14;917;72093
52;72;02;18;094;Coudrecieux;615;9;624;72094
52;72;03;13;095;Coulaines;7779;116;7895;72095
52;72;01;07;096;Coulans-sur-Gée;1656;82;1738;72096
52;72;01;08;098;Coulongé;505;6;511;72098
52;72;03;01;099;CourcebÅ“ufs;638;7;645;72099
52;72;01;06;100;Courcelles-la-Forêt;411;4;415;72100
52;72;02;01;101;Courcemont;676;13;689;72101
52;72;02;01;102;Courcival;98;1;99;72102
52;72;01;03;103;Courdemanche;611;8;619;72103
52;72;02;09;104;Courgains;573;15;588;72104
52;72;02;18;105;Courgenard;490;5;495;72105
52;72;01;17;106;Courtillers;935;28;963;72106
52;72;01;07;107;Crannes-en-Champagne;347;6;353;72107
52;72;02;20;109;Crissé;552;6;558;72109
52;72;01;06;110;Crosmières;1044;20;1064;72110
52;72;02;07;111;Cures;471;15;486;72111
52;72;02;09;112;Dangeul;476;5;481;72112
52;72;02;07;113;Degré;763;12;775;72113
52;72;02;05;114;Dehault;268;6;274;72114
52;72;01;03;115;Dissay-sous-Courcillon;922;22;944;72115
52;72;02;18;118;Dollon;1460;23;1483;72118
52;72;02;07;119;Domfront-en-Champagne;1047;19;1066;72119
52;72;02;20;120;Doucelles;251;3;254;72120
52;72;02;20;121;Douillet;322;10;332;72121
52;72;02;05;122;Duneau;1041;21;1062;72122
52;72;01;17;123;Dureil;72;0;72;72123
52;72;03;04;124;Ecommoy;4744;72;4816;72124
52;72;02;18;125;Ecorpain;298;9;307;72125
52;72;01;07;126;Epineu-le-Chevreuil;292;9;301;72126
52;72;01;21;127;Etival-lès-le-Mans;1956;37;1993;72127
52;72;02;18;128;Val-d'Etangson;524;5;529;72128
52;72;02;19;129;Fatines;850;16;866;72129
52;72;03;16;130;Fay;705;12;717;72130
52;72;01;21;131;Fercé-sur-Sarthe;593;8;601;72131
52;72;02;05;132;La Ferté-Bernard;8862;337;9199;72132
52;72;01;21;133;Fillé;1489;23;1512;72133
52;72;01;03;134;Flée;532;14;546;72134
52;72;01;08;135;La Fontaine-Saint-Martin;606;6;612;72135
52;72;01;07;136;Fontenay-sur-Vègre;318;8;326;72136
52;72;02;09;137;Villeneuve-en-Perseigne;2191;38;2229;72137
52;72;02;20;138;Fresnay-sur-Sarthe;2889;46;2935;72138
52;72;02;20;139;Fyé;979;41;1020;72139
52;72;02;20;141;Gesnes-le-Gandelin;923;35;958;72141
52;72;02;20;142;Grandchamp;149;5;154;72142
52;72;01;03;143;Le Grand-Lucé;1926;26;1952;72143
52;72;02;18;144;Gréez-sur-Roc;327;4;331;72144
52;72;02;20;145;Le Grez;395;7;402;72145
52;72;01;21;146;Guécélard;3092;54;3146;72146
52;72;03;01;147;La Guierche;1125;24;1149;72147
52;72;02;01;148;Jauzé;82;1;83;72148
52;72;01;07;149;Joué-en-Charnie;629;10;639;72149
52;72;03;01;150;Joué-l'Abbé;1261;23;1284;72150
52;72;01;17;151;Juigné-sur-Sarthe;1136;31;1167;72151
52;72;02;20;152;Juillé;444;11;455;72152
52;72;01;03;153;Jupilles;554;12;566;72153
52;72;01;06;154;La Flèche;14858;1071;15929;72154
52;72;03;04;155;Laigné-en-Belin;2323;30;2353;72155
52;72;02;18;156;Lamnay;932;23;955;72156
52;72;02;07;157;Lavardin;714;13;727;72157
52;72;02;18;158;Lavaré;831;12;843;72158
52;72;01;03;160;Lavernat;586;7;593;72160
52;72;01;03;161;Lhomme;904;13;917;72161
52;72;01;06;163;Ligron;491;9;500;72163
52;72;02;20;164;Livet-en-Saosnois;70;0;70;72164
52;72;02;19;165;Lombron;1911;24;1935;72165
52;72;01;07;166;Longnes;317;10;327;72166
52;72;01;17;167;Louailles;717;12;729;72167
52;72;01;07;168;Loué;2068;41;2109;72168
52;72;01;21;169;Louplande;1460;25;1485;72169
52;72;02;09;170;Louvigny;172;7;179;72170
52;72;02;09;171;Louzes;102;1;103;72171
52;72;02;05;172;Le Luart;1441;13;1454;72172
52;72;01;03;173;Luceau;1231;26;1257;72173
52;72;02;09;174;Lucé-sous-Ballon;102;1;103;72174
52;72;01;08;175;Luché-Pringé;1540;14;1554;72175
52;72;01;08;176;Le Lude;4126;71;4197;72176
52;72;01;07;177;Maigné;354;4;358;72177
52;72;02;18;178;Maisoncelles;191;1;192;72178
52;72;01;21;179;Malicorne-sur-Sarthe;1884;34;1918;72179
52;72;02;09;180;Mamers;5157;171;5328;72180
52;72;03;99;181;Le Mans;143847;2856;146703;72181
52;72;01;08;182;Mansigné;1544;29;1573;72182
52;72;01;03;183;Marçon;1068;16;1084;72183
52;72;01;07;184;Mareil-en-Champagne;384;6;390;72184
52;72;01;06;185;Mareil-sur-Loir;661;9;670;72185
52;72;02;20;186;Maresché;887;11;898;72186
52;72;03;04;187;Marigné-Laillé;1611;17;1628;72187
52;72;02;09;188;Marollette;151;2;153;72188
52;72;02;09;189;Marolles-les-Braults;2109;26;2135;72189
52;72;02;18;190;Marolles-lès-Saint-Calais;277;4;281;72190
52;72;01;08;191;Mayet;3120;39;3159;72191
52;72;02;09;192;Les Mées;95;2;97;72192
52;72;02;18;193;Melleray;430;7;437;72193
52;72;02;09;194;Meurcé;267;2;269;72194
52;72;01;21;195;Mézeray;1874;28;1902;72195
52;72;02;09;196;Mézières-sur-Ponthouin;732;6;738;72196
52;72;02;07;197;Mézières-sous-Lavardin;689;5;694;72197
52;72;03;11;198;La Milesse;2637;36;2673;72198
52;72;02;20;199;Moitron-sur-Sarthe;281;1;282;72199
52;72;03;04;200;Moncé-en-Belin;3703;62;3765;72200
52;72;02;09;201;Moncé-en-Saosnois;259;4;263;72201
52;72;02;09;202;Monhoudou;198;11;209;72202
52;72;02;18;204;Montaillé;521;6;527;72204
52;72;03;01;205;Montbizot;1804;26;1830;72205
52;72;02;18;208;Montmirail;374;9;383;72208
52;72;02;20;209;Montreuil-le-Chétif;304;1;305;72209
52;72;01;03;210;Montreuil-le-Henri;304;5;309;72210
52;72;02;20;211;Mont-Saint-Jean;638;11;649;72211
52;72;02;20;212;Moulins-le-Carbonnel;699;13;712;72212
52;72;03;04;213;Mulsanne;5225;63;5288;72213
52;72;02;09;214;Nauvay;10;2;12;72214
52;72;02;09;215;Neufchâtel-en-Saosnois;1034;12;1046;72215
52;72;02;07;216;Neuvillalais;595;14;609;72216
52;72;03;01;217;Neuville-sur-Sarthe;2448;48;2496;72217
52;72;02;20;218;Neuvillette-en-Charnie;291;4;295;72218
52;72;02;07;219;Bernay-Neuvy-en-Champagne;874;58;932;72219
52;72;02;01;220;Nogent-le-Bernard;902;37;939;72220
52;72;01;03;221;Nogent-sur-Loir;372;4;376;72221
52;72;02;09;222;Nouans;271;0;271;72222
52;72;01;07;223;Noyen-sur-Sarthe;2624;32;2656;72223
52;72;02;19;224;Nuillé-le-Jalais;533;3;536;72224
52;72;02;20;225;Oisseau-le-Petit;667;8;675;72225
52;72;01;08;226;Oizé;1333;17;1350;72226
52;72;02;09;227;Panon;41;0;41;72227
52;72;01;17;228;Parcé-sur-Sarthe;2084;50;2134;72228
52;72;02;20;229;Parennes;472;7;479;72229
52;72;01;21;230;Parigné-le-Pôlin;1073;27;1100;72230
52;72;03;02;231;Parigné-l'Evêque;5286;82;5368;72231
52;72;01;17;232;Notre-Dame-du-Pé;657;10;667;72232
52;72;02;09;233;Peray;60;0;60;72233
52;72;02;20;234;Pezé-le-Robert;365;10;375;72234
52;72;02;20;235;Piacé;376;7;383;72235
52;72;01;17;236;Pincé;191;8;199;72236
52;72;01;07;237;Pirmil;501;6;507;72237
52;72;02;09;238;Pizieux;73;0;73;72238
52;72;01;07;239;Poillé-sur-Vègre;612;21;633;72239
52;72;02;19;241;Montfort-le-Gesnois;2931;48;2979;72241
52;72;01;08;243;Pontvallain;1645;25;1670;72243
52;72;01;17;244;Précigné;2957;64;3021;72244
52;72;02;05;245;Préval;685;15;700;72245
52;72;02;05;246;Prévelles;208;6;214;72246
52;72;03;16;247;Pruillé-le-Chétif;1338;31;1369;72247
52;72;01;03;248;Pruillé-l'Eguillé;821;24;845;72248
52;72;02;07;249;La Quinte;763;13;776;72249
52;72;02;18;250;Rahay;151;9;160;72250
52;72;02;09;251;René;386;5;391;72251
52;72;01;08;252;Requeil;1142;10;1152;72252
52;72;01;21;253;Roézé-sur-Sarthe;2615;69;2684;72253
52;72;02;20;254;Rouessé-Fontaine;268;6;274;72254
52;72;02;20;255;Rouessé-Vassé;800;16;816;72255
52;72;02;20;256;Rouez;791;7;798;72256
52;72;03;10;257;Rouillon;2316;319;2635;72257
52;72;02;01;259;Rouperroux-le-Coquet;282;7;289;72259
52;72;03;04;260;Ruaudin;3503;69;3572;72260
52;72;02;07;261;Ruillé-en-Champagne;302;12;314;72261
52;72;01;03;262;Loir en Vallée;2163;174;2337;72262
52;72;01;17;264;Sablé-sur-Sarthe;12125;456;12581;72264
52;72;02;09;265;Saint-Aignan;236;2;238;72265
52;72;02;20;266;Saint-Aubin-de-Locquenay;733;17;750;72266
52;72;02;05;267;Saint-Aubin-des-Coudrais;912;21;933;72267
52;72;03;04;268;Saint-Biez-en-Belin;706;11;717;72268
52;72;02;18;269;Saint-Calais;3244;195;3439;72269
52;72;02;09;270;Saint-Calez-en-Saosnois;193;1;194;72270
52;72;02;19;271;Saint-Célerin;927;15;942;72271
52;72;02;18;272;Sainte-Cérotte;315;6;321;72272
52;72;02;20;273;Saint-Christophe-du-Jambet;232;3;235;72273
52;72;01;07;274;Saint-Christophe-en-Champagne;207;7;214;72274
52;72;02;19;275;Saint-Corneille;1521;15;1536;72275
52;72;02;09;276;Saint-Cosme-en-Vairais;1917;46;1963;72276
52;72;02;05;277;Saint-Denis-des-Coudrais;114;1;115;72277
52;72;01;07;278;Saint-Denis-d'Orques;773;11;784;72278
52;72;01;03;279;Saint-Georges-de-la-Couée;153;3;156;72279
52;72;03;16;280;Saint-Georges-du-Bois;2155;36;2191;72280
52;72;02;01;281;Saint-Georges-du-Rosay;443;5;448;72281
52;72;02;20;282;Saint-Georges-le-Gaultier;536;5;541;72282
52;72;01;08;283;Saint-Germain-d'Arcé;334;5;339;72283
52;72;02;18;286;Saint-Gervais-de-Vic;387;7;394;72286
52;72;03;04;287;Saint-Gervais-en-Belin;2021;44;2065;72287
52;72;03;01;289;Sainte-Jamme-sur-Sarthe;2035;33;2068;72289
52;72;03;01;290;Saint-Jean-d'Assé;1811;15;1826;72290
52;72;01;08;291;Saint-Jean-de-la-Motte;982;20;1002;72291
52;72;02;18;292;Saint-Jean-des-Echelles;238;5;243;72292
52;72;01;21;293;Saint-Jean-du-Bois;617;7;624;72293
52;72;02;20;294;Saint-Léonard-des-Bois;471;15;486;72294
52;72;02;09;295;Saint-Longis;499;7;506;72295
52;72;02;18;296;Saint-Maixent;746;21;767;72296
52;72;02;20;297;Saint-Marceau;547;12;559;72297
52;72;02;18;298;Saint-Mars-de-Locquenay;576;10;586;72298
52;72;03;02;299;Saint-Mars-d'Outillé;2439;34;2473;72299
52;72;02;19;300;Saint-Mars-la-Brière;2698;29;2727;72300
52;72;02;05;302;Saint-Martin-des-Monts;173;4;177;72302
52;72;02;18;303;Saint-Michel-de-Chavaignes;731;10;741;72303
52;72;02;20;305;Saint-Ouen-de-Mimbré;968;25;993;72305
52;72;03;04;306;Saint-Ouen-en-Belin;1322;24;1346;72306
52;72;01;07;307;Saint-Ouen-en-Champagne;239;6;245;72307
52;72;02;09;308;Saint-Paterne - Le Chevain;2106;248;2354;72308
52;72;02;20;309;Saint-Paul-le-Gaultier;285;7;292;72309
52;72;03;01;310;Saint-Pavace;1916;58;1974;72310
52;72;01;03;311;Saint-Pierre-de-Chevillé;351;6;357;72311
52;72;01;07;312;Saint-Pierre-des-Bois;234;3;237;72312
52;72;02;09;313;Saint-Pierre-des-Ormes;224;5;229;72313
52;72;01;03;314;Saint-Pierre-du-LorouÃ«r;375;8;383;72314
52;72;02;20;315;Saint-Rémy-de-Sillé;829;14;843;72315
52;72;02;09;316;Saint-Rémy-des-Monts;686;21;707;72316
52;72;02;09;317;Saint-Rémy-du-Val;501;18;519;72317
52;72;02;07;319;Sainte-Sabine-sur-Longève;742;19;761;72319
52;72;03;11;320;Saint-Saturnin;2590;81;2671;72320
52;72;02;07;321;Saint-Symphorien;516;10;526;72321
52;72;02;18;322;Saint-Ulphace;224;2;226;72322
52;72;02;20;323;Saint-Victeur;459;2;461;72323
52;72;02;09;324;Saint-Vincent-des-Prés;506;14;520;72324
52;72;01;03;325;Saint-Vincent-du-LorouÃ«r;840;17;857;72325
52;72;02;09;326;Saosnes;208;5;213;72326
52;72;01;08;327;Sarcé;300;4;304;72327
52;72;03;02;328;Sargé-lès-le-Mans;3709;140;3849;72328
52;72;02;19;329;Savigné-l'Evêque;4064;83;4147;72329
52;72;01;08;330;Savigné-sous-le-Lude;432;13;445;72330
52;72;02;05;331;Sceaux-sur-Huisne;579;11;590;72331
52;72;02;20;332;Ségrie;605;8;613;72332
52;72;02;18;333;Semur-en-Vallon;441;11;452;72333
52;72;02;20;334;Sillé-le-Guillaume;2231;86;2317;72334
52;72;02;19;335;Sillé-le-Philippe;1075;15;1090;72335
52;72;01;17;336;Solesmes;1214;40;1254;72336
52;72;02;20;337;Sougé-le-Ganelon;865;20;885;72337
52;72;03;01;338;Souillé;743;10;753;72338
52;72;01;21;339;Souligné-Flacé;672;10;682;72339
52;72;03;01;340;Souligné-sous-Ballon;1239;23;1262;72340
52;72;02;19;341;Soulitré;624;12;636;72341
52;72;02;05;342;Souvigné-sur-Même;165;7;172;72342
52;72;01;17;343;Souvigné-sur-Sarthe;626;11;637;72343
52;72;01;21;344;Spay;2881;48;2929;72344
52;72;02;19;345;Surfonds;339;5;344;72345
52;72;01;21;346;La Suze-sur-Sarthe;4473;56;4529;72346
52;72;01;07;347;Tassé;300;5;305;72347
52;72;01;07;348;Tassillé;129;1;130;72348
52;72;03;01;349;Teillé;476;2;478;72349
52;72;03;04;350;Teloché;3056;61;3117;72350
52;72;02;07;351;Tennie;1051;20;1071;72351
52;72;02;01;352;Terrehault;139;0;139;72352
52;72;02;05;353;Théligny;215;5;220;72353
52;72;02;09;354;Thoigné;161;4;165;72354
52;72;02;20;355;Thoiré-sous-Contensor;106;1;107;72355
52;72;01;03;356;Thoiré-sur-Dinan;414;5;419;72356
52;72;01;06;357;Thorée-les-Pins;729;12;741;72357
52;72;02;18;358;Thorigné-sur-Dué;1615;37;1652;72358
52;72;02;19;359;Torcé-en-Vallée;1429;9;1438;72359
52;72;03;16;360;Trangé;1509;34;1543;72360
52;72;02;18;361;Tresson;484;8;492;72361
52;72;02;20;362;Le Tronchet;165;1;166;72362
52;72;02;05;363;Tuffé Val de la Chéronne;1663;16;1679;72363
52;72;01;08;364;Vaas;1432;25;1457;72364
52;72;02;18;366;Valennes;315;4;319;72366
52;72;01;07;367;Vallon-sur-Gée;793;12;805;72367
52;72;02;18;368;Vancé;322;6;328;72368
52;72;01;08;369;Verneil-le-Chétif;594;64;658;72369
52;72;02;20;370;Vernie;328;6;334;72370
52;72;02;09;372;Vezot;77;1;78;72372
52;72;02;18;373;Vibraye;2510;55;2565;72373
52;72;02;09;374;Villaines-la-Carelle;148;5;153;72374
52;72;02;05;375;Villaines-la-Gonais;539;14;553;72375
52;72;01;03;376;Villaines-sous-Lucé;707;21;728;72376
52;72;01;06;377;Villaines-sous-Malicorne;1033;11;1044;72377
52;72;01;17;378;Vion;1445;33;1478;72378
52;72;01;07;379;Viré-en-Champagne;195;6;201;72379
52;72;02;20;380;Vivoin;947;22;969;72380
52;72;01;21;381;Voivres-lès-le-Mans;1370;11;1381;72381
52;72;02;18;382;Volnay;943;18;961;72382
52;72;02;05;383;Vouvray-sur-Huisne;132;4;136;72383
52;72;01;08;385;Yvré-le-Pôlin;1766;24;1790;72385
52;72;03;02;386;Yvré-l'Evêque;4261;133;4394;72386
84;73;02;14;001;Aiguebelette-le-Lac;232;9;241;73001
84;73;01;13;003;Grand-Aigueblanche;3838;113;3951;73003
84;73;02;16;004;Aillon-le-Jeune;433;16;449;73004
84;73;02;16;005;Aillon-le-Vieux;182;4;186;73005
84;73;01;05;006;Aime-la-Plagne;4444;109;4553;73006
84;73;03;18;007;Aiton;1679;22;1701;73007
84;73;02;97;008;Aix-les-Bains;30463;577;31040;73008
84;73;02;01;010;Entrelacs;6315;141;6456;73010
84;73;01;98;011;Albertville;19502;564;20066;73011
84;73;03;17;012;Albiez-le-Jeune;147;2;149;73012
84;73;03;17;013;Albiez-Montrond;365;10;375;73013
84;73;01;03;014;Allondaz;288;2;290;73014
84;73;01;13;015;Les Allues;1860;43;1903;73015
84;73;02;11;017;Apremont;987;21;1008;73017
84;73;02;11;018;Arbin;769;21;790;73018
84;73;03;18;019;Argentine;955;20;975;73019
84;73;02;16;020;Arith;443;11;454;73020
84;73;02;11;021;Arvillard;850;17;867;73021
84;73;02;14;022;Attignat-Oncin;563;15;578;73022
84;73;03;10;023;Aussois;698;23;721;73023
84;73;01;13;024;Les Avanchers-Valmorel;778;22;800;73024
84;73;02;06;025;Avressieux;526;11;537;73025
84;73;03;10;026;Avrieux;389;14;403;73026
84;73;02;14;027;Ayn;387;6;393;73027
84;73;02;06;028;La Balme;337;3;340;73028
84;73;02;15;029;Barberaz;5022;118;5140;73029
84;73;02;16;030;Barby;3429;41;3470;73030
84;73;02;16;031;Bassens;4785;121;4906;73031
84;73;01;03;032;La Bâthie;2152;37;2189;73032
84;73;02;14;033;La Bauche;494;5;499;73033
84;73;01;19;034;Beaufort;2034;89;2123;73034
84;73;02;16;036;Bellecombe-en-Bauges;683;18;701;73036
84;73;02;14;039;Belmont-Tramonet;536;12;548;73039
84;73;03;10;040;Bessans;359;8;367;73040
84;73;02;18;041;Betton-Bettonet;306;6;312;73041
84;73;02;06;042;Billième;263;7;270;73042
84;73;02;01;043;La Biolle;2781;35;2816;73043
84;73;03;10;047;Bonneval-sur-Arc;259;9;268;73047
84;73;01;04;048;Bonvillard;355;14;369;73048
84;73;03;18;049;Bonvillaret;148;0;148;73049
84;73;02;12;050;Bourdeau;574;21;595;73050
84;73;02;12;051;Le Bourget-du-Lac;4966;99;5065;73051
84;73;02;11;052;Bourget-en-Huile;147;4;151;73052
84;73;02;18;053;Bourgneuf;690;11;701;73053
84;73;01;05;054;Bourg-Saint-Maurice;7195;401;7596;73054
84;73;01;13;055;Bozel;1876;58;1934;73055
84;73;01;13;057;Brides-les-Bains;500;12;512;73057
84;73;02;14;058;La Bridoire;1272;19;1291;73058
84;73;02;01;059;Brison-Saint-Innocent;2262;69;2331;73059
84;73;01;19;061;Césarches;423;15;438;73061
84;73;01;03;063;Cevins;718;10;728;73063
84;73;02;15;064;Challes-les-Eaux;5609;273;5882;73064
84;73;02;99;065;Chambéry;58917;1561;60478;73065
84;73;03;17;067;La Chambre;1151;22;1173;73067
84;73;02;18;068;Chamousset;587;20;607;73068
84;73;02;18;069;Chamoux-sur-Gelon;952;17;969;73069
84;73;02;06;070;Champagneux;702;8;710;73070
84;73;01;13;071;Champagny-en-Vanoise;565;22;587;73071
84;73;02;18;072;Champ-Laurent;33;1;34;73072
84;73;02;06;073;Chanaz;535;7;542;73073
84;73;03;17;074;La Chapelle;330;11;341;73074
84;73;02;11;075;La Chapelle-Blanche;572;21;593;73075
84;73;02;12;076;La Chapelle-du-Mont-du-Chat;261;4;265;73076
84;73;01;05;077;Les Chapelles;563;10;573;73077
84;73;02;06;078;La Chapelle-Saint-Martin;144;6;150;73078
84;73;02;18;079;Châteauneuf;924;15;939;73079
84;73;02;16;081;Le Châtelard;668;44;712;73081
84;73;02;11;082;La Chavanne;747;38;785;73082
84;73;03;17;083;Les Chavannes-en-Maurienne;222;3;225;73083
84;73;02;11;084;Chignin;952;27;979;73084
84;73;02;06;085;Chindrieux;1394;21;1415;73085
84;73;01;04;086;Cléry;393;12;405;73086
84;73;02;09;087;Cognin;6359;184;6543;73087
84;73;01;19;088;Cohennoz;159;8;167;73088
84;73;02;18;089;Coise-Saint-Jean-Pied-Gauthier;1269;22;1291;73089
84;73;02;16;090;La Compôte;264;7;271;73090
84;73;02;06;091;Conjux;207;3;210;73091
84;73;02;14;092;Corbel;153;4;157;73092
84;73;01;19;094;Crest-Voland;336;14;350;73094
84;73;02;11;095;La Croix-de-la-Rochette;382;8;390;73095
84;73;02;18;096;Cruet;1041;19;1060;73096
84;73;02;16;097;Curienne;678;21;699;73097
84;73;02;16;098;Les Déserts;811;22;833;73098
84;73;02;11;099;Détrier;433;4;437;73099
84;73;02;14;100;Domessin;1904;46;1950;73100
84;73;02;16;101;Doucy-en-Bauges;96;3;99;73101
84;73;02;12;103;Drumettaz-Clarafond;2934;67;3001;73103
84;73;02;14;104;Dullin;479;5;484;73104
84;73;02;14;105;Les Echelles;1239;17;1256;73105
84;73;02;16;106;Ecole;303;6;309;73106
84;73;02;14;107;Entremont-le-Vieux;644;8;652;73107
84;73;03;18;109;Epierre;777;9;786;73109
84;73;01;03;110;Esserts-Blay;782;7;789;73110
84;73;01;13;113;Feissons-sur-Salins;177;3;180;73113
84;73;01;19;114;Flumet;802;29;831;73114
84;73;03;17;116;Fontcouverte-la-Toussuire;481;12;493;73116
84;73;03;10;117;Fourneaux;691;9;700;73117
84;73;03;10;119;Freney;99;4;103;73119
84;73;02;18;120;Fréterive;609;14;623;73120
84;73;01;04;121;Frontenex;1928;49;1977;73121
84;73;02;06;122;Gerbaix;424;19;443;73122
84;73;01;19;123;La Giettaz;387;15;402;73123
84;73;01;04;124;Gilly-sur-Isère;3042;78;3120;73124
84;73;02;01;128;Grésy-sur-Aix;4595;101;4696;73128
84;73;01;04;129;Grésy-sur-Isère;1215;39;1254;73129
84;73;01;04;130;Grignon;2107;38;2145;73130
84;73;01;13;131;Hautecour;303;8;311;73131
84;73;01;19;132;Hauteluce;758;23;781;73132
84;73;02;18;133;Hauteville;351;7;358;73133
84;73;03;17;135;La Tour-en-Maurienne;1079;26;1105;73135
84;73;02;08;137;Jacob-Bellecombette;4047;78;4125;73137
84;73;03;17;138;Jarrier;491;11;502;73138
84;73;02;16;139;Jarsy;271;12;283;73139
84;73;02;06;140;Jongieux;283;7;290;73140
84;73;02;11;141;Laissaud;687;14;701;73141
84;73;01;05;142;Landry;817;20;837;73142
84;73;02;14;145;Lépin-le-Lac;464;14;478;73145
84;73;02;16;146;Lescheraines;781;17;798;73146
84;73;02;06;147;Loisieux;202;0;202;73147
84;73;02;06;149;Lucey;305;6;311;73149
84;73;01;05;150;La Plagne Tarentaise;3766;128;3894;73150
84;73;02;11;151;Porte-de-Savoie;3796;88;3884;73151
84;73;02;06;152;Marcieux;213;5;218;73152
84;73;01;19;153;Marthod;1352;31;1383;73153
84;73;01;03;154;Mercury;3299;94;3393;73154
84;73;02;12;155;Méry;2013;42;2055;73155
84;73;02;06;156;Meyrieux-Trouet;313;6;319;73156
84;73;03;10;157;Modane;3075;136;3211;73157
84;73;02;11;159;Les Mollettes;845;8;853;73159
84;73;02;14;160;Montagnole;978;26;1004;73160
84;73;01;13;161;Montagny;654;14;668;73161
84;73;01;04;162;Montailleur;678;24;702;73162
84;73;02;01;164;Montcel;1011;61;1072;73164
84;73;02;18;166;Montendry;54;2;56;73166
84;73;03;18;168;Montgilbert;119;1;120;73168
84;73;01;04;170;Monthion;526;11;537;73170
84;73;02;11;171;Montmélian;4102;71;4173;73171
84;73;03;17;173;Montricher-Albanne;475;11;486;73173
84;73;03;18;175;Montsapey;73;0;73;73175
84;73;01;05;176;Montvalezan;709;10;719;73176
84;73;03;17;177;Montvernier;238;7;245;73177
84;73;02;16;178;La Motte-en-Bauges;505;11;516;73178
84;73;02;12;179;La Motte-Servolex;12120;611;12731;73179
84;73;02;06;180;Motz;435;7;442;73180
84;73;01;13;181;Moûtiers;3496;458;3954;73181
84;73;02;02;182;Mouxy;2241;54;2295;73182
84;73;02;11;183;Myans;1289;34;1323;73183
84;73;02;14;184;Nances;509;11;520;73184
84;73;01;19;186;Notre-Dame-de-Bellecombe;477;14;491;73186
84;73;01;13;187;La Léchère;2635;56;2691;73187
84;73;01;04;188;Notre-Dame-des-Millières;1029;25;1054;73188
84;73;03;17;189;Notre-Dame-du-Cruet;227;2;229;73189
84;73;01;13;190;Notre-Dame-du-Pré;247;6;253;73190
84;73;02;06;191;Novalaise;2147;69;2216;73191
84;73;02;16;192;Le Noyer;213;5;218;73192
84;73;02;06;193;Ontex;106;3;109;73193
84;73;03;10;194;Orelle;328;9;337;73194
84;73;01;19;196;Pallud;789;19;808;73196
84;73;01;05;197;Peisey-Nancroix;641;25;666;73197
84;73;02;11;200;Planaise;553;7;560;73200
84;73;01;13;201;Planay;441;14;455;73201
84;73;01;04;202;Plancherine;454;10;464;73202
84;73;02;14;204;Le Pont-de-Beauvoisin;2075;32;2107;73204
84;73;02;11;205;Le Pontet;117;4;121;73205
84;73;01;13;206;Pralognan-la-Vanoise;715;23;738;73206
84;73;02;11;207;Presle;432;12;444;73207
84;73;02;01;208;Pugny-Chatenod;950;40;990;73208
84;73;02;16;210;Puygros;379;5;384;73210
84;73;01;19;211;Queige;782;24;806;73211
84;73;03;18;212;Val-d'Arc;2018;29;2047;73212
84;73;02;15;213;La Ravoire;8530;546;9076;73213
84;73;02;06;214;Rochefort;235;10;245;73214
84;73;02;11;215;Valgelon-La Rochette;4160;100;4260;73215
84;73;01;03;216;Rognaix;487;6;493;73216
84;73;02;11;217;Rotherens;368;12;380;73217
84;73;02;06;218;Ruffieux;816;16;832;73218
84;73;02;14;219;Saint-Alban-de-Montbel;663;16;679;73219
84;73;03;18;220;Saint-Alban-d'Hurtières;366;11;377;73220
84;73;03;17;221;Saint-Alban-des-Villards;88;3;91;73221
84;73;02;16;222;Saint-Alban-Leysse;6285;209;6494;73222
84;73;03;10;223;Saint-André;446;6;452;73223
84;73;03;17;224;Saint-Avre;889;21;910;73224
84;73;02;15;225;Saint-Baldoph;2759;91;2850;73225
84;73;02;14;226;Saint-Béron;1706;22;1728;73226
84;73;01;13;227;Courchevel;2360;73;2433;73227
84;73;02;14;228;Saint-Cassin;905;24;929;73228
84;73;02;14;229;Saint-Christophe;533;13;546;73229
84;73;03;17;230;Saint-Colomban-des-Villards;132;0;132;73230
84;73;03;17;231;Saint-Etienne-de-Cuines;1205;23;1228;73231
84;73;01;05;232;Sainte-Foy-Tarentaise;729;24;753;73232
84;73;02;14;233;Saint-Franc;162;8;170;73233
84;73;02;16;234;Saint-François-de-Sales;149;4;153;73234
84;73;03;17;235;Saint François Longchamp;545;6;551;73235
84;73;02;06;236;Saint-Genix-les-Villages;2905;67;2972;73236
84;73;03;18;237;Saint-Georges-d'Hurtières;350;3;353;73237
84;73;02;11;240;Sainte-Hélène-du-Lac;793;20;813;73240
84;73;01;04;241;Sainte-Hélène-sur-Isère;1196;21;1217;73241
84;73;03;17;242;Saint-Jean-d'Arves;272;10;282;73242
84;73;02;16;243;Saint-Jean-d'Arvey;1726;57;1783;73243
84;73;02;06;245;Saint-Jean-de-Chevelu;823;16;839;73245
84;73;02;14;246;Saint-Jean-de-Couz;299;5;304;73246
84;73;02;18;247;Saint-Jean-de-la-Porte;956;71;1027;73247
84;73;03;17;248;Saint-Jean-de-Maurienne;7621;345;7966;73248
84;73;02;15;249;Saint-Jeoire-Prieuré;1866;46;1912;73249
84;73;03;17;250;Saint-Julien-Mont-Denis;1627;44;1671;73250
84;73;03;18;252;Saint-Léger;239;3;242;73252
84;73;01;13;253;Saint-Marcel;601;8;609;73253
84;73;02;06;254;Sainte-Marie-d'Alvey;120;2;122;73254
84;73;03;17;255;Sainte-Marie-de-Cuines;818;21;839;73255
84;73;03;10;256;Saint-Martin-d'Arc;327;8;335;73256
84;73;01;13;257;Les Belleville;3494;117;3611;73257
84;73;03;10;258;Saint-Martin-de-la-Porte;679;20;699;73258
84;73;03;17;259;Saint-Martin-sur-la-Chambre;544;14;558;73259
84;73;03;10;261;Saint-Michel-de-Maurienne;2467;280;2747;73261
84;73;01;19;262;Saint-Nicolas-la-Chapelle;472;35;507;73262
84;73;02;01;263;Saint-Offenge;1145;22;1167;73263
84;73;02;01;265;Saint-Ours;723;19;742;73265
84;73;03;17;267;Saint-Pancrace;297;10;307;73267
84;73;01;03;268;Saint-Paul-sur-Isère;529;59;588;73268
84;73;02;06;269;Saint-Paul;724;13;737;73269
84;73;02;18;270;Saint-Pierre-d'Albigny;4097;103;4200;73270
84;73;02;06;271;Saint-Pierre-d'Alvey;307;10;317;73271
84;73;03;18;272;Saint-Pierre-de-Belleville;178;4;182;73272
84;73;02;06;273;Saint-Pierre-de-Curtille;487;6;493;73273
84;73;02;14;274;Saint-Pierre-d'Entremont;451;15;466;73274
84;73;02;14;275;Saint-Pierre-de-Genebroz;321;8;329;73275
84;73;02;11;276;Saint-Pierre-de-Soucy;415;18;433;73276
84;73;02;16;277;Sainte-Reine;172;7;179;73277
84;73;03;17;278;Saint-Rémy-de-Maurienne;1238;21;1259;73278
84;73;03;17;280;Saint-Sorlin-d'Arves;344;8;352;73280
84;73;02;14;281;Saint-Sulpice;747;20;767;73281
84;73;02;14;282;Saint-Thibaud-de-Couz;1062;19;1081;73282
84;73;01;04;283;Saint-Vital;709;14;723;73283
84;73;01;13;284;Salins-Fontaine;997;19;1016;73284
84;73;01;05;285;Séez;2322;70;2392;73285
84;73;02;06;286;Serrières-en-Chautagne;1168;21;1189;73286
84;73;02;07;288;Sonnaz;2002;46;2048;73288
84;73;02;11;289;La Table;427;9;436;73289
84;73;03;10;290;Val-Cenis;2062;38;2100;73290
84;73;01;19;292;Thénésol;318;7;325;73292
84;73;02;16;293;Thoiry;455;7;462;73293
84;73;02;16;294;La Thuile;338;7;345;73294
84;73;01;05;296;Tignes;2020;42;2062;73296
84;73;01;04;297;Tournon;592;22;614;73297
84;73;01;03;298;Tours-en-Savoie;910;11;921;73298
84;73;02;06;299;Traize;325;6;331;73299
84;73;02;02;300;Tresserve;2988;106;3094;73300
84;73;02;01;301;Trévignin;814;16;830;73301
84;73;02;11;302;La Trinité;338;3;341;73302
84;73;01;19;303;Ugine;7096;289;7385;73303
84;73;01;05;304;Val-d'Isère;1583;46;1629;73304
84;73;03;10;306;Valloire;1066;25;1091;73306
84;73;03;10;307;Valmeinier;566;3;569;73307
84;73;01;19;308;Venthon;593;18;611;73308
84;73;02;14;309;Verel-de-Montbel;300;5;305;73309
84;73;02;16;310;Verel-Pragondran;479;12;491;73310
84;73;02;11;311;Le Verneil;105;1;106;73311
84;73;01;04;312;Verrens-Arvey;918;31;949;73312
84;73;02;06;313;Verthemex;230;1;231;73313
84;73;02;11;314;Villard-d'Héry;261;5;266;73314
84;73;02;18;315;Villard-Léger;457;8;465;73315
84;73;02;11;316;Villard-Sallet;290;4;294;73316
84;73;01;19;317;Villard-sur-Doron;705;27;732;73317
84;73;03;17;318;Villarembert;252;9;261;73318
84;73;03;17;320;Villargondran;853;25;878;73320
84;73;03;10;322;Villarodin-Bourget;536;14;550;73322
84;73;01;05;323;Villaroger;360;15;375;73323
84;73;02;11;324;Villaroux;193;8;201;73324
84;73;02;14;326;Vimines;2114;40;2154;73326
84;73;02;06;327;Vions;395;6;401;73327
84;73;02;12;328;Viviers-du-Lac;2269;57;2326;73328
84;73;02;12;329;Voglans;1911;37;1948;73329
84;73;02;06;330;Yenne;3002;34;3036;73330
84;74;04;07;001;Abondance;1447;117;1564;74001
84;74;01;12;002;Alby-sur-Chéran;2576;55;2631;74002
84;74;01;08;003;Alex;1102;35;1137;74003
84;74;01;12;004;Allèves;415;8;423;74004
84;74;04;17;005;Allinges;4681;125;4806;74005
84;74;03;11;006;Allonzier-la-Caille;2191;30;2221;74006
84;74;02;11;007;Amancy;2739;54;2793;74007
84;74;03;04;008;Ambilly;6138;67;6205;74008
84;74;03;11;009;Andilly;953;18;971;74009
84;74;01;99;010;Annecy;130721;3380;134101;74010
84;74;03;04;012;Annemasse;36582;396;36978;74012
84;74;04;15;013;Anthy-sur-Léman;2198;91;2289;74013
84;74;02;14;014;Arâches-la-Frasse;1847;54;1901;74014
84;74;03;11;015;Arbusigny;1140;24;1164;74015
84;74;03;13;016;Archamps;2609;35;2644;74016
84;74;02;05;018;Arenthon;1866;48;1914;74018
84;74;01;03;019;Argonay;3370;270;3640;74019
84;74;04;17;020;Armoy;1359;57;1416;74020
84;74;03;09;021;Arthaz-Pont-Notre-Dame;1623;30;1653;74021
84;74;02;05;024;Ayse;2219;60;2279;74024
84;74;04;15;025;Ballaison;1492;21;1513;74025
84;74;01;01;026;La Balme-de-Sillingy;5078;163;5241;74026
84;74;01;08;027;La Balme-de-Thuy;455;9;464;74027
84;74;03;13;029;Bassy;419;14;433;74029
84;74;04;07;030;La Baume;321;6;327;74030
84;74;03;13;031;Beaumont;3027;67;3094;74031
84;74;04;17;032;Bellevaux;1273;40;1313;74032
84;74;04;07;033;Bernex;1384;28;1412;74033
84;74;04;07;034;Le Biot;615;7;622;74034
84;74;01;12;035;Bloye;592;24;616;74035
84;74;01;08;036;Bluffy;376;12;388;74036
84;74;04;15;037;BoÃ«ge;1861;61;1922;74037
84;74;04;15;038;Bogève;1133;29;1162;74038
84;74;03;09;040;Bonne;3181;143;3324;74040
84;74;04;07;041;Bonnevaux;281;5;286;74041
84;74;02;05;042;Bonneville;12509;406;12915;74042
84;74;04;15;043;Bons-en-Chablais;5739;109;5848;74043
84;74;03;13;044;Bossey;1042;12;1054;74044
84;74;01;08;045;Le Bouchet-Mont-Charvin;249;6;255;74045
84;74;01;12;046;Boussy;506;12;518;74046
84;74;04;15;048;Brenthonne;1096;22;1118;74048
84;74;02;05;049;Brizon;482;2;484;74049
84;74;04;15;050;Burdignin;673;16;689;74050
84;74;03;11;051;Cercier;696;11;707;74051
84;74;03;11;052;Cernex;1055;17;1072;74052
84;74;04;17;053;Cervens;1233;22;1255;74053
84;74;01;12;054;Chainaz-les-Frasses;759;28;787;74054
84;74;03;13;055;Challonges;544;13;557;74055
84;74;02;10;056;Chamonix-Mont-Blanc;8640;386;9026;74056
84;74;04;07;057;Champanges;1111;31;1142;74057
84;74;04;07;058;La Chapelle-d'Abondance;932;17;949;74058
84;74;02;11;059;La Chapelle-Rambaud;261;6;267;74059
84;74;01;16;060;La Chapelle-Saint-Maurice;115;0;115;74060
84;74;01;12;061;Chapeiry;931;35;966;74061
84;74;01;03;062;Charvonnex;1428;26;1454;74062
84;74;04;07;063;Châtel;1246;42;1288;74063
84;74;02;06;064;Châtillon-sur-Cluses;1194;44;1238;74064
84;74;03;13;065;Chaumont;499;15;514;74065
84;74;03;13;066;Chavannaz;253;2;255;74066
84;74;01;16;067;Chavanod;2683;168;2851;74067
84;74;03;13;068;Chêne-en-Semine;519;8;527;74068
84;74;03;13;069;Chênex;810;14;824;74069
84;74;04;15;070;Chens-sur-Léman;2792;35;2827;74070
84;74;03;13;071;Chessenaz;221;6;227;74071
84;74;01;08;072;Chevaline;202;6;208;74072
84;74;04;07;073;Chevenoz;662;12;674;74073
84;74;03;13;074;Chevrier;626;7;633;74074
84;74;03;13;075;Chilly;1441;22;1463;74075
84;74;01;01;076;Choisy;1660;43;1703;74076
84;74;03;13;077;Clarafond-Arcine;1034;26;1060;74077
84;74;03;13;078;Clermont;405;6;411;74078
84;74;01;08;079;Les Clefs;675;6;681;74079
84;74;01;08;080;La Clusaz;1709;53;1762;74080
84;74;02;06;081;Cluses;16918;405;17323;74081
84;74;03;13;082;Collonges-sous-Salève;3948;117;4065;74082
84;74;02;14;083;Combloux;2104;115;2219;74083
84;74;02;10;085;Les Contamines-Montjoie;1118;47;1165;74085
84;74;03;13;086;Contamine-Sarzin;722;12;734;74086
84;74;02;05;087;Contamine-sur-Arve;2204;152;2356;74087
84;74;03;11;088;Copponex;1195;22;1217;74088
84;74;02;14;089;Cordon;984;26;1010;74089
84;74;02;11;090;Cornier;1385;20;1405;74090
84;74;02;07;091;La Côte-d'Arbroz;362;2;364;74091
84;74;03;09;094;Cranves-Sales;6975;167;7142;74094
84;74;01;12;095;Crempigny-Bonneguête;319;10;329;74095
84;74;03;11;096;Cruseilles;4502;315;4817;74096
84;74;01;12;097;Cusy;1836;55;1891;74097
84;74;01;11;098;Cuvat;1541;54;1595;74098
84;74;02;14;099;Demi-Quartier;844;37;881;74099
84;74;03;13;100;Desingy;785;25;810;74100
84;74;03;13;101;Dingy-en-Vuache;709;17;726;74101
84;74;01;08;102;Dingy-Saint-Clair;1441;47;1488;74102
84;74;02;14;103;Domancy;2195;76;2271;74103
84;74;01;08;104;Doussard;3542;85;3627;74104
84;74;04;15;105;Douvaine;6483;80;6563;74105
84;74;04;17;106;Draillant;902;31;933;74106
84;74;03;13;107;Droisy;154;5;159;74107
84;74;01;16;108;Duingt;994;21;1015;74108
84;74;03;13;109;Eloise;927;19;946;74109
84;74;01;16;111;Entrevernes;212;3;215;74111
84;74;01;03;112;Epagny Metz-Tessy;8196;198;8394;74112
84;74;04;07;114;Essert-Romand;512;6;518;74114
84;74;02;11;116;Etaux;2021;70;2091;74116
84;74;01;12;117;Etercy;838;21;859;74117
84;74;03;09;118;Etrembières;2556;29;2585;74118
84;74;04;07;119;Evian-les-Bains;9108;251;9359;74119
84;74;04;15;121;Excenevex;1168;17;1185;74121
84;74;02;05;122;Faucigny;640;21;661;74122
84;74;01;08;123;Faverges-Seythenex;7609;227;7836;74123
84;74;03;13;124;Feigères;1757;32;1789;74124
84;74;04;15;126;Fessy;990;31;1021;74126
84;74;04;07;127;Féternes;1433;43;1476;74127
84;74;03;05;128;Fillinges;3516;88;3604;74128
84;74;04;07;129;La Forclaz;227;4;231;74129
84;74;03;13;130;Franclens;540;31;571;74130
84;74;03;13;131;Frangy;2052;39;2091;74131
84;74;03;09;133;Gaillard;10071;108;10179;74133
84;74;02;07;134;Les Gets;1215;27;1242;74134
84;74;01;08;135;Giez;525;8;533;74135
84;74;01;08;136;Le Grand-Bornand;2096;48;2144;74136
84;74;01;03;137;Groisy;3900;147;4047;74137
84;74;01;12;138;Gruffy;1522;62;1584;74138
84;74;04;15;139;Habère-Lullin;1051;31;1082;74139
84;74;04;15;140;Habère-Poche;1475;27;1502;74140
84;74;01;12;141;Hauteville-sur-Fier;1029;26;1055;74141
84;74;01;12;142;Héry-sur-Alby;983;31;1014;74142
84;74;02;10;143;Les Houches;3007;80;3087;74143
84;74;03;13;144;Jonzier-Epagny;827;20;847;74144
84;74;03;09;145;Juvigny;630;12;642;74145
84;74;04;07;146;Larringes;1506;46;1552;74146
84;74;01;08;147;Lathuile;1008;26;1034;74147
84;74;01;16;148;Leschaux;273;7;280;74148
84;74;04;15;150;Loisin;1633;29;1662;74150
84;74;01;12;151;Lornay;572;9;581;74151
84;74;01;01;152;Lovagny;1257;41;1298;74152
84;74;03;09;153;Lucinges;1607;65;1672;74153
84;74;04;07;154;Lugrin;2504;52;2556;74154
84;74;04;17;155;Lullin;802;28;830;74155
84;74;04;15;156;Lully;690;13;703;74156
84;74;04;17;157;Lyaud;1741;63;1804;74157
84;74;03;09;158;Machilly;1098;17;1115;74158
84;74;02;14;159;Magland;3240;68;3308;74159
84;74;01;08;160;Manigod;996;23;1019;74160
84;74;01;12;161;Marcellaz-Albanais;1953;57;2010;74161
84;74;02;05;162;Marcellaz;1052;18;1070;74162
84;74;04;15;163;Margencel;2197;78;2275;74163
84;74;02;05;164;Marignier;6372;185;6557;74164
84;74;01;12;165;Marigny-Saint-Marcel;693;9;702;74165
84;74;04;07;166;Marin;1842;52;1894;74166
84;74;01;08;167;Val de Chaise;1383;24;1407;74167
84;74;03;13;168;Marlioz;1053;11;1064;74168
84;74;02;06;169;Marnaz;5642;116;5758;74169
84;74;01;12;170;Massingy;874;19;893;74170
84;74;04;15;171;Massongy;1534;34;1568;74171
84;74;04;07;172;Maxilly-sur-Léman;1453;34;1487;74172
84;74;02;14;173;Megève;3025;128;3153;74173
84;74;02;05;174;Mégevette;590;25;615;74174
84;74;04;07;175;Meillerie;314;6;320;74175
84;74;01;08;176;Menthon-Saint-Bernard;1884;70;1954;74176
84;74;03;11;177;Menthonnex-en-Bornes;1082;20;1102;74177
84;74;03;13;178;Menthonnex-sous-Clermont;729;13;742;74178
84;74;01;01;179;Mésigny;780;27;807;74179
84;74;04;15;180;Messery;2150;50;2200;74180
84;74;02;06;183;Mieussy;2421;64;2485;74183
84;74;03;13;184;Minzier;1045;20;1065;74184
84;74;03;11;185;Monnetier-Mornex;2318;45;2363;74185
84;74;01;16;186;Montagny-les-Lanches;760;22;782;74186
84;74;04;07;188;Montriond;939;24;963;74188
84;74;02;06;189;Mont-Saxonnex;1667;54;1721;74189
84;74;02;06;190;Morillon;676;13;689;74190
84;74;04;07;191;Morzine;2717;74;2791;74191
84;74;01;12;192;Moye;983;37;1020;74192
84;74;03;11;193;La Muraz;1061;11;1072;74193
84;74;01;12;194;Mûres;881;24;905;74194
84;74;03;13;195;Musièges;420;8;428;74195
84;74;02;06;196;Nancy-sur-Cluses;465;15;480;74196
84;74;03;11;197;Nangy;1604;34;1638;74197
84;74;01;03;198;Nâves-Parmelan;1006;40;1046;74198
84;74;04;15;199;Nernier;378;7;385;74199
84;74;04;07;200;Neuvecelle;3122;95;3217;74200
84;74;03;13;201;Neydens;2152;23;2175;74201
84;74;01;01;202;Nonglard;719;8;727;74202
84;74;04;07;203;Novel;49;2;51;74203
84;74;02;05;205;Onnion;1288;29;1317;74205
84;74;04;17;206;Orcier;1030;18;1048;74206
84;74;02;10;208;Passy;11233;423;11656;74208
84;74;02;05;209;Peillonnex;1381;40;1421;74209
84;74;04;17;210;Perrignier;1885;40;1925;74210
84;74;03;11;211;Pers-Jussy;3108;90;3198;74211
84;74;02;05;212;Glières-Val-de-Borne;1814;30;1844;74212
84;74;01;01;213;Poisy;8233;359;8592;74213
84;74;02;14;215;Praz-sur-Arly;1241;36;1277;74215
84;74;03;13;216;Présilly;1054;17;1071;74216
84;74;04;07;218;Publier;7341;213;7554;74218
84;74;01;16;219;Quintal;1252;50;1302;74219
84;74;03;11;220;Reignier-Esery;8072;196;8268;74220
84;74;02;06;221;Le Reposoir;536;21;557;74221
84;74;04;17;222;Reyvroz;504;9;513;74222
84;74;02;06;223;La Rivière-Enverse;470;5;475;74223
84;74;02;11;224;La Roche-sur-Foron;11149;342;11491;74224
84;74;01;12;225;Rumilly;15768;377;16145;74225
84;74;04;15;226;Saint-André-de-BoÃ«ge;575;12;587;74226
84;74;03;11;228;Saint-Blaise;351;12;363;74228
84;74;03;09;229;Saint-Cergues;3671;74;3745;74229
84;74;01;12;231;Saint-Eusèbe;594;14;608;74231
84;74;01;16;232;Saint-Eustache;498;21;519;74232
84;74;01;12;233;Saint-Félix;2418;30;2448;74233
84;74;01;08;234;Saint-Ferréol;876;22;898;74234
84;74;03;13;235;Saint-Germain-sur-Rhône;587;12;599;74235
84;74;02;10;236;Saint-Gervais-les-Bains;5604;130;5734;74236
84;74;04;07;237;Saint-Gingolph;886;4;890;74237
84;74;04;07;238;Saint-Jean-d'Aulps;1558;26;1584;74238
84;74;01;08;239;Saint-Jean-de-Sixt;1461;38;1499;74239
84;74;02;05;240;Saint-Jean-de-Tholome;1007;28;1035;74240
84;74;02;05;241;Saint-Jeoire;3370;101;3471;74241
84;74;01;16;242;Saint-Jorioz;6008;200;6208;74242
84;74;03;13;243;Saint-Julien-en-Genevois;15873;252;16125;74243
84;74;02;11;244;Saint-Laurent;839;34;873;74244
84;74;04;07;249;Saint-Paul-en-Chablais;2487;83;2570;74249
84;74;02;05;250;Saint-Pierre-en-Faucigny;7091;139;7230;74250
84;74;02;06;252;Saint-Sigismond;585;33;618;74252
84;74;02;11;253;Saint-Sixt;1018;38;1056;74253
84;74;01;12;254;Saint-Sylvestre;605;16;621;74254
84;74;01;12;255;Sales;2060;51;2111;74255
84;74;02;14;256;Sallanches;16831;491;17322;74256
84;74;01;01;257;Sallenôves;765;21;786;74257
84;74;02;06;258;SamoÃ«ns;2473;63;2536;74258
84;74;03;11;259;Le Sappey;434;8;442;74259
84;74;03;13;260;Savigny;980;21;1001;74260
84;74;04;15;261;Saxel;484;8;492;74261
84;74;03;11;262;Scientrier;1148;21;1169;74262
84;74;04;15;263;Sciez;6348;144;6492;74263
84;74;02;06;264;Scionzier;8932;138;9070;74264
84;74;01;08;265;Serraval;702;72;774;74265
84;74;02;10;266;Servoz;1057;35;1092;74266
84;74;01;02;267;Sevrier;4139;182;4321;74267
84;74;03;13;269;Seyssel;2351;79;2430;74269
84;74;04;07;271;Seytroux;519;13;532;74271
84;74;01;01;272;Sillingy;5365;130;5495;74272
84;74;02;06;273;Sixt-Fer-Ã -Cheval;759;18;777;74273
84;74;01;08;275;Talloires-Montmin;1948;67;2015;74275
84;74;02;06;276;Taninges;3394;71;3465;74276
84;74;02;06;278;Thyez;6330;150;6480;74278
84;74;04;07;279;Thollon-les-Mémises;831;25;856;74279
84;74;01;08;280;Thônes;6598;284;6882;74280
84;74;04;17;281;Thonon-les-Bains;35826;1147;36973;74281
84;74;01;03;282;Fillière;9449;236;9685;74282
84;74;01;12;283;Thusy;1131;19;1150;74283
84;74;02;05;284;La Tour;1301;25;1326;74284
84;74;03;13;285;Usinens;415;9;424;74285
84;74;04;07;286;Vacheresse;859;17;876;74286
84;74;04;17;287;Vailly;914;20;934;74287
84;74;03;13;288;Valleiry;4935;60;4995;74288
84;74;01;12;289;Vallières-sur-Fier;2562;59;2621;74289
84;74;02;10;290;Vallorcine;406;12;418;74290
84;74;03;13;291;Vanzy;336;4;340;74291
84;74;01;12;292;Vaulx;1022;30;1052;74292
84;74;04;15;293;Veigy-Foncenex;3919;44;3963;74293
84;74;02;06;294;Verchaix;755;20;775;74294
84;74;04;07;295;La Vernaz;343;5;348;74295
84;74;03;13;296;Vers;918;18;936;74296
84;74;01;12;297;Versonnex;610;25;635;74297
84;74;03;09;298;Vétraz-Monthoux;9003;264;9267;74298
84;74;01;08;299;Veyrier-du-Lac;2276;82;2358;74299
84;74;04;15;301;Villard;905;19;924;74301
84;74;01;08;302;Les Villards-sur-Thônes;1071;37;1108;74302
84;74;01;03;303;Villaz;3347;126;3473;74303
84;74;02;05;304;Ville-en-Sallaz;933;10;943;74304
84;74;03;04;305;Ville-la-Grand;9050;119;9169;74305
84;74;03;11;306;Villy-le-Bouveret;594;17;611;74306
84;74;01;11;307;Villy-le-Pelloux;989;16;1005;74307
84;74;04;07;308;Vinzier;844;23;867;74308
84;74;03;13;309;Viry;5415;82;5497;74309
84;74;01;12;310;Viuz-la-Chiésaz;1307;33;1340;74310
84;74;02;05;311;Viuz-en-Sallaz;4454;78;4532;74311
84;74;02;05;312;Vougy;1581;28;1609;74312
84;74;03;11;313;Vovray-en-Bornes;555;11;566;74313
84;74;03;13;314;Vulbens;1630;55;1685;74314
84;74;04;15;315;Yvoire;1067;19;1086;74315
11;75;01;  ;101;Paris 1er Arrondissement;15917;138;16055;75101
11;75;01;  ;102;Paris 2e Arrondissement;21595;140;21735;75102
11;75;01;  ;103;Paris 3e Arrondissement;34025;281;34306;75103
11;75;01;  ;104;Paris 4e Arrondissement;29131;259;29390;75104
11;75;01;  ;105;Paris 5e Arrondissement;58227;670;58897;75105
11;75;01;  ;106;Paris 6e Arrondissement;40303;868;41171;75106
11;75;01;  ;107;Paris 7e Arrondissement;48888;793;49681;75107
11;75;01;  ;108;Paris 8e Arrondissement;35655;595;36250;75108
11;75;01;  ;109;Paris 9e Arrondissement;60026;537;60563;75109
11;75;01;  ;110;Paris 10e Arrondissement;86472;391;86863;75110
11;75;01;  ;111;Paris 11e Arrondissement;145208;820;146028;75111
11;75;01;  ;112;Paris 12e Arrondissement;139297;940;140237;75112
11;75;01;  ;113;Paris 13e Arrondissement;180005;1228;181233;75113
11;75;01;  ;114;Paris 14e Arrondissement;135592;976;136568;75114
11;75;01;  ;115;Paris 15e Arrondissement;230981;1687;232668;75115
11;75;01;  ;116;Paris 16e Arrondissement;165523;2254;167777;75116
11;75;01;  ;117;Paris 17e Arrondissement;166543;1432;167975;75117
11;75;01;  ;118;Paris 18e Arrondissement;192468;820;193288;75118
11;75;01;  ;119;Paris 19e Arrondissement;184573;998;185571;75119
11;75;01;  ;120;Paris 20e Arrondissement;194994;924;195918;75120
28;76;03;35;001;Allouville-Bellefosse;1158;19;1177;76001
28;76;02;33;002;Alvimare;622;9;631;76002
28;76;01;07;004;Ambrumesnil;468;14;482;76004
28;76;03;06;005;Amfreville-la-Mi-Voie;3306;31;3337;76005
28;76;03;35;006;Amfreville-les-Champs;173;4;177;76006
28;76;03;02;007;Anceaumeville;675;10;685;76007
28;76;01;08;008;Ancourt;630;10;640;76008
28;76;01;33;009;Ancourteville-sur-Héricourt;344;4;348;76009
28;76;03;35;010;Ancretiéville-Saint-Victor;373;6;379;76010
28;76;02;11;011;Ancretteville-sur-Mer;152;4;156;76011
28;76;02;32;012;Angerville-Bailleul;185;3;188;76012
28;76;02;11;013;Angerville-la-Martel;1078;30;1108;76013
28;76;02;26;014;Angerville-l'Orcher;1405;15;1420;76014
28;76;01;33;015;Angiens;512;11;523;76015
28;76;01;33;016;Anglesqueville-la-Bras-Long;121;2;123;76016
28;76;02;26;017;Anglesqueville-l'Esneval;648;6;654;76017
28;76;01;20;018;Val-de-Saâne;1491;33;1524;76018
28;76;01;20;019;Anneville-sur-Scie;424;10;434;76019
28;76;03;01;020;Anneville-Ambourville;1189;23;1212;76020
28;76;02;32;021;Annouville-Vilmesnil;467;7;474;76021
28;76;03;25;022;Anquetierville;338;13;351;76022
28;76;03;35;023;Anvéville;300;5;305;76023
28;76;01;23;024;Ardouval;157;4;161;76024
28;76;01;12;025;Argueil;344;8;352;76025
28;76;01;08;026;Arques-la-Bataille;2573;52;2625;76026
28;76;01;12;028;Aubéguimont;187;1;188;76028
28;76;01;10;029;Aubermesnil-aux-Erables;199;3;202;76029
28;76;01;07;030;Aubermesnil-Beaumais;503;3;506;76030
28;76;01;33;032;Auberville-la-Manuel;138;1;139;76032
28;76;02;32;033;Auberville-la-Renault;458;6;464;76033
28;76;01;20;034;Val-de-Scie;2535;22;2557;76034
28;76;01;12;035;Aumale;1986;53;2039;76035
28;76;01;20;036;Auppegard;692;19;711;76036
28;76;03;02;038;Authieux-Ratiéville;399;3;402;76038
28;76;03;06;039;Les Authieux-sur-le-Port-Saint-Ouen;1261;26;1287;76039
28;76;01;33;040;Autigny;308;0;308;76040
28;76;03;35;041;Les Hauts-de-Caux;1349;36;1385;76041
28;76;01;23;042;Auvilliers;102;0;102;76042
28;76;03;35;043;Auzebosc;1130;361;1491;76043
28;76;03;35;045;Auzouville-l'Esneval;358;9;367;76045
28;76;03;21;046;Auzouville-sur-Ry;702;12;714;76046
28;76;01;20;047;Auzouville-sur-Saâne;150;1;151;76047
28;76;01;12;048;Avesnes-en-Bray;297;6;303;76048
28;76;01;23;049;Avesnes-en-Val;280;6;286;76049
28;76;01;20;050;Avremesnil;1011;27;1038;76050
28;76;01;20;051;Bacqueville-en-Caux;1910;39;1949;76051
28;76;01;23;052;Bailleul-Neuville;221;1;222;76052
28;76;01;23;053;Baillolet;108;1;109;76053
28;76;01;08;054;Bailly-en-Rivière;522;4;526;76054
28;76;03;35;055;Baons-le-Comte;337;17;354;76055
28;76;03;01;056;Bardouville;632;6;638;76056
28;76;03;01;057;Barentin;12398;229;12627;76057
28;76;01;10;058;Baromesnil;218;5;223;76058
28;76;01;10;059;Bazinval;417;11;428;76059
28;76;01;12;060;Beaubec-la-Rosière;497;13;510;76060
28;76;03;23;062;Beaumont-le-Hareng;261;3;264;76062
28;76;01;20;063;Beauval-en-Caux;472;10;482;76063
28;76;02;26;064;Beaurepaire;492;13;505;76064
28;76;01;12;065;Beaussault;411;4;415;76065
28;76;01;20;066;Beautot;149;4;153;76066
28;76;01;12;067;Beauvoir-en-Lyons;604;14;618;76067
28;76;02;32;068;Bec-de-Mortagne;643;17;660;76068
28;76;03;06;069;Belbeuf;2235;52;2287;76069
28;76;01;23;070;Bellencombre;624;10;634;76070
28;76;01;08;071;Bellengreville;474;8;482;76071
28;76;01;20;072;Belleville-en-Caux;738;12;750;76072
28;76;01;12;074;La Bellière;54;0;54;76074
28;76;01;20;075;Belmesnil;452;2;454;76075
28;76;02;32;076;Bénarville;267;5;272;76076
28;76;03;35;077;Bénesville;178;5;183;76077
28;76;02;26;079;Bénouville;189;1;190;76079
28;76;02;03;082;Bernières;637;6;643;76082
28;76;01;33;083;Bertheauville;99;1;100;76083
28;76;01;33;084;Bertreville;122;1;123;76084
28;76;01;20;085;Bertreville-Saint-Ouen;339;10;349;76085
28;76;01;20;086;Bertrimont;216;5;221;76086
28;76;03;35;087;Berville-en-Caux;680;10;690;76087
28;76;03;01;088;Berville-sur-Seine;545;9;554;76088
28;76;02;03;090;Beuzeville-la-Grenier;1244;17;1261;76090
28;76;01;33;091;Beuzeville-la-Guérard;228;2;230;76091
28;76;02;03;092;Beuzevillette;634;10;644;76092
28;76;01;12;093;Bézancourt;357;13;370;76093
28;76;03;21;094;Bierville;325;3;328;76094
28;76;03;02;095;Bihorel;8264;166;8430;76095
28;76;01;20;096;Biville-la-Baignarde;662;12;674;76096
28;76;01;20;097;Biville-la-Rivière;106;0;106;76097
28;76;03;01;099;Blacqueville;723;9;732;76099
28;76;03;21;100;Blainville-Crevon;1222;17;1239;76100
28;76;01;10;101;Blangy-sur-Bresle;2907;34;2941;76101
28;76;03;06;103;Bonsecours;6479;106;6585;76103
28;76;01;33;104;Blosseville;252;14;266;76104
28;76;03;02;105;Le Bocasse;659;7;666;76105
28;76;03;21;106;Bois-d'Ennebourg;556;7;563;76106
28;76;03;21;107;Bois-Guilbert;299;4;303;76107
28;76;03;02;108;Bois-Guillaume;14592;404;14996;76108
28;76;03;21;109;Bois-Héroult;182;4;186;76109
28;76;03;35;110;Bois-Himont;472;5;477;76110
28;76;03;21;111;Bois-l'Evêque;601;10;611;76111
28;76;01;20;112;Le Bois-Robert;353;8;361;76112
28;76;03;21;113;Boissay;406;6;412;76113
28;76;02;03;114;Bolbec;11610;136;11746;76114
28;76;02;25;115;Bolleville;581;3;584;76115
28;76;03;21;116;Boos;3923;46;3969;76116
28;76;02;26;117;Bordeaux-Saint-Clair;651;20;671;76117
28;76;02;32;118;Bornambusc;251;8;259;76118
28;76;01;23;119;Bosc-Bérenger;200;2;202;76119
28;76;03;21;120;Bosc-Bordel;452;10;462;76120
28;76;03;21;121;Bosc-Edeline;364;3;367;76121
28;76;01;23;122;Callengeville;509;8;517;76122
28;76;03;02;123;Bosc-Guérard-Saint-Adrien;1028;28;1056;76123
28;76;01;12;124;Bosc-Hyons;434;8;442;76124
28;76;03;23;125;Bosc-le-Hard;1532;19;1551;76125
28;76;01;23;126;Bosc-Mesnil;317;6;323;76126
28;76;01;33;128;Bosville;585;15;600;76128
28;76;03;35;129;Boudeville;206;6;212;76129
28;76;01;23;130;Bouelles;289;3;292;76130
28;76;03;09;131;La Bouille;722;10;732;76131
28;76;03;35;132;Bourdainville;465;2;467;76132
28;76;01;33;133;Le Bourg-Dun;431;9;440;76133
28;76;01;33;134;Bourville;300;4;304;76134
28;76;03;01;135;Bouville;987;13;1000;76135
28;76;01;20;136;Brachy;723;11;734;76136
28;76;01;23;138;Bracquetuit;329;5;334;76138
28;76;01;23;139;Bradiancourt;220;3;223;76139
28;76;01;33;140;Brametot;199;2;201;76140
28;76;02;32;141;Bréauté;1359;13;1372;76141
28;76;01;12;142;Brémontier-Merval;454;126;580;76142
28;76;02;32;143;Bretteville-du-Grand-Caux;1360;22;1382;76143
28;76;03;35;144;Bretteville-Saint-Laurent;154;2;156;76144
28;76;03;21;146;Buchy;2840;102;2942;76146
28;76;01;23;147;Bully;913;23;936;76147
28;76;01;23;148;Bures-en-Bray;326;4;330;76148
28;76;03;35;149;Butot;284;5;289;76149
28;76;01;33;151;Cailleville;262;10;272;76151
28;76;03;21;152;Cailly;763;4;767;76152
28;76;01;20;153;Calleville-les-Deux-Eglises;324;3;327;76153
28;76;01;10;154;Campneuseville;475;12;487;76154
28;76;01;10;155;Canehan;377;3;380;76155
28;76;01;33;156;Canouville;342;9;351;76156
28;76;03;04;157;Canteleu;13846;373;14219;76157
28;76;03;35;158;Canville-les-Deux-Eglises;326;2;328;76158
28;76;01;33;159;Cany-Barville;3046;56;3102;76159
28;76;03;24;160;Carville-la-Folletière;417;10;427;76160
28;76;03;35;161;Carville-Pot-de-Fer;100;3;103;76161
28;76;01;20;162;Le Catelier;270;5;275;76162
28;76;03;21;163;Catenay;672;10;682;76163
28;76;03;25;164;Rives-en-Seine;4148;66;4214;76164
28;76;03;05;165;Caudebec-lès-Elbeuf;9949;67;10016;76165
28;76;01;12;166;Le Caule-Sainte-Beuve;482;4;486;76166
28;76;02;26;167;Cauville-sur-Mer;1594;27;1621;76167
28;76;01;20;168;Les Cent-Acres;65;1;66;76168
28;76;02;32;169;La Cerlangue;1276;114;1390;76169
28;76;01;20;170;La Chapelle-du-Bourgay;118;1;119;76170
28;76;01;12;171;La Chapelle-Saint-Ouen;135;1;136;76171
28;76;01;33;172;La Chapelle-sur-Dun;158;3;161;76172
28;76;01;20;173;La Chaussée;542;6;548;76173
28;76;03;35;174;Cideville;404;5;409;76174
28;76;01;23;175;Clais;260;7;267;76175
28;76;01;33;176;Clasville;343;7;350;76176
28;76;03;02;177;Claville-Motteville;284;6;290;76177
28;76;03;05;178;Cléon;4924;25;4949;76178
28;76;03;02;179;Clères;1377;16;1393;76179
28;76;01;33;180;Cleuville;190;8;198;76180
28;76;02;33;181;Cléville;154;2;156;76181
28;76;02;33;182;Cliponville;262;2;264;76182
28;76;02;11;183;Colleville;763;19;782;76183
28;76;01;07;184;Colmesnil-Manneville;109;3;112;76184
28;76;01;12;185;Compainville;166;4;170;76185
28;76;01;12;186;Conteville;496;3;499;76186
28;76;02;11;187;Contremoulins;162;3;165;76187
28;76;03;23;188;Cottévrard;476;4;480;76188
28;76;01;33;189;Crasville-la-Mallet;153;6;159;76189
28;76;01;33;190;Crasville-la-Rocquefort;208;3;211;76190
28;76;01;10;192;Criel-sur-Mer;2630;54;2684;76192
28;76;01;23;193;La Crique;341;5;346;76193
28;76;02;11;194;Criquebeuf-en-Caux;402;3;405;76194
28;76;02;11;195;Criquetot-le-Mauconduit;177;1;178;76195
28;76;02;26;196;Criquetot-l'Esneval;2562;90;2652;76196
28;76;01;20;197;Criquetot-sur-Longueville;221;2;223;76197
28;76;03;35;198;Criquetot-sur-Ouville;802;19;821;76198
28;76;01;12;199;Criquiers;691;10;701;76199
28;76;01;23;200;Critot;458;12;470;76200
28;76;01;12;201;Croisy-sur-Andelle;534;4;538;76201
28;76;01;23;202;Croixdalle;318;4;322;76202
28;76;03;24;203;Croix-Mare;757;7;764;76203
28;76;01;23;204;Cropus;254;1;255;76204
28;76;01;20;205;Crosville-sur-Scie;248;2;250;76205
28;76;02;26;206;Cuverville;345;5;350;76206
28;76;01;10;207;Cuverville-sur-Yères;196;6;202;76207
28;76;01;12;208;Cuy-Saint-Fiacre;665;17;682;76208
28;76;01;12;209;Dampierre-en-Bray;442;8;450;76209
28;76;01;08;210;Dampierre-Saint-Nicolas;460;2;462;76210
28;76;01;10;211;Dancourt;231;2;233;76211
28;76;03;06;212;Darnétal;9788;84;9872;76212
28;76;02;32;213;Daubeuf-Serville;401;9;410;76213
28;76;01;20;214;Dénestanville;265;1;266;76214
28;76;03;22;216;Déville-lès-Rouen;10654;75;10729;76216
28;76;01;95;217;Dieppe;28241;468;28709;76217
28;76;01;12;218;Doudeauville;98;2;100;76218
28;76;03;35;219;Doudeville;2477;45;2522;76219
28;76;01;08;220;Douvrend;523;12;535;76220
28;76;01;33;221;Drosay;194;5;199;76221
28;76;03;01;222;Duclair;4073;53;4126;76222
28;76;03;24;223;Ecalles-Alix;514;6;520;76223
28;76;02;32;224;Ecrainville;977;19;996;76224
28;76;03;35;225;Ecretteville-lès-Baons;377;12;389;76225
28;76;02;11;226;Ecretteville-sur-Mer;163;2;165;76226
28;76;03;35;227;Ectot-l'Auber;698;11;709;76227
28;76;03;35;228;Ectot-lès-Baons;392;7;399;76228
28;76;01;12;229;Elbeuf-en-Bray;406;14;420;76229
28;76;03;21;230;Elbeuf-sur-Andelle;475;6;481;76230
28;76;03;09;231;Elbeuf;16224;126;16350;76231
28;76;02;11;232;Eletot;643;9;652;76232
28;76;01;12;233;Ellecourt;151;4;155;76233
28;76;03;24;234;Emanville;712;11;723;76234
28;76;01;08;235;Envermeu;2022;155;2177;76235
28;76;02;33;236;Envronville;349;1;350;76236
28;76;03;01;237;Epinay-sur-Duclair;509;8;517;76237
28;76;02;26;238;Epouville;2654;39;2693;76238
28;76;02;32;239;Epretot;776;14;790;76239
28;76;02;11;240;Epreville;1013;13;1026;76240
28;76;01;33;241;Ermenouville;139;6;145;76241
28;76;01;12;242;Ernemont-la-Villette;195;4;199;76242
28;76;03;21;243;Ernemont-sur-Buchy;294;2;296;76243
28;76;01;23;244;Esclavelles;385;6;391;76244
28;76;03;24;245;Eslettes;1619;16;1635;76245
28;76;03;02;247;Esteville;495;4;499;76247
28;76;01;20;249;Etaimpuis;827;11;838;76249
28;76;02;32;250;Etainhus;1205;27;1232;76250
28;76;03;35;251;Etalleville;442;3;445;76251
28;76;01;10;252;Etalondes;1036;28;1064;76252
28;76;03;35;253;Etoutteville;826;14;840;76253
28;76;02;26;254;Etretat;1237;6;1243;76254
28;76;01;10;255;Eu;6716;200;6916;76255
28;76;01;10;257;Fallencourt;183;2;185;76257
28;76;02;33;258;Terres-de-Caux;4193;112;4305;76258
28;76;02;11;259;Fécamp;18041;288;18329;76259
28;76;01;12;260;Ferrières-en-Bray;1675;19;1694;76260
28;76;01;12;261;La Ferté-Saint-Samson;458;11;469;76261
28;76;01;23;262;Fesques;134;2;136;76262
28;76;01;12;263;La Feuillie;1289;22;1311;76263
28;76;03;35;264;Flamanville;484;11;495;76264
28;76;01;23;265;Flamets-Frétils;163;8;171;76265
28;76;01;10;266;Flocques;705;15;720;76266
28;76;02;26;268;Fongueusemare;185;5;190;76268
28;76;01;23;269;Fontaine-en-Bray;173;3;176;76269
28;76;02;26;270;Fontaine-la-Mallet;2633;53;2686;76270
28;76;03;02;271;Fontaine-le-Bourg;1809;18;1827;76271
28;76;01;33;272;Fontaine-le-Dun;899;17;916;76272
28;76;03;06;273;Fontaine-sous-Préaux;541;15;556;76273
28;76;01;20;274;La Fontelaye;28;0;28;76274
28;76;02;26;275;Fontenay;1521;24;1545;76275
28;76;01;12;276;Forges-les-Eaux;3812;198;4010;76276
28;76;01;10;278;Foucarmont;797;13;810;76278
28;76;02;33;279;Foucart;359;10;369;76279
28;76;01;23;280;Fréauville;132;1;133;76280
28;76;02;25;281;La Frénaye;2093;45;2138;76281
28;76;03;05;282;Freneuse;953;9;962;76282
28;76;01;23;283;Fresles;238;4;242;76283
28;76;01;20;284;Fresnay-le-Long;331;5;336;76284
28;76;03;21;285;Fresne-le-Plan;574;8;582;76285
28;76;01;23;286;Fresnoy-Folny;672;7;679;76286
28;76;03;24;287;Fresquiennes;1017;13;1030;76287
28;76;01;08;288;Freulleville;364;4;368;76288
28;76;03;24;289;Saint Martin de l'If;1726;24;1750;76289
28;76;03;02;290;Frichemesnil;398;11;409;76290
28;76;02;11;291;Froberville;1194;26;1220;76291
28;76;01;12;292;Fry;144;3;147;76292
28;76;03;35;293;Fultot;236;0;236;76293
28;76;01;33;294;La Gaillarde;384;8;392;76294
28;76;01;12;295;Gaillefontaine;1224;9;1233;76295
28;76;02;16;296;Gainneville;2526;31;2557;76296
28;76;01;12;297;Gancourt-Saint-Etienne;230;7;237;76297
28;76;02;11;298;Ganzeville;468;5;473;76298
28;76;02;11;299;Gerponville;391;4;395;76299
28;76;02;11;300;Gerville;431;4;435;76300
28;76;02;32;302;Goderville;2864;41;2905;76302
28;76;02;32;303;Gommerville;729;9;738;76303
28;76;02;32;304;Gonfreville-Caillot;369;1;370;76304
28;76;02;16;305;Gonfreville-l'Orcher;9124;59;9183;76305
28;76;01;20;306;Gonnetot;178;2;180;76306
28;76;02;26;307;Gonneville-la-Mallet;1371;20;1391;76307
28;76;01;20;308;Gonneville-sur-Scie;503;8;511;76308
28;76;03;35;309;Gonzeville;123;2;125;76309
28;76;03;24;311;Goupillières;425;5;430;76311
28;76;01;12;312;Gournay-en-Bray;6041;97;6138;76312
28;76;03;06;313;Gouy;888;14;902;76313
28;76;02;32;314;Graimbouville;615;9;624;76314
28;76;01;33;315;Grainville-la-Teinturière;1077;18;1095;76315
28;76;03;21;316;Grainville-sur-Ry;442;4;446;76316
28;76;02;32;317;Grainville-Ymauville;433;12;445;76317
28;76;02;25;318;Grand-Camp;737;27;764;76318
28;76;03;09;319;Grand-Couronne;9739;191;9930;76319
28;76;01;23;320;Grandcourt;328;4;332;76320
28;76;01;23;321;Les Grandes-Ventes;1783;27;1810;76321
28;76;03;13;322;Le Grand-Quevilly;25963;250;26213;76322
28;76;01;23;323;Graval;155;2;157;76323
28;76;01;08;324;Grèges;848;15;863;76324
28;76;03;35;325;Grémonville;438;5;443;76325
28;76;01;20;327;Greuville;374;5;379;76327
28;76;03;23;328;Grigneuseville;375;5;380;76328
28;76;02;03;329;Gruchet-le-Valasse;3175;37;3212;76329
28;76;01;20;330;Gruchet-Saint-Siméon;686;20;706;76330
28;76;03;02;331;Grugny;1008;5;1013;76331
28;76;01;12;332;Grumesnil;423;2;425;76332
28;76;01;10;333;Guerville;464;5;469;76333
28;76;01;20;334;Gueures;528;19;547;76334
28;76;01;20;335;Gueutteville;88;0;88;76335
28;76;01;33;336;Gueutteville-les-Grès;377;11;388;76336
28;76;01;12;338;La Hallotière;224;1;225;76338
28;76;01;33;339;Le Hanouard;257;3;260;76339
28;76;03;35;340;Harcanville;523;7;530;76340
28;76;02;15;341;Harfleur;8349;65;8414;76341
28;76;02;33;342;Hattenville;715;17;732;76342
28;76;01;12;343;Haucourt;193;4;197;76343
28;76;01;12;344;Haudricourt;407;10;417;76344
28;76;01;12;345;Haussez;281;2;283;76345
28;76;01;33;346;Hautot-l'Auvray;316;8;324;76346
28;76;03;35;347;Hautot-le-Vatois;356;6;362;76347
28;76;03;35;348;Hautot-Saint-Sulpice;687;8;695;76348
28;76;01;07;349;Hautot-sur-Mer;1891;71;1962;76349
28;76;03;04;350;Hautot-sur-Seine;399;7;406;76350
28;76;02;96;351;Le Havre;168290;1830;170120;76351
28;76;01;12;352;La Haye;372;3;375;76352
28;76;01;33;353;Héberville;107;6;113;76353
28;76;03;01;354;Hénouville;1323;14;1337;76354
28;76;03;35;355;Héricourt-en-Caux;950;13;963;76355
28;76;01;20;356;Hermanville;115;2;117;76356
28;76;02;26;357;Hermeville;355;16;371;76357
28;76;01;12;358;Le Héron;247;1;248;76358
28;76;03;21;359;Héronchelles;143;2;145;76359
28;76;01;20;360;Heugleville-sur-Scie;634;8;642;76360
28;76;02;26;361;Heuqueville;715;10;725;76361
28;76;03;25;362;Heurteauville;299;7;306;76362
28;76;01;10;363;Hodeng-au-Bosc;575;8;583;76363
28;76;01;12;364;Hodeng-Hodenger;272;5;277;76364
28;76;01;33;365;Houdetot;187;0;187;76365
28;76;03;24;366;Le Houlme;4107;29;4136;76366
28;76;03;24;367;Houppeville;2907;47;2954;76367
28;76;02;32;368;Houquetot;338;6;344;76368
28;76;03;02;369;La Houssaye-Béranger;534;7;541;76369
28;76;03;35;370;Hugleville-en-Caux;427;3;430;76370
28;76;01;08;371;Les Ifs;71;0;71;76371
28;76;01;12;372;Illois;410;3;413;76372
28;76;01;20;373;Imbleville;305;6;311;76373
28;76;01;10;374;Incheville;1234;15;1249;76374
28;76;01;33;375;Ingouville;274;14;288;76375
28;76;03;02;377;Isneauville;3546;72;3618;76377
28;76;03;01;378;Jumièges;1704;34;1738;76378
28;76;01;20;379;Lamberville;192;2;194;76379
28;76;01;20;380;Lammerville;316;8;324;76380
28;76;01;12;381;Landes-Vieilles-et-Neuves;131;1;132;76381
28;76;02;03;382;Lanquetot;1161;13;1174;76382
28;76;01;20;383;Lestanville;96;0;96;76383
28;76;02;03;384;Lillebonne;8797;145;8942;76384
28;76;03;24;385;Limésy;1496;53;1549;76385
28;76;02;11;386;Limpiville;380;6;386;76386
28;76;03;35;387;Lindebeuf;389;7;396;76387
28;76;02;25;388;Lintot;472;3;475;76388
28;76;01;20;389;Lintot-les-Bois;187;7;194;76389
28;76;02;11;390;Les Loges;1106;21;1127;76390
28;76;03;09;391;La Londe;2338;66;2404;76391
28;76;01;23;392;Londinières;1264;14;1278;76392
28;76;01;12;393;Longmesnil;49;0;49;76393
28;76;01;10;394;Longroy;630;5;635;76394
28;76;01;07;395;Longueil;561;11;572;76395
28;76;03;21;396;Longuerue;334;2;336;76396
28;76;01;20;397;Longueville-sur-Scie;992;25;1017;76397
28;76;03;25;398;Louvetot;747;6;753;76398
28;76;01;23;399;Lucy;196;1;197;76399
28;76;01;20;400;Luneray;2169;36;2205;76400
28;76;03;25;401;Arelaune-en-Seine;2522;44;2566;76401
28;76;03;24;402;Malaunay;6143;48;6191;76402
28;76;01;33;403;Malleville-les-Grès;204;3;207;76403
28;76;02;26;404;Manéglise;1228;22;1250;76404
28;76;01;20;405;Manéhouville;224;1;225;76405
28;76;02;11;406;Maniquerville;421;6;427;76406
28;76;01;33;407;Manneville-ès-Plains;304;8;312;76407
28;76;02;32;408;Manneville-la-Goupil;1035;14;1049;76408
28;76;02;26;409;Mannevillette;892;13;905;76409
28;76;03;04;410;Maromme;10663;135;10798;76410
28;76;01;12;411;Marques;233;1;234;76411
28;76;03;21;412;Martainville-Epreville;714;11;725;76412
28;76;01;07;413;Martigny;426;6;432;76413
28;76;01;08;414;Martin-Eglise;1603;51;1654;76414
28;76;01;23;415;Massy;334;5;339;76415
28;76;01;23;416;Mathonville;327;5;332;76416
28;76;01;23;417;Maucomble;415;3;418;76417
28;76;03;25;418;Maulévrier-Sainte-Gertrude;1000;20;1020;76418
28;76;03;01;419;Mauny;164;6;170;76419
28;76;01;12;420;Mauquenchy;358;6;364;76420
28;76;02;03;421;Mélamare;922;14;936;76421
28;76;01;10;422;Melleville;266;8;274;76422
28;76;01;12;423;Ménerval;168;2;170;76423
28;76;01;23;424;Ménonval;228;1;229;76424
28;76;02;32;425;Mentheville;293;5;298;76425
28;76;01;12;426;Mésangueville;161;1;162;76426
28;76;01;23;427;Mesnières-en-Bray;937;249;1186;76427
28;76;01;33;428;Le Mesnil-Durdent;17;3;20;76428
28;76;03;21;429;Le Mesnil-Esnard;7886;341;8227;76429
28;76;01;23;430;Mesnil-Follemprise;120;3;123;76430
28;76;01;12;431;Le Mesnil-Lieubray;97;3;100;76431
28;76;01;12;432;Mesnil-Mauger;245;4;249;76432
28;76;03;24;433;Mesnil-Panneville;729;7;736;76433
28;76;03;21;434;Mesnil-Raoul;1090;7;1097;76434
28;76;01;10;435;Le Mesnil-Réaume;793;16;809;76435
28;76;03;01;436;Le Mesnil-sous-Jumièges;619;4;623;76436
28;76;01;08;437;Meulers;553;5;558;76437
28;76;01;10;438;Millebosc;244;5;249;76438
28;76;02;03;439;Mirville;342;9;351;76439
28;76;01;12;440;Molagnies;197;4;201;76440
28;76;01;10;441;Monchaux-Soreng;633;11;644;76441
28;76;01;10;442;Monchy-sur-Eu;591;9;600;76442
28;76;03;02;443;Mont-Cauvaire;840;16;856;76443
28;76;01;23;445;Montérolier;600;7;607;76445
28;76;03;24;446;Montigny;1271;17;1288;76446
28;76;02;15;447;Montivilliers;15470;235;15705;76447
28;76;03;21;448;Montmain;1346;29;1375;76448
28;76;01;20;449;Montreuil-en-Caux;500;8;508;76449
28;76;01;12;450;Montroty;271;26;297;76450
28;76;03;22;451;Mont-Saint-Aignan;19357;375;19732;76451
28;76;03;02;452;Montville;4563;51;4614;76452
28;76;03;21;453;Morgny-la-Pommeraye;1076;20;1096;76453
28;76;01;23;454;Mortemer;83;0;83;76454
28;76;01;12;455;Morville-sur-Andelle;316;5;321;76455
28;76;03;35;456;Motteville;765;11;776;76456
28;76;03;09;457;Moulineaux;928;17;945;76457
28;76;01;20;458;Muchedent;127;3;130;76458
28;76;01;23;459;Nesle-Hodeng;349;5;354;76459
28;76;01;10;460;Nesle-Normandeuse;513;8;521;76460
28;76;01;23;461;Neufbosc;400;5;405;76461
28;76;01;23;462;Neufchâtel-en-Bray;4678;209;4887;76462
28;76;01;12;463;Neuf-Marché;667;22;689;76463
28;76;03;21;464;La Neuville-Chant-d'Oisel;2378;37;2415;76464
28;76;01;23;465;Neuville-Ferrières;571;6;577;76465
28;76;01;33;467;Néville;1329;19;1348;76467
28;76;02;03;468;Nointot;1360;33;1393;76468
28;76;01;12;469;Nolléval;432;5;437;76469
28;76;01;33;470;Normanville;659;24;683;76470
28;76;02;25;471;Norville;1001;27;1028;76471
28;76;01;08;472;Notre-Dame-d'Aliermont;774;2;776;76472
28;76;03;25;473;Notre-Dame-de-Bliquetuit;790;10;800;76473
28;76;03;24;474;Notre-Dame-de-Bondeville;6978;83;7061;76474
28;76;03;21;475;Franqueville-Saint-Pierre;6105;194;6299;76475
28;76;02;25;476;Port-Jérôme-sur-Seine;10248;185;10433;76476
28;76;02;26;477;Notre-Dame-du-Bec;453;7;460;76477
28;76;01;20;478;Notre-Dame-du-Parc;186;1;187;76478
28;76;01;12;479;Nullemont;132;1;133;76479
28;76;01;33;480;Ocqueville;451;11;462;76480
28;76;02;26;481;Octeville-sur-Mer;6018;122;6140;76481
28;76;01;07;482;Offranville;3143;228;3371;76482
28;76;01;33;483;Oherville;227;2;229;76483
28;76;03;31;484;Oissel;12241;58;12299;76484
28;76;01;20;485;Omonville;270;46;316;76485
28;76;03;09;486;Orival;897;4;901;76486
28;76;01;23;487;Osmoy-Saint-Valery;314;6;320;76487
28;76;01;33;488;Ouainville;507;16;523;76488
28;76;02;32;489;Oudalle;417;10;427;76489
28;76;01;33;490;Ourville-en-Caux;1130;13;1143;76490
28;76;03;35;491;Ouville-l'Abbaye;662;6;668;76491
28;76;01;07;492;Ouville-la-Rivière;465;16;481;76492
28;76;01;33;493;Paluel;407;12;419;76493
28;76;02;03;494;Parc-d'Anxtot;585;7;592;76494
28;76;03;24;495;Pavilly;6212;51;6263;76495
28;76;03;13;497;Petit-Couronne;8693;175;8868;76497
28;76;03;27;498;Le Petit-Quevilly;22000;275;22275;76498
28;76;02;25;499;Petiville;1126;29;1155;76499
28;76;01;10;500;Pierrecourt;478;4;482;76500
28;76;02;26;501;Pierrefiques;135;7;142;76501
28;76;03;21;502;Pierreval;551;9;560;76502
28;76;03;24;503;Pissy-Pôville;1276;20;1296;76503
28;76;01;33;504;Pleine-Sève;128;2;130;76504
28;76;01;12;505;Pommereux;95;1;96;76505
28;76;01;23;506;Pommeréval;488;4;492;76506
28;76;01;10;507;Ponts-et-Marais;816;15;831;76507
28;76;02;26;508;La Poterie-Cap-d'Antifer;453;15;468;76508
28;76;03;21;509;Préaux;1836;31;1867;76509
28;76;03;35;510;Prétot-Vicquemare;237;3;240;76510
28;76;01;23;511;Preuseville;154;1;155;76511
28;76;01;23;512;Puisenval;24;0;24;76512
28;76;03;01;513;Quevillon;589;15;604;76513
28;76;03;06;514;Quévreville-la-Poterie;1025;13;1038;76514
28;76;01;07;515;Quiberville;541;14;555;76515
28;76;01;23;516;Quièvrecourt;423;19;442;76516
28;76;03;02;517;Quincampoix;3097;88;3185;76517
28;76;02;03;518;Raffetot;504;9;513;76518
28;76;01;20;519;Rainfreville;73;4;77;76519
28;76;01;10;520;Réalcamp;606;13;619;76520
28;76;03;21;521;Rebets;147;1;148;76521
28;76;02;32;522;La Remuée;1277;24;1301;76522
28;76;01;10;523;Rétonval;184;3;187;76523
28;76;03;35;524;Reuville;134;2;136;76524
28;76;01;08;526;Ricarville-du-Val;180;7;187;76526
28;76;01;12;527;Richemont;441;3;444;76527
28;76;01;10;528;Rieux;609;11;620;76528
28;76;02;11;529;Riville;294;12;306;76529
28;76;03;35;530;Robertot;222;5;227;76530
28;76;03;33;531;Rocquefort;319;8;327;76531
28;76;01;23;532;Rocquemont;793;18;811;76532
28;76;02;16;533;Rogerville;1574;17;1591;76533
28;76;02;26;534;Rolleville;1186;18;1204;76534
28;76;01;12;535;Roncherolles-en-Bray;461;8;469;76535
28;76;03;06;536;Roncherolles-sur-le-Vivier;1209;22;1231;76536
28;76;01;12;537;Ronchois;184;6;190;76537
28;76;01;23;538;Rosay;266;5;271;76538
28;76;03;97;540;Rouen;112321;1613;113934;76540
28;76;03;24;541;Roumare;1524;27;1551;76541
28;76;03;35;542;Routes;278;4;282;76542
28;76;02;03;543;Rouville;605;11;616;76543
28;76;01;12;544;Rouvray-Catillon;225;8;233;76544
28;76;01;07;545;Rouxmesnil-Bouteilles;1809;42;1851;76545
28;76;01;20;546;Royville;298;7;305;76546
28;76;03;21;547;La Rue-Saint-Pierre;780;9;789;76547
28;76;03;21;548;Ry;744;15;759;76548
28;76;01;20;549;Saâne-Saint-Just;146;6;152;76549
28;76;03;04;550;Sahurs;1205;24;1229;76550
28;76;02;32;551;Sainneville;850;11;861;76551
28;76;02;19;552;Sainte-Adresse;7317;259;7576;76552
28;76;01;23;553;Sainte-Agathe-d'Aliermont;302;5;307;76553
28;76;03;21;554;Saint-Aignan-sur-Ry;355;2;357;76554
28;76;03;21;555;Saint-André-sur-Cailly;833;20;853;76555
28;76;02;03;556;Saint-Antoine-la-Forêt;1091;21;1112;76556
28;76;03;25;557;Saint-Arnoult;1444;21;1465;76557
28;76;03;06;558;Saint-Aubin-Celloville;1176;6;1182;76558
28;76;03;25;559;Saint-Aubin-de-Crétot;512;8;520;76559
28;76;03;06;560;Saint-Aubin-Epinay;1024;16;1040;76560
28;76;03;05;561;Saint-Aubin-lès-Elbeuf;8429;76;8505;76561
28;76;01;08;562;Saint-Aubin-le-Cauf;841;18;859;76562
28;76;02;32;563;Saint-Aubin-Routot;1917;14;1931;76563
28;76;01;33;564;Saint-Aubin-sur-Mer;165;3;168;76564
28;76;01;07;565;Saint-Aubin-sur-Scie;1160;99;1259;76565
28;76;03;24;566;Sainte-Austreberthe;624;5;629;76566
28;76;01;23;567;Sainte-Beuve-en-Rivière;178;5;183;76567
28;76;03;35;568;Saint-Clair-sur-les-Monts;606;12;618;76568
28;76;01;33;569;Sainte-Colombe;222;4;226;76569
28;76;01;20;570;Saint-Crespin;308;4;312;76570
28;76;03;21;571;Sainte-Croix-sur-Buchy;692;4;696;76571
28;76;01;07;572;Saint-Denis-d'Aclon;126;5;131;76572
28;76;03;21;573;Saint-Denis-le-Thiboult;502;14;516;76573
28;76;01;20;574;Saint-Denis-sur-Scie;693;4;697;76574
28;76;03;98;575;Saint-Etienne-du-Rouvray;28352;221;28573;76575
28;76;02;03;576;Saint-Eustache-la-Forêt;1208;17;1225;76576
28;76;01;20;577;Sainte-Foy;620;13;633;76577
28;76;01;23;578;Sainte-Geneviève;269;4;273;76578
28;76;03;02;580;Saint-Georges-sur-Fontaine;904;19;923;76580
28;76;03;21;581;Saint-Germain-des-Essourts;391;9;400;76581
28;76;01;20;582;Saint-Germain-d'Etables;247;5;252;76582
28;76;03;21;583;Saint-Germain-sous-Cailly;342;5;347;76583
28;76;01;23;584;Saint-Germain-sur-Eaulne;218;5;223;76584
28;76;03;25;585;Saint-Gilles-de-Crétot;411;15;426;76585
28;76;02;32;586;Saint-Gilles-de-la-Neuville;652;5;657;76586
28;76;02;11;587;Sainte-Hélène-Bondeville;720;9;729;76587
28;76;01;23;588;Saint-Hellier;489;12;501;76588
28;76;01;20;589;Saint-Honoré;199;5;204;76589
28;76;01;08;590;Saint-Jacques-d'Aliermont;344;2;346;76590
28;76;03;06;591;Saint-Jacques-sur-Darnétal;3045;44;3089;76591
28;76;02;03;592;Saint-Jean-de-Folleville;816;27;843;76592
28;76;02;03;593;Saint-Jean-de-la-Neuville;610;11;621;76593
28;76;03;24;594;Saint-Jean-du-Cardonnay;1351;26;1377;76594
28;76;02;26;595;Saint-Jouin-Bruneval;1844;38;1882;76595
28;76;02;32;596;Saint-Laurent-de-Brèvedent;1491;38;1529;76596
28;76;03;35;597;Saint-Laurent-en-Caux;763;9;772;76597
28;76;01;10;598;Saint-Léger-aux-Bois;489;9;498;76598
28;76;03;06;599;Saint-Léger-du-Bourg-Denis;3599;49;3648;76599
28;76;02;11;600;Saint-Léonard;1709;34;1743;76600
28;76;01;12;601;Saint-Lucien;233;3;236;76601
28;76;01;20;602;Saint-Maclou-de-Folleville;620;12;632;76602
28;76;02;32;603;Saint-Maclou-la-Brière;462;6;468;76603
28;76;01;20;604;Saint-Mards;179;6;185;76604
28;76;01;07;605;Sainte-Marguerite-sur-Mer;468;13;481;76605
28;76;01;12;606;Morienne;188;25;213;76606
28;76;03;01;608;Sainte-Marguerite-sur-Duclair;2027;33;2060;76608
28;76;02;26;609;Sainte-Marie-au-Bosc;364;11;375;76609
28;76;03;35;610;Sainte-Marie-des-Champs;1580;13;1593;76610
28;76;03;35;611;Saint-Martin-aux-Arbres;317;9;326;76611
28;76;01;10;612;Saint-Martin-au-Bosc;261;5;266;76612
28;76;01;33;613;Saint-Martin-aux-Buneaux;651;12;663;76613
28;76;03;01;614;Saint-Martin-de-Boscherville;1535;31;1566;76614
28;76;02;26;615;Saint-Martin-du-Bec;629;24;653;76615
28;76;02;26;616;Saint-Martin-du-Manoir;1469;34;1503;76616
28;76;03;06;617;Saint-Martin-du-Vivier;1660;62;1722;76617
28;76;01;08;618;Petit-Caux;9628;203;9831;76618
28;76;01;10;619;Saint-Martin-le-Gaillard;289;5;294;76619
28;76;01;23;620;Saint-Martin-l'Hortier;273;7;280;76620
28;76;01;23;621;Saint-Martin-Osmonville;1186;22;1208;76621
28;76;02;25;622;Saint-Maurice-d'Etelan;301;10;311;76622
28;76;01;12;623;Saint-Michel-d'Halescourt;118;4;122;76623
28;76;01;08;624;Saint-Nicolas-d'Aliermont;3719;60;3779;76624
28;76;03;25;626;Saint-Nicolas-de-la-Haie;417;6;423;76626
28;76;02;03;627;Saint-Nicolas-de-la-Taille;1645;19;1664;76627
28;76;01;20;628;Saint-Ouen-du-Breuil;783;13;796;76628
28;76;01;20;629;Saint-Ouen-le-Mauger;278;6;284;76629
28;76;01;08;630;Saint-Ouen-sous-Bailly;225;7;232;76630
28;76;03;01;631;Saint-PaÃ«r;1311;15;1326;76631
28;76;01;20;632;Saint-Pierre-Bénouville;391;3;394;76632
28;76;03;04;634;Saint-Pierre-de-Manneville;897;15;912;76634
28;76;01;23;635;Saint-Pierre-des-Jonquières;72;0;72;76635
28;76;03;01;636;Saint-Pierre-de-Varengeville;2306;33;2339;76636
28;76;02;11;637;Saint-Pierre-en-Port;823;12;835;76637
28;76;01;10;638;Saint-Pierre-en-Val;1091;16;1107;76638
28;76;03;05;640;Saint-Pierre-lès-Elbeuf;8283;71;8354;76640
28;76;01;33;641;Saint-Pierre-le-Vieux;195;5;200;76641
28;76;01;33;642;Saint-Pierre-le-Viger;265;3;268;76642
28;76;01;10;644;Saint-Rémy-Boscrocourt;799;16;815;76644
28;76;01;10;645;Saint-Riquier-en-Rivière;145;5;150;76645
28;76;01;33;646;Saint-Riquier-ès-Plains;604;14;618;76646
28;76;02;32;647;Saint-Romain-de-Colbosc;4259;40;4299;76647
28;76;01;23;648;Saint-SaÃ«ns;2351;23;2374;76648
28;76;01;23;649;Saint-Saire;585;11;596;76649
28;76;02;32;650;Saint-Sauveur-d'Emalleville;1229;26;1255;76650
28;76;01;33;651;Saint-Sylvain;153;3;156;76651
28;76;01;08;652;Saint-Vaast-d'Equiqueville;763;5;768;76652
28;76;01;33;653;Saint-Vaast-Dieppedalle;372;3;375;76653
28;76;01;20;654;Saint-Vaast-du-Val;468;10;478;76654
28;76;01;33;655;Saint-Valery-en-Caux;3928;163;4091;76655
28;76;01;20;656;Saint-Victor-l'Abbaye;767;7;774;76656
28;76;02;32;657;Saint-Vigor-d'Ymonville;1137;23;1160;76657
28;76;02;32;658;Saint-Vincent-Cramesnil;691;21;712;76658
28;76;02;32;660;Sandouville;797;11;808;76660
28;76;01;20;662;Sassetot-le-Malgardé;111;1;112;76662
28;76;02;11;663;Sassetot-le-Mauconduit;1035;18;1053;76663
28;76;01;33;664;Sasseville;281;5;286;76664
28;76;01;08;665;Sauchay;431;5;436;76665
28;76;01;12;666;Saumont-la-Poterie;411;16;427;76666
28;76;01;07;667;Sauqueville;349;6;355;76667
28;76;03;35;668;Saussay;365;7;372;76668
28;76;02;32;669;Sausseuzemare-en-Caux;430;7;437;76669
28;76;02;11;670;Senneville-sur-Fécamp;884;11;895;76670
28;76;01;10;671;Sept-Meules;178;1;179;76671
28;76;01;12;672;Serqueux;979;20;999;76672
28;76;03;21;673;Servaville-Salmonville;1132;16;1148;76673
28;76;03;02;675;Sierville;1094;11;1105;76675
28;76;01;12;676;Sigy-en-Bray;496;11;507;76676
28;76;01;23;677;Smermesnil;383;8;391;76677
28;76;01;23;678;Sommery;828;13;841;76678
28;76;01;33;679;Sommesnil;111;1;112;76679
28;76;02;11;680;Sorquainville;185;4;189;76680
28;76;03;99;681;Sotteville-lès-Rouen;29068;445;29513;76681
28;76;03;05;682;Sotteville-sous-le-Val;758;4;762;76682
28;76;01;33;683;Sotteville-sur-Mer;397;10;407;76683
28;76;02;03;684;Tancarville;1250;22;1272;76684
28;76;02;11;685;Thérouldeville;669;3;672;76685
28;76;02;11;686;Theuville-aux-Maillots;541;8;549;76686
28;76;02;11;688;Thiergeville;400;14;414;76688
28;76;02;11;689;Thiétreville;367;38;405;76689
28;76;01;20;690;Thil-Manneville;639;19;658;76690
28;76;01;12;691;Le Thil-Riberpré;230;1;231;76691
28;76;01;33;692;Thiouville;293;5;298;76692
28;76;02;26;693;Le Tilleul;687;7;694;76693
28;76;01;20;694;Tocqueville-en-Caux;138;3;141;76694
28;76;02;32;695;Tocqueville-les-Murs;279;5;284;76695
28;76;01;20;697;Torcy-le-Grand;796;25;821;76697
28;76;01;20;698;Torcy-le-Petit;491;7;498;76698
28;76;03;35;699;Le Torp-Mesnil;451;4;455;76699
28;76;01;20;700;Tôtes;1576;31;1607;76700
28;76;03;35;702;Touffreville-la-Corbeline;838;15;853;76702
28;76;01;10;703;Touffreville-sur-Eu;212;8;220;76703
28;76;03;05;705;Tourville-la-Rivière;2493;21;2514;76705
28;76;02;11;706;Tourville-les-Ifs;691;7;698;76706
28;76;01;07;707;Tourville-sur-Arques;1211;39;1250;76707
28;76;02;11;708;Toussaint;702;12;714;76708
28;76;03;01;709;Le Trait;4876;46;4922;76709
28;76;02;33;710;Trémauville;103;2;105;76710
28;76;01;10;711;Le Tréport;4582;98;4680;76711
28;76;02;03;712;La Trinité-du-Mont;832;26;858;76712
28;76;02;32;714;Les Trois-Pierres;769;14;783;76714
28;76;02;25;715;Trouville;624;8;632;76715
28;76;02;26;716;Turretot;1462;25;1487;76716
28;76;03;04;717;Val-de-la-Haye;718;3;721;76717
28;76;03;35;718;Valliquerville;1421;37;1458;76718
28;76;02;11;719;Valmont;858;15;873;76719
28;76;01;07;720;Varengeville-sur-Mer;945;33;978;76720
28;76;01;20;721;Varneville-Bretteville;328;9;337;76721
28;76;01;20;723;Vassonville;438;7;445;76723
28;76;01;23;724;Vatierville;132;2;134;76724
28;76;02;32;725;Vattetot-sous-Beaumont;576;5;581;76725
28;76;02;11;726;Vattetot-sur-Mer;322;6;328;76726
28;76;03;25;727;Vatteville-la-Rue;1141;26;1167;76727
28;76;03;24;728;La Vaupalière;1124;20;1144;76728
28;76;01;33;730;Veauville-lès-Quelles;133;2;135;76730
28;76;01;20;731;Vénestanville;209;2;211;76731
28;76;01;33;732;Butot-Vénesville;242;4;246;76732
28;76;01;23;733;Ventes-Saint-Rémy;228;4;232;76733
28;76;02;26;734;Vergetot;447;12;459;76734
28;76;01;33;735;Veules-les-Roses;550;14;564;76735
28;76;01;33;736;Veulettes-sur-Mer;271;6;277;76736
28;76;03;35;737;Vibeuf;600;19;619;76737
28;76;03;21;738;Vieux-Manoir;757;11;768;76738
28;76;01;12;739;Vieux-Rouen-sur-Bresle;553;6;559;76739
28;76;03;21;740;La Vieux-Rue;574;10;584;76740
28;76;02;26;741;Villainville;286;12;298;76741
28;76;03;01;743;Villers-Ecalles;1765;19;1784;76743
28;76;01;10;744;Villers-sous-Foucarmont;188;2;190;76744
28;76;01;10;745;Villy-sur-Yères;201;2;203;76745
28;76;02;11;746;Vinnemerville;222;2;224;76746
28;76;02;32;747;Virville;351;3;354;76747
28;76;01;33;748;Vittefleur;653;7;660;76748
28;76;01;23;749;Wanchy-Capval;342;8;350;76749
28;76;03;01;750;Yainville;1041;13;1054;76750
28;76;02;33;751;Yébleron;1269;18;1287;76751
28;76;03;35;752;Yerville;2514;21;2535;76752
28;76;03;06;753;Ymare;1151;22;1173;76753
28;76;02;11;754;Yport;726;15;741;76754
28;76;02;11;755;Ypreville-Biville;576;9;585;76755
28;76;03;21;756;Yquebeuf;240;8;248;76756
28;76;03;35;757;Yvecrique;640;7;647;76757
28;76;03;35;758;Yvetot;11448;222;11670;76758
28;76;03;01;759;Yville-sur-Seine;444;6;450;76759
11;77;04;07;001;Achères-la-Forêt;1142;29;1171;77001
11;77;01;05;002;Amillis;826;5;831;77002
11;77;04;07;003;Amponville;337;17;354;77003
11;77;02;14;004;Andrezel;286;5;291;77004
11;77;01;03;005;Annet-sur-Marne;3281;45;3326;77005
11;77;04;07;006;Arbonne-la-Forêt;979;20;999;77006
11;77;02;14;007;Argentières;355;7;362;77007
11;77;01;06;008;Armentières-en-Brie;1225;24;1249;77008
11;77;04;15;009;Arville;124;0;124;77009
11;77;03;14;010;Aubepierre-Ozouer-le-Repos;935;10;945;77010
11;77;04;15;011;Aufferville;499;6;505;77011
11;77;03;18;012;Augers-en-Brie;294;7;301;77012
11;77;01;05;013;Aulnoy;359;9;368;77013
11;77;04;07;014;Avon;13419;224;13643;77014
11;77;03;18;015;Baby;94;2;96;77015
11;77;04;15;016;Bagneaux-sur-Loing;1623;15;1638;77016
11;77;05;21;018;Bailly-Romainvilliers;7416;61;7477;77018
11;77;03;18;019;Balloy;333;3;336;77019
11;77;03;18;020;Bannost-Villegagnon;645;12;657;77020
11;77;03;13;021;Barbey;152;2;154;77021
11;77;04;07;022;Barbizon;1207;39;1246;77022
11;77;01;03;023;Barcy;310;7;317;77023
11;77;01;06;024;Bassevelle;382;2;384;77024
11;77;03;18;025;Bazoches-lès-Bray;862;8;870;77025
11;77;03;18;026;Beauchery-Saint-Martin;358;15;373;77026
11;77;04;15;027;Beaumont-du-Gâtinais;1194;15;1209;77027
11;77;02;14;029;Beauvoir;192;3;195;77029
11;77;03;05;030;Bellot;773;5;778;77030
11;77;03;08;031;Bernay-Vilbert;905;11;916;77031
11;77;03;18;032;Beton-Bazoches;921;17;938;77032
11;77;03;18;033;Bezalles;233;8;241;77033
11;77;02;14;034;Blandy;749;7;756;77034
11;77;03;15;035;Blennes;548;7;555;77035
11;77;03;18;036;Boisdon;133;3;136;77036
11;77;04;14;037;Bois-le-Roi;5913;148;6061;77037
11;77;02;20;038;Boissettes;409;7;416;77038
11;77;02;20;039;Boissise-la-Bertrand;1146;11;1157;77039
11;77;02;19;040;Boissise-le-Roi;3739;41;3780;77040
11;77;04;07;041;Boissy-aux-Cailles;280;5;285;77041
11;77;01;05;042;Boissy-le-Châtel;3216;43;3259;77042
11;77;03;05;043;Boitron;348;7;355;77043
11;77;02;14;044;Bombon;960;8;968;77044
11;77;04;15;045;Bougligny;722;11;733;77045
11;77;04;07;046;Boulancourt;335;10;345;77046
11;77;01;21;047;Bouleurs;1680;14;1694;77047
11;77;04;07;048;Bourron-Marlotte;2763;85;2848;77048
11;77;01;21;049;Boutigny;844;14;858;77049
11;77;04;15;050;Bransles;541;10;551;77050
11;77;03;18;051;Bray-sur-Seine;2307;18;2325;77051
11;77;03;14;052;Bréau;345;5;350;77052
11;77;05;04;053;Brie-Comte-Robert;18812;317;19129;77053
11;77;03;13;054;La Brosse-Montceaux;730;14;744;77054
11;77;05;23;055;Brou-sur-Chantereine;4809;10;4819;77055
11;77;04;07;056;Burcy;148;6;154;77056
11;77;01;06;057;Bussières;519;3;522;77057
11;77;05;22;058;Bussy-Saint-Georges;26597;347;26944;77058
11;77;05;22;059;Bussy-Saint-Martin;647;14;661;77059
11;77;04;07;060;Buthiers;732;16;748;77060
11;77;03;13;061;Cannes-Ecluse;2482;35;2517;77061
11;77;05;09;062;Carnetin;455;10;465;77062
11;77;01;05;063;La Celle-sur-Morin;1267;15;1282;77063
11;77;04;07;065;Cély;1238;24;1262;77065
11;77;03;18;066;Cerneux;327;8;335;77066
11;77;02;20;067;Cesson;10833;145;10978;77067
11;77;03;18;068;Cessoy-en-Montois;214;4;218;77068
11;77;04;07;069;Chailly-en-Bière;2074;32;2106;77069
11;77;01;05;070;Chailly-en-Brie;1479;118;1597;77070
11;77;04;15;071;Chaintreaux;864;12;876;77071
11;77;03;18;072;Chalautre-la-Grande;685;10;695;77072
11;77;03;18;073;Chalautre-la-Petite;560;17;577;77073
11;77;05;09;075;Chalifert;1288;15;1303;77075
11;77;03;18;076;Chalmaison;755;54;809;77076
11;77;01;03;077;Chambry;993;12;1005;77077
11;77;01;06;078;Chamigny;1335;51;1386;77078
11;77;04;13;079;Champagne-sur-Seine;6353;149;6502;77079
11;77;03;18;080;Champcenest;196;1;197;77080
11;77;02;14;081;Champdeuil;727;8;735;77081
11;77;02;14;082;Champeaux;815;13;828;77082
11;77;05;01;083;Champs-sur-Marne;25654;154;25808;77083
11;77;01;06;084;Changis-sur-Marne;1349;11;1360;77084
11;77;05;09;085;Chanteloup-en-Brie;3991;51;4042;77085
11;77;03;14;086;La Chapelle-Gauthier;1441;5;1446;77086
11;77;03;08;087;La Chapelle-Iger;170;0;170;77087
11;77;04;07;088;La Chapelle-la-Reine;2384;30;2414;77088
11;77;03;14;089;La Chapelle-Rablais;916;6;922;77089
11;77;03;18;090;La Chapelle-Saint-Sulpice;241;4;245;77090
11;77;03;08;091;Les Chapelles-Bourbon;486;3;489;77091
11;77;03;05;093;La Chapelle-Moutils;449;3;452;77093
11;77;01;03;094;Charmentray;299;1;300;77094
11;77;01;03;095;Charny;1354;16;1370;77095
11;77;04;14;096;Chartrettes;2543;56;2599;77096
11;77;03;05;097;Chartronges;299;2;301;77097
11;77;03;14;098;Châteaubleau;358;2;360;77098
11;77;04;15;099;Château-Landon;2947;56;3003;77099
11;77;02;14;100;Le Châtelet-en-Brie;4339;67;4406;77100
11;77;03;18;101;Châtenay-sur-Seine;1063;11;1074;77101
11;77;04;15;102;Châtenoy;163;1;164;77102
11;77;02;14;103;Châtillon-la-Borde;217;2;219;77103
11;77;03;08;104;Châtres;693;7;700;77104
11;77;01;05;106;Chauffry;1023;17;1040;77106
11;77;02;08;107;Chaumes-en-Brie;3339;26;3365;77107
11;77;05;02;108;Chelles;55154;294;55448;77108
11;77;03;18;109;Chenoise-Cucharmoy;1640;26;1666;77109
11;77;04;15;110;Chenou;312;8;320;77110
11;77;05;21;111;Chessy;6304;54;6358;77111
11;77;04;15;112;Chevrainvilliers;251;4;255;77112
11;77;01;05;113;Chevru;1088;14;1102;77113
11;77;05;16;114;Chevry-Cossigny;3927;40;3967;77114
11;77;03;15;115;Chevry-en-Sereine;515;17;532;77115
11;77;03;05;116;Choisy-en-Brie;1308;18;1326;77116
11;77;01;06;117;Citry;953;9;962;77117
11;77;01;03;118;Claye-Souilly;12172;133;12305;77118
11;77;03;14;119;Clos-Fontaine;248;3;251;77119
11;77;01;06;120;Cocherel;626;4;630;77120
11;77;05;22;121;Collégien;3359;43;3402;77121
11;77;02;04;122;Combs-la-Ville;21627;150;21777;77122
11;77;01;12;123;Compans;815;2;817;77123
11;77;05;09;124;Conches-sur-Gondoire;1754;28;1782;77124
11;77;01;21;125;Condé-Sainte-Libiaire;1426;17;1443;77125
11;77;01;06;126;Congis-sur-Thérouanne;1762;193;1955;77126
11;77;02;08;127;Coubert;1885;13;1898;77127
11;77;01;21;128;Couilly-Pont-aux-Dames;2097;29;2126;77128
11;77;01;06;129;Coulombs-en-Valois;559;9;568;77129
11;77;01;21;130;Coulommes;488;4;492;77130
11;77;01;05;131;Coulommiers;14779;239;15018;77131
11;77;05;21;132;Coupvray;2871;28;2899;77132
11;77;03;13;133;Courcelles-en-Bassée;199;3;202;77133
11;77;03;18;134;Courchamp;148;3;151;77134
11;77;03;08;135;Courpalay;1294;14;1308;77135
11;77;02;08;136;Courquetaine;189;7;196;77136
11;77;03;18;137;Courtacon;239;10;249;77137
11;77;03;14;138;Courtomer;548;5;553;77138
11;77;05;23;139;Courtry;6698;52;6750;77139
11;77;03;18;140;Coutençon;281;3;284;77140
11;77;01;21;141;Coutevroult;1167;11;1178;77141
11;77;01;21;142;Crécy-la-Chapelle;4713;67;4780;77142
11;77;01;03;143;Crégy-lès-Meaux;5223;51;5274;77143
11;77;03;08;144;CrèvecÅ“ur-en-Brie;429;1;430;77144
11;77;02;14;145;Crisenoy;620;12;632;77145
11;77;05;01;146;Croissy-Beaubourg;2026;21;2047;77146
11;77;03;14;147;La Croix-en-Brie;666;8;674;77147
11;77;01;06;148;Crouy-sur-Ourcq;1825;24;1849;77148
11;77;01;03;150;Cuisy;455;2;457;77150
11;77;01;05;151;Dagny;278;4;282;77151
11;77;02;19;152;Dammarie-les-Lys;22128;146;22274;77152
11;77;01;12;153;Dammartin-en-GoÃ«le;10355;88;10443;77153
11;77;01;08;154;Dammartin-sur-Tigeaux;1135;16;1151;77154
11;77;05;09;155;Dampmart;3417;36;3453;77155
11;77;04;15;156;Darvault;896;14;910;77156
11;77;01;06;157;Dhuisy;311;6;317;77157
11;77;03;15;158;Diant;199;2;201;77158
11;77;03;18;159;Donnemarie-Dontilly;2775;48;2823;77159
11;77;04;15;161;Dormelles;802;18;820;77161
11;77;03;05;162;Doue;1070;8;1078;77162
11;77;01;06;163;Douy-la-Ramée;367;5;372;77163
11;77;02;14;164;Echouboulains;557;6;563;77164
11;77;02;14;165;Les Ecrennes;599;5;604;77165
11;77;03;18;167;Egligny;323;6;329;77167
11;77;04;15;168;Egreville;2152;38;2190;77168
11;77;05;17;169;Emerainville;7659;32;7691;77169
11;77;05;21;171;Esbly;6404;47;6451;77171
11;77;03;13;172;Esmans;887;9;896;77172
11;77;01;06;173;Etrépilly;844;7;851;77173
11;77;03;18;174;Everly;582;11;593;77174
11;77;02;08;175;Evry-Grégy-sur-Yerre;3025;30;3055;77175
11;77;01;08;176;Faremoutiers;2944;28;2972;77176
11;77;03;16;177;Favières;1132;13;1145;77177
11;77;04;15;178;FaÃ¿-lès-Nemours;495;11;506;77178
11;77;02;14;179;Féricy;594;15;609;77179
11;77;05;16;180;Férolles-Attilly;1257;27;1284;77180
11;77;05;16;181;Ferrières-en-Brie;3768;35;3803;77181
11;77;03;05;182;La Ferté-Gaucher;4933;48;4981;77182
11;77;01;06;183;La Ferté-sous-Jouarre;9637;85;9722;77183
11;77;04;15;184;Flagy;622;10;632;77184
11;77;04;07;185;Fleury-en-Bière;647;17;664;77185
11;77;04;07;186;Fontainebleau;15696;463;16159;77186
11;77;03;18;187;Fontaine-Fourches;588;3;591;77187
11;77;02;14;188;Fontaine-le-Port;998;18;1016;77188
11;77;03;14;190;Fontains;258;5;263;77190
11;77;03;14;191;Fontenailles;1052;13;1065;77191
11;77;03;08;192;Fontenay-Trésigny;5710;57;5767;77192
11;77;01;03;193;Forfry;233;1;234;77193
11;77;03;13;194;Forges;415;17;432;77194
11;77;02;14;195;Fouju;575;10;585;77195
11;77;01;03;196;Fresnes-sur-Marne;971;3;974;77196
11;77;03;18;197;Frétoy;166;3;169;77197
11;77;04;07;198;Fromont;247;4;251;77198
11;77;01;06;199;Fublaines;1389;11;1400;77199
11;77;04;15;200;Garentreville;117;2;119;77200
11;77;03;14;201;Gastins;678;4;682;77201
11;77;04;15;202;La Genevraye;802;6;808;77202
11;77;01;06;203;Germigny-l'Evêque;1326;21;1347;77203
11;77;01;06;204;Germigny-sous-Coulombs;211;3;214;77204
11;77;01;03;205;Gesvres-le-Chapitre;148;1;149;77205
11;77;01;05;206;Giremoutiers;181;4;185;77206
11;77;04;15;207;Gironville;153;5;158;77207
11;77;03;18;208;Gouaix;1400;29;1429;77208
11;77;05;09;209;Gouvernes;1186;22;1208;77209
11;77;03;13;210;La Grande-Paroisse;2833;35;2868;77210
11;77;03;14;211;Grandpuits-Bailly-Carrois;1025;9;1034;77211
11;77;03;18;212;Gravon;164;3;167;77212
11;77;01;03;214;Gressy;814;13;827;77214
11;77;05;16;215;Gretz-Armainvilliers;8476;69;8545;77215
11;77;04;15;216;Grez-sur-Loing;1413;35;1448;77216
11;77;02;08;217;Grisy-Suisnes;2532;30;2562;77217
11;77;03;18;218;Grisy-sur-Seine;108;1;109;77218
11;77;01;08;219;Guérard;2621;33;2654;77219
11;77;04;07;220;Guercheville;266;5;271;77220
11;77;05;09;221;Guermantes;1144;24;1168;77221
11;77;02;14;222;Guignes;4296;29;4325;77222
11;77;03;18;223;Gurcy-le-Châtel;565;6;571;77223
11;77;01;05;224;Hautefeuille;253;2;255;77224
11;77;01;21;225;La Haute-Maison;318;7;325;77225
11;77;04;07;226;Héricy;2545;101;2646;77226
11;77;03;18;227;Hermé;624;17;641;77227
11;77;03;05;228;Hondevilliers;256;4;260;77228
11;77;03;08;229;La Houssaye-en-Brie;1650;18;1668;77229
11;77;04;15;230;Ichy;161;2;163;77230
11;77;01;06;231;Isles-les-Meldeuses;815;2;817;77231
11;77;01;03;232;Isles-lès-Villenoy;1149;17;1166;77232
11;77;01;03;233;Iverny;589;3;592;77233
11;77;05;09;234;Jablines;691;7;698;77234
11;77;01;06;235;Jaignes;316;5;321;77235
11;77;03;18;236;Jaulnes;345;4;349;77236
11;77;05;22;237;Jossigny;656;9;665;77237
11;77;01;06;238;Jouarre;4349;41;4390;77238
11;77;03;18;239;Jouy-le-Châtel;1509;20;1529;77239
11;77;03;05;240;Jouy-sur-Morin;2171;28;2199;77240
11;77;01;12;241;Juilly;2003;15;2018;77241
11;77;03;18;242;Jutigny;537;7;544;77242
11;77;05;09;243;Lagny-sur-Marne;21539;225;21764;77243
11;77;04;15;244;Larchant;681;42;723;77244
11;77;03;13;245;Laval-en-Brie;410;4;414;77245
11;77;03;18;246;Léchelle;587;15;602;77246
11;77;03;05;247;Lescherolles;447;11;458;77247
11;77;05;09;248;Lesches;763;8;771;77248
11;77;05;16;249;Lésigny;7151;118;7269;77249
11;77;03;05;250;Leudon-en-Brie;162;7;169;77250
11;77;02;04;251;Lieusaint;13853;94;13947;77251
11;77;02;08;252;Limoges-Fourches;561;6;567;77252
11;77;02;08;253;Lissy;288;1;289;77253
11;77;03;08;254;Liverdy-en-Brie;1285;22;1307;77254
11;77;02;11;255;Livry-sur-Seine;2181;34;2215;77255
11;77;03;18;256;Lizines;186;1;187;77256
11;77;01;06;257;Lizy-sur-Ourcq;3533;21;3554;77257
11;77;05;01;258;Lognes;14353;65;14418;77258
11;77;01;12;259;Longperrier;2331;11;2342;77259
11;77;03;18;260;Longueville;1781;25;1806;77260
11;77;04;15;261;Lorrez-le-Bocage-Préaux;1189;20;1209;77261
11;77;03;18;262;Louan-Villegruis-Fontaine;490;18;508;77262
11;77;03;18;263;Luisetaines;236;7;243;77263
11;77;03;08;264;Lumigny-Nesles-Ormeaux;1526;17;1543;77264
11;77;01;06;265;Luzancy;1112;48;1160;77265
11;77;02;14;266;Machault;779;12;791;77266
11;77;04;15;267;La Madeleine-sur-Loing;360;3;363;77267
11;77;05;21;268;Magny-le-Hongre;9107;150;9257;77268
11;77;02;11;269;Maincy;1808;54;1862;77269
11;77;01;05;270;Maisoncelles-en-Brie;926;11;937;77270
11;77;04;15;271;Maisoncelles-en-Gâtinais;134;1;135;77271
11;77;03;18;272;Maison-Rouge;862;8;870;77272
11;77;01;12;273;Marchémoret;583;4;587;77273
11;77;01;06;274;Marcilly;442;2;444;77274
11;77;03;18;275;Les Marêts;148;4;152;77275
11;77;01;03;276;Mareuil-lès-Meaux;3231;41;3272;77276
11;77;03;08;277;Marles-en-Brie;1763;22;1785;77277
11;77;01;05;278;Marolles-en-Brie;410;6;416;77278
11;77;03;13;279;Marolles-sur-Seine;1814;33;1847;77279
11;77;01;06;280;Mary-sur-Marne;1114;11;1125;77280
11;77;01;05;281;Mauperthuis;476;4;480;77281
11;77;01;12;282;Mauregard;361;4;365;77282
11;77;01;06;283;May-en-Multien;943;4;947;77283
11;77;01;10;284;Meaux;55750;479;56229;77284
11;77;02;20;285;Le Mée-sur-Seine;20917;142;21059;77285
11;77;03;18;286;Meigneux;228;6;234;77286
11;77;03;05;287;Meilleray;496;11;507;77287
11;77;02;11;288;Melun;40844;295;41139;77288
11;77;03;18;289;Melz-sur-Seine;351;3;354;77289
11;77;01;06;290;Méry-sur-Marne;673;58;731;77290
11;77;01;12;291;Le Mesnil-Amelot;1068;5;1073;77291
11;77;01;03;292;Messy;1199;11;1210;77292
11;77;03;13;293;Misy-sur-Yonne;926;17;943;77293
11;77;01;12;294;Mitry-Mory;20648;83;20731;77294
11;77;02;14;295;Moisenay;1387;13;1400;77295
11;77;02;04;296;Moissy-Cramayel;17849;135;17984;77296
11;77;04;15;297;Mondreville;329;4;333;77297
11;77;03;18;298;Mons-en-Montois;445;10;455;77298
11;77;01;06;300;Montceaux-lès-Meaux;604;12;616;77300
11;77;03;18;301;Montceaux-lès-Provins;323;1;324;77301
11;77;04;15;302;Montcourt-Fromonville;1958;34;1992;77302
11;77;03;05;303;Montdauphin;239;3;242;77303
11;77;03;05;304;Montenils;25;0;25;77304
11;77;03;13;305;Montereau-Fault-Yonne;21229;193;21422;77305
11;77;02;11;306;Montereau-sur-le-Jard;503;6;509;77306
11;77;05;09;307;Montévrain;13517;111;13628;77307
11;77;01;12;308;Montgé-en-GoÃ«le;743;7;750;77308
11;77;01;03;309;Monthyon;1753;10;1763;77309
11;77;03;18;310;Montigny-le-Guesdier;305;6;311;77310
11;77;03;18;311;Montigny-Lencoup;1427;15;1442;77311
11;77;04;15;312;Montigny-sur-Loing;2660;75;2735;77312
11;77;03;15;313;Montmachoux;257;2;259;77313
11;77;03;05;314;Montolivet;236;2;238;77314
11;77;05;21;315;Montry;3705;31;3736;77315
11;77;04;13;316;Moret-Loing-et-Orvanne;12223;333;12556;77316
11;77;03;14;317;Mormant;5014;36;5050;77317
11;77;03;08;318;Mortcerf;1431;22;1453;77318
11;77;03;18;319;Mortery;145;3;148;77319
11;77;01;05;320;Mouroux;5654;58;5712;77320
11;77;03;18;321;Mousseaux-lès-Bray;672;4;676;77321
11;77;01;12;322;Moussy-le-Neuf;3160;27;3187;77322
11;77;01;12;323;Moussy-le-Vieux;1477;5;1482;77323
11;77;03;18;325;Mouy-sur-Seine;359;4;363;77325
11;77;02;19;326;Nandy;6235;71;6306;77326
11;77;03;14;327;Nangis;8867;86;8953;77327
11;77;04;07;328;Nanteau-sur-Essonne;429;8;437;77328
11;77;04;15;329;Nanteau-sur-Lunain;686;3;689;77329
11;77;01;06;330;Nanteuil-lès-Meaux;6225;74;6299;77330
11;77;01;06;331;Nanteuil-sur-Marne;429;6;435;77331
11;77;01;12;332;Nantouillet;286;1;287;77332
11;77;04;15;333;Nemours;13088;123;13211;77333
11;77;01;03;335;Chauconin-Neufmontiers;3554;28;3582;77335
11;77;03;08;336;Neufmoutiers-en-Brie;1185;11;1196;77336
11;77;05;01;337;Noisiel;15960;107;16067;77337
11;77;03;15;338;Noisy-Rudignon;597;8;605;77338
11;77;04;07;339;Noisy-sur-Ecole;1827;58;1885;77339
11;77;04;15;340;Nonville;602;11;613;77340
11;77;03;18;341;Noyen-sur-Seine;381;10;391;77341
11;77;04;15;342;Obsonville;111;1;112;77342
11;77;01;06;343;Ocquerre;392;19;411;77343
11;77;01;03;344;Oissery;2431;23;2454;77344
11;77;03;05;345;Orly-sur-Morin;666;9;675;77345
11;77;03;18;347;Les Ormes-sur-Voulzie;856;10;866;77347
11;77;04;15;348;Ormesson;234;6;240;77348
11;77;01;12;349;Othis;6725;76;6801;77349
11;77;05;16;350;Ozoir-la-Ferrière;20532;194;20726;77350
11;77;02;08;352;Ozouer-le-Voulgis;1921;22;1943;77352
11;77;04;15;353;Paley;425;7;432;77353
11;77;02;14;354;Pamfou;940;8;948;77354
11;77;03;18;355;Paroy;159;1;160;77355
11;77;03;18;356;Passy-sur-Seine;45;1;46;77356
11;77;03;08;357;Pécy;851;10;861;77357
11;77;01;03;358;Penchard;1315;12;1327;77358
11;77;04;07;359;Perthes;1980;25;2005;77359
11;77;01;05;360;Pézarches;386;4;390;77360
11;77;01;06;361;Pierre-Levée;463;7;470;77361
11;77;01;23;363;Le Pin;1568;11;1579;77363
11;77;01;03;364;Le Plessis-aux-Bois;260;2;262;77364
11;77;03;08;365;Le Plessis-Feu-Aussoux;614;5;619;77365
11;77;01;03;366;Le Plessis-l'Evêque;292;1;293;77366
11;77;01;06;367;Le Plessis-Placy;279;4;283;77367
11;77;03;18;368;Poigny;515;13;528;77368
11;77;01;06;369;Poincy;724;12;736;77369
11;77;04;15;370;Poligny;787;12;799;77370
11;77;01;08;371;Pommeuse;2966;21;2987;77371
11;77;05;09;372;Pomponne;4183;38;4221;77372
11;77;05;17;373;Pontault-Combault;37617;208;37825;77373
11;77;05;16;374;Pontcarré;2186;18;2204;77374
11;77;01;03;376;Précy-sur-Marne;809;3;812;77376
11;77;03;08;377;Presles-en-Brie;2312;29;2341;77377
11;77;02;19;378;Pringy;2954;20;2974;77378
11;77;03;18;379;Provins;12132;285;12417;77379
11;77;01;06;380;Puisieux;320;6;326;77380
11;77;03;14;381;Quiers;666;5;671;77381
11;77;01;21;382;Quincy-Voisins;5439;54;5493;77382
11;77;03;14;383;Rampillon;826;7;833;77383
11;77;02;04;384;Réau;1919;3;1922;77384
11;77;03;05;385;Rebais;2292;24;2316;77385
11;77;04;07;386;Recloses;614;22;636;77386
11;77;04;15;387;Remauville;466;8;474;77387
11;77;01;06;388;Reuil-en-Brie;826;7;833;77388
11;77;02;11;389;La Rochette;3778;105;3883;77389
11;77;05;17;390;Roissy-en-Brie;22851;82;22933;77390
11;77;03;18;391;Rouilly;489;6;495;77391
11;77;01;12;392;Rouvres;910;12;922;77392
11;77;03;08;393;Rozay-en-Brie;2808;36;2844;77393
11;77;02;11;394;Rubelles;2831;23;2854;77394
11;77;04;07;395;Rumont;121;4;125;77395
11;77;03;18;396;Rupéreux;98;0;98;77396
11;77;01;06;397;Saâcy-sur-Marne;1844;25;1869;77397
11;77;03;05;398;Sablonnières;717;8;725;77398
11;77;01;05;400;Saint-Augustin;1729;28;1757;77400
11;77;01;06;401;Sainte-Aulde;673;7;680;77401
11;77;03;05;402;Saint-Barthélemy;338;5;343;77402
11;77;03;18;403;Saint-Brice;807;17;824;77403
11;77;03;18;404;Sainte-Colombe;1826;32;1858;77404
11;77;03;05;405;Saint-Cyr-sur-Morin;1969;44;2013;77405
11;77;03;05;406;Saint-Denis-lès-Rebais;997;19;1016;77406
11;77;02;19;407;Saint-Fargeau-Ponthierry;14121;125;14246;77407
11;77;01;21;408;Saint-Fiacre;417;2;419;77408
11;77;03;13;409;Saint-Germain-Laval;2707;101;2808;77409
11;77;02;11;410;Saint-Germain-Laxis;738;33;771;77410
11;77;03;05;411;Saint-Germain-sous-Doue;553;11;564;77411
11;77;04;07;412;Saint-Germain-sur-Ecole;380;5;385;77412
11;77;05;21;413;Saint-Germain-sur-Morin;3770;48;3818;77413
11;77;03;18;414;Saint-Hilliers;483;7;490;77414
11;77;01;06;415;Saint-Jean-les-Deux-Jumeaux;1277;18;1295;77415
11;77;03;14;416;Saint-Just-en-Brie;238;5;243;77416
11;77;03;05;417;Saint-Léger;260;1;261;77417
11;77;03;18;418;Saint-Loup-de-Naud;874;11;885;77418
11;77;04;13;419;Saint-Mammès;3391;117;3508;77419
11;77;01;12;420;Saint-Mard;3875;26;3901;77420
11;77;03;05;421;Saint-Mars-Vieux-Maisons;265;6;271;77421
11;77;03;05;423;Saint-Martin-des-Champs;655;9;664;77423
11;77;03;18;424;Saint-Martin-du-Boschet;278;4;282;77424
11;77;04;07;425;Saint-Martin-en-Bière;737;21;758;77425
11;77;02;14;426;Saint-Méry;337;9;346;77426
11;77;01;03;427;Saint-Mesmes;612;5;617;77427
11;77;03;14;428;Saint-Ouen-en-Brie;834;12;846;77428
11;77;03;05;429;Saint-Ouen-sur-Morin;537;5;542;77429
11;77;01;12;430;Saint-Pathus;6110;53;6163;77430
11;77;04;15;431;Saint-Pierre-lès-Nemours;5394;89;5483;77431
11;77;03;05;432;Saint-Rémy-la-Vanne;992;9;1001;77432
11;77;01;05;433;Beautheil-Saints;1992;34;2026;77433
11;77;03;18;434;Saint-Sauveur-lès-Bray;364;5;369;77434
11;77;04;07;435;Saint-Sauveur-sur-Ecole;1107;31;1138;77435
11;77;03;05;436;Saint-Siméon;896;5;901;77436
11;77;01;03;437;Saint-Soupplets;3224;29;3253;77437
11;77;05;09;438;Saint-Thibault-des-Vignes;6354;73;6427;77438
11;77;03;13;439;Salins;1169;23;1192;77439
11;77;01;06;440;Sammeron;1132;13;1145;77440
11;77;04;07;441;Samois-sur-Seine;2040;47;2087;77441
11;77;04;07;442;Samoreau;2396;60;2456;77442
11;77;01;21;443;Sancy;389;8;397;77443
11;77;03;18;444;Sancy-lès-Provins;318;2;320;77444
11;77;02;20;445;Savigny-le-Temple;29987;225;30212;77445
11;77;03;18;446;Savins;603;9;612;77446
11;77;02;19;447;Seine-Port;1853;48;1901;77447
11;77;01;06;448;Sept-Sorts;522;7;529;77448
11;77;05;21;449;Serris;9494;90;9584;77449
11;77;05;16;450;Servon;3288;52;3340;77450
11;77;01;06;451;Signy-Signets;582;6;588;77451
11;77;03;18;452;Sigy;65;0;65;77452
11;77;02;14;453;Sivry-Courtry;1155;14;1169;77453
11;77;03;18;454;Sognolles-en-Montois;376;6;382;77454
11;77;02;08;455;Soignolles-en-Brie;2009;32;2041;77455
11;77;03;18;456;Soisy-Bouy;814;19;833;77456
11;77;02;08;457;Solers;1179;22;1201;77457
11;77;04;15;458;Souppes-sur-Loing;5383;102;5485;77458
11;77;03;18;459;Sourdun;1504;393;1897;77459
11;77;01;06;460;Tancrou;349;4;353;77460
11;77;03;18;461;Thénisy;295;6;301;77461
11;77;01;12;462;Thieux;872;2;874;77462
11;77;04;13;463;Thomery;3420;114;3534;77463
11;77;05;09;464;Thorigny-sur-Marne;10454;116;10570;77464
11;77;03;15;465;Thoury-Férottes;655;9;664;77465
11;77;01;21;466;Tigeaux;381;3;384;77466
11;77;03;18;467;La Tombe;207;0;207;77467
11;77;05;22;468;Torcy;22030;104;22134;77468
11;77;01;05;469;Touquin;1221;11;1232;77469
11;77;05;16;470;Tournan-en-Brie;8521;110;8631;77470
11;77;04;07;471;Tousson;363;8;371;77471
11;77;03;05;472;La Trétoire;504;10;514;77472
11;77;04;15;473;Treuzy-Levelay;411;7;418;77473
11;77;01;03;474;Trilbardou;657;5;662;77474
11;77;01;06;475;Trilport;5045;32;5077;77475
11;77;01;06;476;Trocy-en-Multien;233;2;235;77476
11;77;04;07;477;Ury;850;30;880;77477
11;77;01;06;478;Ussy-sur-Marne;1097;10;1107;77478
11;77;05;23;479;Vaires-sur-Marne;13368;132;13500;77479
11;77;02;14;480;Valence-en-Brie;1048;9;1057;77480
11;77;03;14;481;Vanvillé;188;1;189;77481
11;77;03;13;482;Varennes-sur-Seine;3601;70;3671;77482
11;77;01;03;483;Varreddes;2032;22;2054;77483
11;77;01;21;484;Vaucourtois;276;6;282;77484
11;77;04;07;485;Le Vaudoué;729;14;743;77485
11;77;03;08;486;Vaudoy-en-Brie;898;8;906;77486
11;77;02;11;487;Vaux-le-Pénil;11101;159;11260;77487
11;77;04;15;489;Vaux-sur-Lunain;232;3;235;77489
11;77;01;06;490;Vendrest;696;9;705;77490
11;77;03;05;492;Verdelot;657;4;661;77492
11;77;03;14;493;Verneuil-l'Etang;3204;21;3225;77493
11;77;04;13;494;Vernou-la-Celle-sur-Seine;2643;37;2680;77494
11;77;02;20;495;Vert-Saint-Denis;8238;82;8320;77495
11;77;03;14;496;Vieux-Champagne;189;4;193;77496
11;77;01;03;498;Vignely;307;0;307;77498
11;77;04;15;500;Villebéon;468;9;477;77500
11;77;04;13;501;Villecerf;719;17;736;77501
11;77;04;15;504;Villemaréchal;1111;17;1128;77504
11;77;01;21;505;Villemareuil;385;5;390;77505
11;77;04;15;506;Villemer;782;10;792;77506
11;77;03;18;507;Villenauxe-la-Petite;410;6;416;77507
11;77;05;16;508;Villeneuve-le-Comte;1816;36;1852;77508
11;77;03;18;509;Villeneuve-les-Bordes;610;7;617;77509
11;77;05;16;510;Villeneuve-Saint-Denis;982;4;986;77510
11;77;01;12;511;Villeneuve-sous-Dammartin;645;0;645;77511
11;77;03;05;512;Villeneuve-sur-Bellot;1129;12;1141;77512
11;77;01;03;513;Villenoy;4975;34;5009;77513
11;77;01;23;514;Villeparisis;26580;98;26678;77514
11;77;01;03;515;Villeroy;705;5;710;77515
11;77;04;13;516;Ville-Saint-Jacques;862;26;888;77516
11;77;01;23;517;Villevaudé;2137;13;2150;77517
11;77;02;07;518;Villiers-en-Bière;208;3;211;77518
11;77;03;18;519;Villiers-Saint-Georges;1189;25;1214;77519
11;77;04;07;520;Villiers-sous-Grez;646;20;666;77520
11;77;01;21;521;Villiers-sur-Morin;1935;46;1981;77521
11;77;03;18;522;Villiers-sur-Seine;298;6;304;77522
11;77;03;18;523;Villuis;261;3;264;77523
11;77;03;18;524;Vimpelles;522;6;528;77524
11;77;01;12;525;Vinantes;383;2;385;77525
11;77;01;06;526;Vincy-ManÅ“uvre;277;5;282;77526
11;77;03;08;527;Voinsles;576;17;593;77527
11;77;02;11;528;Voisenon;1154;16;1170;77528
11;77;01;21;529;Voulangis;1494;30;1524;77529
11;77;03;18;530;Voulton;316;12;328;77530
11;77;03;15;531;Voulx;1664;23;1687;77531
11;77;03;18;532;Vulaines-lès-Provins;66;0;66;77532
11;77;04;07;533;Vulaines-sur-Seine;2748;62;2810;77533
11;77;02;14;534;Yèbles;953;1;954;77534
11;78;02;14;003;Ablis;3490;48;3538;78003
11;78;03;13;005;Achères;21529;159;21688;78005
11;78;01;02;006;Adainville;662;16;678;78006
11;78;03;16;007;Aigremont;1086;49;1135;78007
11;78;02;14;009;Allainville;293;6;299;78009
11;78;03;19;010;Les Alluets-le-Roi;1213;37;1250;78010
11;78;03;01;013;Andelu;483;4;487;78013
11;78;03;05;015;Andrésy;13302;147;13449;78015
11;78;01;02;020;Arnouville-lès-Mantes;939;12;951;78020
11;78;01;01;029;Aubergenville;12152;64;12216;78029
11;78;02;14;030;Auffargis;1958;47;2005;78030
11;78;01;02;031;Auffreville-Brasseuil;649;10;659;78031
11;78;01;01;033;Aulnay-sur-Mauldre;1142;24;1166;78033
11;78;02;01;034;Auteuil;967;19;986;78034
11;78;02;01;036;Autouillet;584;7;591;78036
11;78;04;04;043;Bailly;3733;140;3873;78043
11;78;01;02;048;Bazainville;1457;41;1498;78048
11;78;03;01;049;Bazemont;1649;46;1695;78049
11;78;02;01;050;Bazoches-sur-Guyonne;641;9;650;78050
11;78;02;01;053;Béhoust;479;12;491;78053
11;78;01;02;057;Bennecourt;1883;21;1904;78057
11;78;02;12;062;Beynes;7618;111;7729;78062
11;78;01;02;068;Blaru;894;20;914;78068
11;78;01;02;070;Boinville-en-Mantois;288;2;290;78070
11;78;02;14;071;Boinville-le-Gaillard;609;9;618;78071
11;78;01;02;072;Boinvilliers;264;2;266;78072
11;78;04;15;073;Bois-d'Arcy;15325;143;15468;78073
11;78;01;02;076;Boissets;275;4;279;78076
11;78;02;14;077;La Boissière-Ecole;752;57;809;78077
11;78;01;02;082;Boissy-Mauvoisin;623;11;634;78082
11;78;02;01;084;Boissy-sans-Avoir;653;12;665;78084
11;78;02;14;087;Bonnelles;2079;50;2129;78087
11;78;01;02;089;Bonnières-sur-Seine;4791;38;4829;78089
11;78;01;01;090;Bouafle;2194;28;2222;78090
11;78;04;04;092;Bougival;8790;142;8932;78092
11;78;01;02;096;Bourdonné;499;9;508;78096
11;78;01;02;104;Breuil-Bois-Robert;743;12;755;78104
11;78;01;02;107;Bréval;1803;26;1829;78107
11;78;02;14;108;Les Bréviaires;1305;29;1334;78108
11;78;01;07;113;Brueil-en-Vexin;696;12;708;78113
11;78;04;21;117;Buc;6027;165;6192;78117
11;78;01;08;118;Buchelay;3306;23;3329;78118
11;78;02;14;120;Bullion;1908;62;1970;78120
11;78;03;13;123;Carrières-sous-Poissy;16641;116;16757;78123
11;78;03;06;124;Carrières-sur-Seine;15178;198;15376;78124
11;78;02;14;125;La Celle-les-Bordes;836;31;867;78125
11;78;04;04;126;La Celle-Saint-Cloud;20692;404;21096;78126
11;78;02;14;128;Cernay-la-Ville;1559;38;1597;78128
11;78;03;16;133;Chambourcy;5587;141;5728;78133
11;78;03;05;138;Chanteloup-les-Vignes;10426;73;10499;78138
11;78;01;11;140;Chapet;1335;25;1360;78140
11;78;04;09;143;Châteaufort;1423;39;1462;78143
11;78;03;03;146;Chatou;30153;501;30654;78146
11;78;01;02;147;Chaufour-lès-Bonnières;476;7;483;78147
11;78;03;15;152;Chavenay;1767;76;1843;78152
11;78;04;04;158;Le Chesnay-Rocquencourt;31233;638;31871;78158
11;78;02;09;160;Chevreuse;5610;136;5746;78160
11;78;02;09;162;Choisel;545;26;571;78162
11;78;01;02;163;Civry-la-Forêt;332;4;336;78163
11;78;02;14;164;Clairefontaine-en-Yvelines;818;64;882;78164
11;78;04;12;165;Les Clayes-sous-Bois;17487;235;17722;78165
11;78;02;09;168;Coignières;4355;31;4386;78168
11;78;01;02;171;Condé-sur-Vesgre;1238;27;1265;78171
11;78;03;05;172;Conflans-Sainte-Honorine;35536;410;35946;78172
11;78;01;02;185;Courgent;366;11;377;78185
11;78;01;02;188;Cravent;407;6;413;78188
11;78;03;19;189;Crespières;1671;63;1734;78189
11;78;03;03;190;Croissy-sur-Seine;10031;336;10367;78190
11;78;01;02;192;Dammartin-en-Serve;1375;16;1391;78192
11;78;02;09;193;Dampierre-en-Yvelines;1022;15;1037;78193
11;78;01;02;194;Dannemarie;209;3;212;78194
11;78;03;19;196;Davron;293;14;307;78196
11;78;01;07;202;Drocourt;561;8;569;78202
11;78;01;11;206;Ecquevilly;4150;44;4194;78206
11;78;02;18;208;Elancourt;25624;244;25868;78208
11;78;02;14;209;Emancé;881;13;894;78209
11;78;01;07;217;Epône;6561;94;6655;78217
11;78;02;14;220;Les Essarts-le-Roi;6668;136;6804;78220
11;78;03;16;224;L'Etang-la-Ville;4453;185;4638;78224
11;78;01;11;227;Evecquemont;793;14;807;78227
11;78;01;07;230;La Falaise;592;8;600;78230
11;78;01;02;231;Favrieux;155;6;161;78231
11;78;03;19;233;Feucherolles;2983;141;3124;78233
11;78;01;02;234;Flacourt;183;0;183;78234
11;78;02;01;236;Flexanville;583;14;597;78236
11;78;01;02;237;Flins-Neuve-Eglise;154;2;156;78237
11;78;01;01;238;Flins-sur-Seine;2428;30;2458;78238
11;78;01;07;239;Follainville-Dennemont;2146;30;2176;78239
11;78;04;15;242;Fontenay-le-Fleury;13466;141;13607;78242
11;78;01;02;245;Fontenay-Mauvoisin;377;14;391;78245
11;78;01;07;246;Fontenay-Saint-Père;954;19;973;78246
11;78;01;02;255;Freneuse;4266;58;4324;78255
11;78;01;11;261;Gaillon-sur-Montcient;665;13;678;78261
11;78;02;01;262;Galluis;1243;18;1261;78262
11;78;02;01;263;Gambais;2476;64;2540;78263
11;78;02;14;264;Gambaiseuil;57;1;58;78264
11;78;02;01;265;Garancières;2375;53;2428;78265
11;78;01;07;267;Gargenville;7893;68;7961;78267
11;78;02;14;269;Gazeran;1290;30;1320;78269
11;78;01;02;276;Gommecourt;674;5;679;78276
11;78;02;01;278;Goupillières;511;10;521;78278
11;78;01;02;281;Goussonville;625;10;635;78281
11;78;01;02;283;Grandchamp;304;10;314;78283
11;78;01;02;285;Gressey;544;14;558;78285
11;78;02;01;289;Grosrouvre;900;39;939;78289
11;78;01;07;290;Guernes;1074;15;1089;78290
11;78;01;02;291;Guerville;2166;38;2204;78291
11;78;01;07;296;Guitrancourt;622;11;633;78296
11;78;04;10;297;Guyancourt;29471;461;29932;78297
11;78;01;11;299;Hardricourt;2495;21;2516;78299
11;78;01;02;300;Hargeville;454;5;459;78300
11;78;01;02;302;La Hauteville;166;5;171;78302
11;78;03;01;305;Herbeville;247;6;253;78305
11;78;02;14;307;Hermeray;949;25;974;78307
11;78;01;02;310;Houdan;3671;41;3712;78310
11;78;03;06;311;Houilles;32801;346;33147;78311
11;78;01;07;314;Issou;3893;46;3939;78314
11;78;01;07;317;Jambville;796;13;809;78317
11;78;01;02;320;Notre-Dame-de-la-Mer;687;15;702;78320
11;78;02;01;321;Jouars-Pontchartrain;5772;117;5889;78321
11;78;04;21;322;Jouy-en-Josas;8049;167;8216;78322
11;78;01;02;324;Jouy-Mauvoisin;558;3;561;78324
11;78;01;02;325;Jumeauville;605;7;612;78325
11;78;01;07;327;Juziers;3843;46;3889;78327
11;78;01;07;329;Lainville-en-Vexin;776;12;788;78329
11;78;02;09;334;Lévis-Saint-Nom;1600;34;1634;78334
11;78;01;07;335;Limay;17136;105;17241;78335
11;78;01;02;337;Limetz-Villez;1937;32;1969;78337
11;78;04;21;343;Les Loges-en-Josas;1629;65;1694;78343
11;78;01;02;344;Lommoye;658;9;667;78344
11;78;01;02;346;Longnes;1502;24;1526;78346
11;78;02;14;349;Longvilliers;504;12;516;78349
11;78;03;04;350;Louveciennes;7236;165;7401;78350
11;78;01;08;354;Magnanville;6177;131;6308;78354
11;78;02;09;356;Magny-les-Hameaux;9418;170;9588;78356
11;78;03;17;358;Maisons-Laffitte;23361;501;23862;78358
11;78;01;08;361;Mantes-la-Jolie;43921;195;44116;78361
11;78;01;08;362;Mantes-la-Ville;20818;157;20975;78362
11;78;02;01;364;Marcq;765;9;774;78364
11;78;02;01;366;Mareil-le-Guyon;391;11;402;78366
11;78;03;16;367;Mareil-Marly;3677;168;3845;78367
11;78;03;01;368;Mareil-sur-Mauldre;1696;36;1732;78368
11;78;03;03;372;Marly-le-Roi;16385;499;16884;78372
11;78;03;01;380;Maule;5881;221;6102;78380
11;78;01;02;381;Maulette;1013;15;1028;78381
11;78;03;05;382;Maurecourt;4414;53;4467;78382
11;78;02;09;383;Maurepas;17683;248;17931;78383
11;78;03;19;384;Médan;1346;45;1391;78384
11;78;01;02;385;Ménerville;212;1;213;78385
11;78;02;01;389;Méré;1665;50;1715;78389
11;78;01;02;391;Méricourt;394;7;401;78391
11;78;03;17;396;Le Mesnil-le-Roi;6285;151;6436;78396
11;78;02;09;397;Le Mesnil-Saint-Denis;6777;117;6894;78397
11;78;02;01;398;Les Mesnuls;865;22;887;78398
11;78;01;11;401;Meulan-en-Yvelines;9005;76;9081;78401
11;78;01;07;402;Mézières-sur-Seine;3683;40;3723;78402
11;78;01;11;403;Mézy-sur-Seine;2296;35;2331;78403
11;78;02;01;404;Millemont;269;4;273;78404
11;78;02;09;406;Milon-la-Chapelle;283;12;295;78406
11;78;02;14;407;Mittainville;626;15;641;78407
11;78;01;02;410;Moisson;979;7;986;78410
11;78;01;02;413;Mondreville;407;3;410;78413
11;78;03;01;415;Montainville;510;21;531;78415
11;78;01;07;416;Montalet-le-Bois;316;5;321;78416
11;78;01;02;417;Montchauvet;297;7;304;78417
11;78;03;06;418;Montesson;14991;278;15269;78418
11;78;02;01;420;Montfort-l'Amaury;2935;78;3013;78420
11;78;04;10;423;Montigny-le-Bretonneux;32282;459;32741;78423
11;78;03;19;431;Morainvilliers;3023;82;3105;78431
11;78;01;02;437;Mousseaux-sur-Seine;679;9;688;78437
11;78;01;02;439;Mulcent;109;1;110;78439
11;78;01;11;440;Les Mureaux;33203;159;33362;78440
11;78;02;01;442;Neauphle-le-Château;3385;54;3439;78442
11;78;02;01;443;Neauphle-le-Vieux;916;19;935;78443
11;78;01;02;444;Neauphlette;823;15;838;78444
11;78;01;01;451;Nézel;1040;15;1055;78451
11;78;04;19;455;Noisy-le-Roi;7635;285;7920;78455
11;78;01;07;460;Oinville-sur-Montcient;1070;20;1090;78460
11;78;02;14;464;Orcemont;1020;23;1043;78464
11;78;01;02;465;Orgerus;2433;68;2501;78465
11;78;03;19;466;Orgeval;6664;199;6863;78466
11;78;02;14;470;Orphin;883;26;909;78470
11;78;02;14;472;Orsonville;330;6;336;78472
11;78;01;02;474;Orvilliers;927;9;936;78474
11;78;01;02;475;Osmoy;379;9;388;78475
11;78;02;14;478;Paray-Douaville;243;7;250;78478
11;78;03;16;481;Le Pecq;15716;330;16046;78481
11;78;01;02;484;Perdreauville;637;16;653;78484
11;78;02;14;486;Le Perray-en-Yvelines;6597;113;6710;78486
11;78;04;12;490;Plaisir;30950;353;31303;78490
11;78;02;14;497;Poigny-la-Forêt;916;41;957;78497
11;78;03;13;498;Poissy;39187;288;39475;78498
11;78;02;14;499;Ponthévrard;664;19;683;78499
11;78;01;07;501;Porcheville;3174;70;3244;78501
11;78;03;03;502;Le Port-Marly;5481;56;5537;78502
11;78;01;02;505;Prunay-le-Temple;416;17;433;78505
11;78;02;14;506;Prunay-en-Yvelines;882;9;891;78506
11;78;02;01;513;La Queue-les-Yvelines;2199;31;2230;78513
11;78;02;14;516;Raizeux;979;16;995;78516
11;78;02;14;517;Rambouillet;27141;495;27636;78517
11;78;04;15;518;Rennemoulin;110;4;114;78518
11;78;01;02;520;Richebourg;1593;25;1618;78520
11;78;02;14;522;Rochefort-en-Yvelines;907;38;945;78522
11;78;01;02;528;Rolleboise;375;3;378;78528
11;78;01;02;530;Rosay;374;6;380;78530
11;78;01;08;531;Rosny-sur-Seine;6883;46;6929;78531
11;78;01;07;536;Sailly;357;11;368;78536
11;78;02;14;537;Saint-Arnoult-en-Yvelines;5818;135;5953;78537
11;78;04;15;545;Saint-Cyr-l'Ecole;19792;640;20432;78545
11;78;02;09;548;Saint-Forget;473;13;486;78548
11;78;02;01;550;Saint-Germain-de-la-Grange;1850;37;1887;78550
11;78;03;16;551;Saint-Germain-en-Laye;44806;1843;46649;78551
11;78;02;14;557;Saint-Hilarion;948;18;966;78557
11;78;01;02;558;Saint-Illiers-la-Ville;390;8;398;78558
11;78;01;02;559;Saint-Illiers-le-Bois;426;5;431;78559
11;78;02;09;561;Saint-Lambert;447;35;482;78561
11;78;02;14;562;Saint-Léger-en-Yvelines;1394;32;1426;78562
11;78;02;14;564;Saint-Martin-de-Bréthencourt;667;9;676;78564
11;78;01;02;565;Saint-Martin-des-Champs;303;9;312;78565
11;78;01;07;567;Saint-Martin-la-Garenne;928;11;939;78567
11;78;02;14;569;Sainte-Mesme;921;19;940;78569
11;78;03;19;571;Saint-Nom-la-Bretèche;4920;210;5130;78571
11;78;02;09;575;Saint-Rémy-lès-Chevreuse;7806;159;7965;78575
11;78;02;01;576;Saint-Rémy-l'Honoré;1621;29;1650;78576
11;78;03;17;586;Sartrouville;52774;449;53223;78586
11;78;02;01;588;Saulx-Marchais;957;27;984;78588
11;78;02;09;590;Senlisse;499;11;510;78590
11;78;01;02;591;Septeuil;2349;24;2373;78591
11;78;01;02;597;Soindres;685;8;693;78597
11;78;02;14;601;Sonchamp;1600;62;1662;78601
11;78;01;02;605;Tacoignières;1042;17;1059;78605
11;78;01;02;606;Le Tartre-Gaudran;36;1;37;78606
11;78;01;02;608;Le Tertre-Saint-Denis;123;1;124;78608
11;78;01;11;609;Tessancourt-sur-Aubette;1051;6;1057;78609
11;78;02;12;615;Thiverval-Grignon;1189;22;1211;78615
11;78;02;01;616;Thoiry;1424;28;1452;78616
11;78;01;02;618;Tilly;516;14;530;78618
11;78;04;09;620;Toussus-le-Noble;1166;38;1204;78620
11;78;04;18;621;Trappes;32645;114;32759;78621
11;78;02;01;623;Le Tremblay-sur-Mauldre;951;150;1101;78623
11;78;03;19;624;Triel-sur-Seine;12250;213;12463;78624
11;78;01;11;638;Vaux-sur-Seine;5010;67;5077;78638
11;78;04;21;640;Vélizy-Villacoublay;23092;184;23276;78640
11;78;03;19;642;Verneuil-sur-Seine;15980;372;16352;78642
11;78;03;19;643;Vernouillet;10104;187;10291;78643
11;78;02;18;644;La Verrière;6386;79;6465;78644
11;78;04;99;646;Versailles;84808;2038;86846;78646
11;78;01;02;647;Vert;835;12;847;78647
11;78;03;03;650;Le Vésinet;15943;553;16496;78650
11;78;02;01;653;Vicq;377;9;386;78653
11;78;02;14;655;Vieille-Eglise-en-Yvelines;635;26;661;78655
11;78;01;02;668;La Villeneuve-en-Chevrie;656;10;666;78668
11;78;03;19;672;Villennes-sur-Seine;5292;167;5459;78672
11;78;04;15;674;Villepreux;11003;205;11208;78674
11;78;01;02;677;Villette;509;17;526;78677
11;78;02;01;681;Villiers-le-Mahieu;828;17;845;78681
11;78;02;01;683;Villiers-Saint-Frédéric;2906;161;3067;78683
11;78;04;21;686;Viroflay;16752;348;17100;78686
11;78;02;09;688;Voisins-le-Bretonneux;10835;374;11209;78688
75;79;01;04;001;L'Absie;1052;15;1067;79001
75;79;03;13;002;Adilly;309;5;314;79002
75;79;02;14;003;Aiffres;5396;170;5566;79003
75;79;03;17;005;Airvault;3270;47;3317;79005
75;79;03;06;007;Allonne;666;19;685;79007
75;79;03;13;008;Amailloux;822;7;829;79008
75;79;02;05;009;Amuré;432;9;441;79009
75;79;02;05;010;Arçais;612;6;618;79010
75;79;03;01;012;Ardin;1244;32;1276;79012
75;79;01;07;013;Argentonnay;3183;89;3272;79013
75;79;01;17;014;Loretz-d'Argenton;2620;36;2656;79014
75;79;02;09;015;Asnières-en-Poitou;196;5;201;79015
75;79;03;17;016;Assais-les-Jumeaux;769;12;781;79016
75;79;02;08;018;Aubigné;184;5;189;79018
75;79;03;06;019;Aubigny;164;1;165;79019
75;79;02;15;020;Augé;890;21;911;79020
75;79;03;17;022;Availles-Thouarsais;193;1;194;79022
75;79;02;03;023;Avon;63;1;64;79023
75;79;02;15;024;Azay-le-Brûlé;1982;95;2077;79024
75;79;03;06;025;Azay-sur-Thouet;1125;29;1154;79025
75;79;03;06;029;Beaulieu-sous-Parthenay;664;14;678;79029
75;79;02;03;030;Beaussais-Vitré;973;55;1028;79030
75;79;02;09;031;Beauvoir-sur-Niort;1768;37;1805;79031
75;79;03;01;032;Béceleuf;774;14;788;79032
75;79;02;05;034;Bessines;1721;65;1786;79034
75;79;01;02;038;Boismé;1192;28;1220;79038
75;79;03;06;040;La Boissière-en-Gâtine;236;2;238;79040
75;79;02;03;042;Bougon;176;6;182;79042
75;79;02;09;046;Le Bourdet;567;6;573;79046
75;79;03;17;047;Boussais;453;10;463;79047
75;79;02;15;048;La Crèche;5820;133;5953;79048
75;79;01;02;049;Bressuire;19850;997;20847;79049
75;79;01;04;050;Bretignolles;589;16;605;79050
75;79;02;09;055;Brieuil-sur-Chizé;123;3;126;79055
75;79;01;17;056;Brion-près-Thouet;740;11;751;79056
75;79;02;09;057;Brioux-sur-Boutonne;1445;51;1496;79057
75;79;02;14;058;Brûlain;767;17;784;79058
75;79;03;01;059;Le Busseau;733;8;741;79059
75;79;02;08;060;Caunay;178;3;181;79060
75;79;02;03;061;Celles-sur-Belle;3907;57;3964;79061
75;79;01;04;062;Cerizay;4764;73;4837;79062
75;79;01;17;063;Val en Vignes;2044;110;2154;79063
75;79;02;08;064;Fontivillié;848;24;872;79064
75;79;03;01;066;Champdeniers;1734;39;1773;79066
75;79;01;04;069;Chanteloup;1012;23;1035;79069
75;79;03;01;070;La Chapelle-Bâton;402;10;412;79070
75;79;03;13;071;La Chapelle-Bertrand;469;14;483;79071
75;79;02;08;074;La Chapelle-Pouilloux;179;5;184;79074
75;79;01;04;076;La Chapelle-Saint-Laurent;2034;26;2060;79076
75;79;03;01;077;Beugnon-Thireuil;731;10;741;79077
75;79;02;09;078;Plaine-d'Argenson;965;15;980;79078
75;79;01;07;079;Mauléon;8578;226;8804;79079
75;79;03;13;080;Châtillon-sur-Thouet;2678;54;2732;79080
75;79;02;14;081;Chauray;7083;206;7289;79081
75;79;02;08;083;Chef-Boutonne;2457;113;2570;79083
75;79;02;03;084;Chenay;451;3;454;79084
75;79;02;09;085;Chérigné;135;5;140;79085
75;79;02;01;086;Cherveux;1960;42;2002;79086
75;79;02;03;087;Chey;559;9;568;79087
75;79;01;02;088;Chiché;1695;44;1739;79088
75;79;03;17;089;Le Chillou;160;1;161;79089
75;79;02;09;090;Chizé;846;22;868;79090
75;79;01;04;091;Cirières;947;24;971;79091
75;79;03;06;092;Clavé;361;4;365;79092
75;79;01;04;094;Clessé;952;9;961;79094
75;79;02;08;095;Clussais-la-Pommeraie;586;12;598;79095
75;79;01;04;096;Combrand;1144;34;1178;79096
75;79;02;05;100;Coulon;2260;55;2315;79100
75;79;03;01;101;Coulonges-sur-l'Autize;2355;49;2404;79101
75;79;01;17;102;Coulonges-Thouarsais;433;3;436;79102
75;79;01;04;103;Courlay;2421;49;2470;79103
75;79;03;01;104;Cours;560;13;573;79104
75;79;03;06;105;Les Châteliers;473;9;482;79105
75;79;02;08;106;Couture-d'Argenson;401;2;403;79106
75;79;03;06;108;Doux;230;1;231;79108
75;79;02;14;109;Echiré;3441;99;3540;79109
75;79;02;09;111;Ensigné;289;4;293;79111
75;79;02;05;112;Epannes;860;24;884;79112
75;79;02;15;114;Exireuil;1578;31;1609;79114
75;79;02;03;115;Exoudun;567;10;577;79115
75;79;01;02;116;Faye-l'Abbesse;1114;17;1131;79116
75;79;03;01;117;Faye-sur-Ardin;648;8;656;79117
75;79;03;13;118;Fénery;281;6;287;79118
75;79;03;01;119;Fenioux;628;11;639;79119
75;79;03;06;120;La Ferrière-en-Parthenay;762;13;775;79120
75;79;03;06;121;Fomperron;405;10;415;79121
75;79;02;08;122;Fontenille-Saint-Martin-d'Entraigues;533;5;538;79122
75;79;01;04;123;La Forêt-sur-Sèvre;2311;49;2360;79123
75;79;03;06;124;Les Forges;112;5;117;79124
75;79;02;05;125;Fors;1811;55;1866;79125
75;79;02;09;126;Les Fosses;439;10;449;79126
75;79;02;09;127;La Foye-Monjault;850;7;857;79127
75;79;02;15;128;François;953;26;979;79128
75;79;02;03;129;Fressines;1719;31;1750;79129
75;79;02;05;130;Frontenay-Rohan-Rohan;2899;99;2998;79130
75;79;01;02;131;Geay;314;7;321;79131
75;79;01;07;132;Genneton;317;6;323;79132
75;79;02;01;133;Germond-Rouvre;1182;23;1205;79133
75;79;01;17;134;Glénay;571;14;585;79134
75;79;03;06;135;Gourgé;960;23;983;79135
75;79;02;08;136;Alloinay;894;17;911;79136
75;79;02;05;137;Granzay-Gript;903;18;921;79137
75;79;03;06;139;Les Groseillers;55;2;57;79139
75;79;02;08;140;Valdelaume;828;10;838;79140
75;79;03;17;141;Irais;208;4;212;79141
75;79;02;09;142;Juillé;100;2;102;79142
75;79;02;14;144;Juscorps;372;7;379;79144
75;79;03;13;145;Lageon;368;5;373;79145
75;79;01;04;147;Largeasse;732;9;741;79147
75;79;02;03;148;Lezay;1982;27;2009;79148
75;79;03;06;149;Lhoumois;139;2;141;79149
75;79;02;08;150;Limalonges;819;16;835;79150
75;79;02;08;152;Lorigné;302;6;308;79152
75;79;02;08;153;Loubigné;158;3;161;79153
75;79;02;08;154;Loubillé;400;6;406;79154
75;79;03;17;156;Louin;687;25;712;79156
75;79;01;16;157;Louzy;1320;41;1361;79157
75;79;02;09;158;Luché-sur-Brioux;132;3;135;79158
75;79;01;17;159;Luché-Thouarsais;526;4;530;79159
75;79;02;09;160;Lusseray;164;3;167;79160
75;79;01;17;161;Luzay;644;12;656;79161
75;79;02;05;162;Magné;2693;65;2758;79162
75;79;02;08;163;Mairé-Levescault;519;10;529;79163
75;79;02;08;164;Maisonnay;262;4;266;79164
75;79;03;17;165;Maisontiers;141;5;146;79165
75;79;02;09;166;Marigny;877;14;891;79166
75;79;01;17;167;Marnes;236;11;247;79167
75;79;02;09;170;Mauzé-sur-le-Mignon;2891;55;2946;79170
75;79;03;06;172;Mazières-en-Gâtine;1026;23;1049;79172
75;79;02;08;174;Melle;6173;329;6502;79174
75;79;02;08;175;Melleran;488;12;500;79175
75;79;03;06;176;Ménigoute;861;23;884;79176
75;79;02;03;177;Messé;193;4;197;79177
75;79;01;04;179;Moncoutant-sur-Sèvre;5057;184;5241;79179
75;79;02;08;180;Montalembert;309;3;312;79180
75;79;01;04;183;Montravers;373;10;383;79183
75;79;02;03;184;La Mothe-Saint-Héray;1674;24;1698;79184
75;79;02;03;185;Aigondigné;4677;144;4821;79185
75;79;02;15;189;Nanteuil;1704;31;1735;79189
75;79;01;04;190;Neuvy-Bouin;492;3;495;79190
75;79;02;99;191;Niort;59193;1834;61027;79191
75;79;01;07;195;Nueil-les-Aubiers;5536;119;5655;79195
75;79;01;17;196;Plaine-et-Vallées;2384;53;2437;79196
75;79;03;06;197;Oroux;91;2;93;79197
75;79;02;09;198;Paizay-le-Chapt;260;3;263;79198
75;79;03;01;200;Pamplie;265;3;268;79200
75;79;02;03;201;Pamproux;1704;20;1724;79201
75;79;03;13;202;Parthenay;10089;400;10489;79202
75;79;01;17;203;Pas-de-Jeu;367;8;375;79203
75;79;02;09;204;Périgné;1004;38;1042;79204
75;79;02;08;205;Pers;74;3;77;79205
75;79;01;07;207;La Petite-Boissière;630;17;647;79207
75;79;03;06;208;La Peyratte;1137;38;1175;79208
75;79;01;17;209;Pierrefitte;330;8;338;79209
75;79;01;04;210;Le Pin;1047;23;1070;79210
75;79;02;08;212;Pliboux;206;3;209;79212
75;79;03;13;213;Pompaire;1992;54;2046;79213
75;79;03;06;215;Pougne-Hérisson;368;7;375;79215
75;79;02;14;216;Prahecq;2217;40;2257;79216
75;79;02;03;217;Prailles-La Couarde;950;22;972;79217
75;79;03;06;218;Pressigny;193;6;199;79218
75;79;02;09;220;Prin-Deyrançon;600;15;615;79220
75;79;03;01;223;Puihardy;62;1;63;79223
75;79;03;06;225;Reffannes;376;6;382;79225
75;79;03;06;226;Le Retail;276;5;281;79226
75;79;02;09;229;La Rochénard;553;14;567;79229
75;79;02;03;230;Rom;867;11;878;79230
75;79;02;15;231;Romans;708;15;723;79231
75;79;01;07;235;Saint-Amand-sur-Sèvre;1408;42;1450;79235
75;79;01;04;236;Saint-André-sur-Sèvre;652;12;664;79236
75;79;01;07;238;Saint-Aubin-du-Plain;540;21;561;79238
75;79;03;06;239;Saint-Aubin-le-Cloud;1714;127;1841;79239
75;79;03;01;241;Saint-Christophe-sur-Roc;569;11;580;79241
75;79;01;07;242;Voulmentin;1119;20;1139;79242
75;79;02;03;243;Saint-Coutant;279;0;279;79243
75;79;01;17;244;Saint-Cyr-la-Lande;366;4;370;79244
75;79;02;15;246;Sainte-Eanne;605;13;618;79246
75;79;02;14;249;Saint-Gelais;2136;63;2199;79249
75;79;01;17;250;Sainte-Gemme;400;4;404;79250
75;79;02;08;251;Marcillé;745;29;774;79251
75;79;01;17;252;Saint-Généroux;348;13;361;79252
75;79;03;06;253;Saint-Georges-de-Noisné;694;14;708;79253
75;79;02;09;254;Saint-Georges-de-Rex;451;13;464;79254
75;79;03;13;255;Saint-Germain-de-Longue-Chaume;401;3;404;79255
75;79;03;06;256;Saint-Germier;233;6;239;79256
75;79;02;09;257;Saint-Hilaire-la-Palud;1524;23;1547;79257
75;79;01;16;258;Saint-Jacques-de-Thouars;432;13;445;79258
75;79;01;16;259;Saint-Jean-de-Thouars;1372;36;1408;79259
75;79;03;01;263;Saint-Laurs;596;11;607;79263
75;79;01;17;265;Saint-Léger-de-Montbrun;1261;24;1285;79265
75;79;03;06;267;Saint-Lin;326;4;330;79267
75;79;03;17;268;Saint-Loup-Lamairé;995;40;1035;79268
75;79;03;01;269;Saint-Maixent-de-Beugné;414;5;419;79269
75;79;02;15;270;Saint-Maixent-l'Ecole;7242;140;7382;79270
75;79;03;06;271;Saint-Marc-la-Lande;370;2;372;79271
75;79;02;14;273;Saint-Martin-de-Bernegoue;795;20;815;79273
75;79;01;17;274;Saint-Martin-de-Mâcon;292;6;298;79274
75;79;02;15;276;Saint-Martin-de-Saint-Maixent;1083;31;1114;79276
75;79;01;17;277;Saint-Martin-de-Sanzay;1090;18;1108;79277
75;79;03;06;278;Saint-Martin-du-Fouilloux;238;6;244;79278
75;79;01;07;280;Saint Maurice Etusson;883;14;897;79280
75;79;02;01;281;Saint-Maxire;1306;36;1342;79281
75;79;02;15;283;Sainte-Néomaye;1327;31;1358;79283
75;79;03;01;284;Sainte-Ouenne;782;12;794;79284
75;79;03;06;285;Saint-Pardoux-Soutiers;1862;42;1904;79285
75;79;01;04;286;Saint-Paul-en-Gâtine;441;7;448;79286
75;79;01;07;289;Saint-Pierre-des-Echaubrognes;1444;26;1470;79289
75;79;03;01;290;Saint-Pompain;944;15;959;79290
75;79;02;01;293;Saint-Rémy;1128;25;1153;79293
75;79;02;14;294;Saint-Romans-des-Champs;167;5;172;79294
75;79;02;08;295;Saint-Romans-lès-Melle;711;18;729;79295
75;79;02;03;297;Sainte-Soline;353;7;360;79297
75;79;02;05;298;Saint-Symphorien;1950;56;2006;79298
75;79;01;17;299;Saint-Varent;2401;49;2450;79299
75;79;01;16;300;Sainte-Verge;1377;30;1407;79300
75;79;02;08;301;Saint-Vincent-la-Châtre;627;20;647;79301
75;79;02;15;302;Saivres;1391;34;1425;79302
75;79;02;03;303;Salles;328;12;340;79303
75;79;02;05;304;Sansais;760;51;811;79304
75;79;03;06;306;Saurais;188;2;190;79306
75;79;02;08;307;Sauzé-Vaussais;1514;28;1542;79307
75;79;02;01;308;Sciecq;637;10;647;79308
75;79;03;01;309;Scillé;350;7;357;79309
75;79;02;09;310;Secondigné-sur-Belle;501;15;516;79310
75;79;03;06;311;Secondigny;1802;85;1887;79311
75;79;02;09;312;Séligné;116;3;119;79312
75;79;02;03;313;Sepvret;625;15;640;79313
75;79;02;03;316;Soudan;431;14;445;79316
75;79;02;15;319;Souvigné;873;28;901;79319
75;79;03;01;320;Surin;655;12;667;79320
75;79;03;13;322;Le Tallud;2000;56;2056;79322
75;79;03;06;326;Thénezay;1409;27;1436;79326
75;79;01;16;329;Thouars;13886;344;14230;79329
75;79;01;17;331;Tourtenay;124;6;130;79331
75;79;01;04;332;Trayes;121;4;125;79332
75;79;02;09;334;Val-du-Mignon;1076;22;1098;79334
75;79;02;05;335;Vallans;793;21;814;79335
75;79;02;03;336;Vançais;226;2;228;79336
75;79;02;05;337;Le Vanneau-Irleau;868;26;894;79337
75;79;02;03;338;Vanzay;252;0;252;79338
75;79;03;06;339;Vasles;1671;29;1700;79339
75;79;03;06;340;Vausseroux;324;6;330;79340
75;79;03;06;341;Vautebis;113;1;114;79341
75;79;03;06;342;Vernoux-en-Gâtine;573;13;586;79342
75;79;02;09;343;Vernoux-sur-Boutonne;211;2;213;79343
75;79;03;06;345;Verruyes;896;32;928;79345
75;79;02;09;346;Le Vert;129;3;132;79346
75;79;03;13;347;Viennay;1105;21;1126;79347
75;79;02;09;348;Villefollet;222;5;227;79348
75;79;02;08;349;Villemain;148;2;150;79349
75;79;02;09;350;Villiers-en-Bois;121;3;124;79350
75;79;02;01;351;Villiers-en-Plaine;1793;31;1824;79351
75;79;02;09;352;Villiers-sur-Chizé;157;6;163;79352
75;79;03;06;354;Vouhé;362;10;372;79354
75;79;02;14;355;Vouillé;3345;101;3446;79355
75;79;03;01;357;Xaintray;232;3;235;79357
32;80;01;98;001;Abbeville;22980;410;23390;80001
32;80;04;18;002;Ablaincourt-Pressoir;266;5;271;80002
32;80;04;05;003;Acheux-en-Amiénois;581;11;592;80003
32;80;01;02;004;Acheux-en-Vimeu;511;4;515;80004
32;80;02;14;005;Agenville;84;2;86;80005
32;80;01;01;006;Agenvillers;253;4;257;80006
32;80;01;17;008;Aigneville;896;18;914;80008
32;80;01;23;009;Ailly-le-Haut-Clocher;997;24;1021;80009
32;80;03;03;010;Ailly-sur-Noye;2833;31;2864;80010
32;80;02;04;011;Ailly-sur-Somme;2952;26;2978;80011
32;80;02;04;013;Airaines;2383;32;2415;80013
32;80;04;20;014;Aizecourt-le-Bas;56;0;56;80014
32;80;04;20;015;Aizecourt-le-Haut;64;3;67;80015
32;80;04;05;016;Albert;9779;166;9945;80016
32;80;04;20;017;Allaines;442;6;448;80017
32;80;01;16;018;Allenay;248;5;253;80018
32;80;01;17;019;Allery;787;14;801;80019
32;80;02;07;020;Allonville;762;18;780;80020
32;80;02;99;021;Amiens;134706;2674;137380;80021
32;80;02;21;022;Andainville;264;3;267;80022
32;80;03;22;023;Andechy;279;4;283;80023
32;80;02;04;024;ArgÅ“uves;544;6;550;80024
32;80;01;23;025;Argoules;327;3;330;80025
32;80;02;21;026;Arguel;28;0;28;80026
32;80;03;22;027;Armancourt;31;0;31;80027
32;80;04;05;028;Arquèves;157;1;158;80028
32;80;01;02;029;Arrest;842;25;867;80029
32;80;01;23;030;Arry;216;8;224;80030
32;80;03;19;031;Arvillers;775;9;784;80031
32;80;03;22;032;Assainvillers;104;0;104;80032
32;80;04;18;033;Assevillers;303;3;306;80033
32;80;04;18;034;Athies;588;6;594;80034
32;80;03;19;035;Aubercourt;78;1;79;80035
32;80;02;08;036;Aubigny;538;4;542;80036
32;80;03;03;037;Aubvillers;153;1;154;80037
32;80;04;05;038;Auchonvillers;144;3;147;80038
32;80;01;16;039;Ault;1397;17;1414;80039
32;80;02;21;040;Aumâtre;175;4;179;80040
32;80;02;21;041;Aumont;147;4;151;80041
32;80;02;14;042;Autheux;122;2;124;80042
32;80;04;05;043;Authie;264;11;275;80043
32;80;02;14;044;Authieule;408;6;414;80044
32;80;04;05;045;Authuille;161;2;163;80045
32;80;02;04;046;Avelesges;55;0;55;80046
32;80;04;05;047;Aveluy;521;5;526;80047
32;80;02;21;048;Avesnes-Chaussoy;63;3;66;80048
32;80;03;22;049;Ayencourt;167;10;177;80049
32;80;02;03;050;Bacouel-sur-Selle;485;10;495;80050
32;80;01;17;051;Bailleul;257;3;260;80051
32;80;02;13;052;Baizieux;212;5;217;80052
32;80;03;22;053;Balâtre;70;1;71;80053
32;80;04;20;054;Barleux;236;5;241;80054
32;80;02;14;055;Barly;168;1;169;80055
32;80;02;13;056;Bavelincourt;96;1;97;80056
32;80;04;05;057;Bayencourt;77;3;80;80057
32;80;04;19;058;Bayonvillers;334;4;338;80058
32;80;04;05;059;Bazentin;77;1;78;80059
32;80;02;14;060;Béalcourt;105;0;105;80060
32;80;02;21;061;Beaucamps-le-Jeune;187;3;190;80061
32;80;02;21;062;Beaucamps-le-Vieux;1422;17;1439;80062
32;80;01;17;063;Beauchamps;988;22;1010;80063
32;80;03;19;064;Beaucourt-en-Santerre;170;3;173;80064
32;80;04;05;065;Beaucourt-sur-l'Ancre;89;3;92;80065
32;80;02;13;066;Beaucourt-sur-l'Hallue;281;6;287;80066
32;80;04;19;067;Beaufort-en-Santerre;194;2;196;80067
32;80;02;14;068;Beaumetz;220;1;221;80068
32;80;04;05;069;Beaumont-Hamel;208;0;208;80069
32;80;02;14;070;Beauquesne;1325;52;1377;80070
32;80;02;14;071;Beauval;2036;23;2059;80071
32;80;04;05;073;Bécordel-Bécourt;156;2;158;80073
32;80;03;22;074;Becquigny;130;1;131;80074
32;80;01;02;076;Béhen;516;4;520;80076
32;80;02;13;077;Béhencourt;324;3;327;80077
32;80;01;01;078;Bellancourt;511;9;520;80078
32;80;02;03;079;Belleuse;326;4;330;80079
32;80;04;18;080;Belloy-en-Santerre;148;5;153;80080
32;80;02;21;081;Belloy-Saint-Léonard;90;2;92;80081
32;80;02;04;082;Belloy-sur-Somme;740;8;748;80082
32;80;02;21;083;Bergicourt;140;4;144;80083
32;80;02;21;084;Bermesnil;213;1;214;80084
32;80;02;14;085;Bernâtre;37;2;39;80085
32;80;02;14;086;Bernaville;1058;17;1075;80086
32;80;01;23;087;Bernay-en-Ponthieu;238;6;244;80087
32;80;04;20;088;Bernes;353;2;355;80088
32;80;02;14;089;Berneuil;264;1;265;80089
32;80;04;18;090;Berny-en-Santerre;152;3;155;80090
32;80;02;07;092;Bertangles;686;6;692;80092
32;80;02;15;093;Berteaucourt-les-Dames;1103;12;1115;80093
32;80;03;19;094;Berteaucourt-lès-Thennes;439;11;450;80094
32;80;04;05;095;Bertrancourt;212;3;215;80095
32;80;01;16;096;Béthencourt-sur-Mer;942;9;951;80096
32;80;04;18;097;Béthencourt-sur-Somme;129;3;132;80097
32;80;02;21;098;Bettembos;106;3;109;80098
32;80;01;17;099;Bettencourt-Rivière;226;4;230;80099
32;80;02;15;100;Bettencourt-Saint-Ouen;619;4;623;80100
32;80;03;22;101;Beuvraignes;861;5;866;80101
32;80;04;20;102;Biaches;383;7;390;80102
32;80;03;22;103;Biarre;66;0;66;80103
32;80;01;17;104;Biencourt;135;2;137;80104
32;80;04;18;105;Billancourt;168;2;170;80105
32;80;02;21;106;Blangy-sous-Poix;175;3;178;80106
32;80;02;09;107;Blangy-Tronville;622;11;633;80107
32;80;02;14;108;Boisbergues;73;1;74;80108
32;80;01;23;109;Le Boisle;343;3;346;80109
32;80;01;02;110;Boismont;474;16;490;80110
32;80;02;13;112;Bonnay;240;1;241;80112
32;80;02;14;113;Bonneville;337;7;344;80113
32;80;02;03;114;Bosquel;336;6;342;80114
32;80;04;20;115;Bouchavesnes-Bergen;282;4;286;80115
32;80;04;19;116;Bouchoir;273;3;276;80116
32;80;02;15;117;Bouchon;158;5;163;80117
32;80;01;23;118;Boufflers;116;1;117;80118
32;80;02;04;119;Bougainville;422;8;430;80119
32;80;01;17;120;Bouillancourt-en-Séry;536;11;547;80120
32;80;03;22;121;Bouillancourt-la-Bataille;156;0;156;80121
32;80;02;14;122;Bouquemaison;488;15;503;80122
32;80;02;04;123;Bourdon;372;8;380;80123
32;80;01;16;124;Bourseville;704;14;718;80124
32;80;03;22;125;Boussicourt;87;0;87;80125
32;80;01;17;126;Bouttencourt;922;17;939;80126
32;80;01;17;127;Bouvaincourt-sur-Bresle;832;11;843;80127
32;80;04;20;128;Bouvincourt-en-Vermandois;147;3;150;80128
32;80;04;05;129;Bouzincourt;541;13;554;80129
32;80;02;04;130;Bovelles;427;6;433;80130
32;80;02;10;131;Boves;3281;56;3337;80131
32;80;03;19;132;Braches;232;3;235;80132
32;80;01;23;133;Brailly-Cornehotte;238;1;239;80133
32;80;02;03;134;Brassy;79;2;81;80134
32;80;01;02;135;Bray-lès-Mareuil;244;4;248;80135
32;80;04;05;136;Bray-sur-Somme;1275;7;1282;80136
32;80;02;04;137;Breilly;746;4;750;80137
32;80;02;13;138;Bresle;125;1;126;80138
32;80;04;18;139;Breuil;43;0;43;80139
32;80;02;14;140;Brévillers;107;3;110;80140
32;80;04;20;141;Brie;329;1;330;80141
32;80;02;04;142;Briquemesnil-Floxicourt;318;4;322;80142
32;80;02;21;143;Brocourt;101;1;102;80143
32;80;04;18;144;Brouchy;497;9;506;80144
32;80;01;23;145;Brucamps;138;0;138;80145
32;80;01;16;146;Brutelles;205;5;210;80146
32;80;01;23;147;Buigny-l'Abbé;326;7;333;80147
32;80;01;17;148;Buigny-lès-Gamaches;400;5;405;80148
32;80;01;01;149;Buigny-Saint-Maclou;524;11;535;80149
32;80;04;20;150;Buire-Courcelles;222;7;229;80150
32;80;04;05;151;Buire-sur-l'Ancre;308;4;312;80151
32;80;03;22;152;Bus-la-Mésière;148;1;149;80152
32;80;04;05;153;Bus-lès-Artois;131;0;131;80153
32;80;04;20;154;Bussu;213;7;220;80154
32;80;01;23;155;Bussus-Bussuel;293;8;301;80155
32;80;02;08;156;Bussy-lès-Daours;398;3;401;80156
32;80;02;21;157;Bussy-lès-Poix;96;5;101;80157
32;80;04;18;158;Buverchy;51;0;51;80158
32;80;02;09;159;Cachy;280;6;286;80159
32;80;02;10;160;Cagny;1203;21;1224;80160
32;80;01;02;161;Cahon;205;7;212;80161
32;80;04;19;162;Caix;699;11;710;80162
32;80;01;02;163;Cambron;761;11;772;80163
32;80;02;08;164;Camon;4436;54;4490;80164
32;80;02;04;165;Camps-en-Amiénois;190;1;191;80165
32;80;02;15;166;Canaples;702;7;709;80166
32;80;01;01;167;Canchy;330;11;341;80167
32;80;02;14;168;Candas;1105;9;1114;80168
32;80;02;21;169;Cannessières;66;0;66;80169
32;80;03;22;170;Cantigny;111;1;112;80170
32;80;01;01;171;Caours;599;19;618;80171
32;80;04;05;172;Cappy;546;7;553;80172
32;80;02;07;173;Cardonnette;538;7;545;80173
32;80;03;22;174;Le Cardonnois;79;3;82;80174
32;80;03;22;176;Carrépuis;268;4;272;80176
32;80;04;20;177;Cartigny;715;23;738;80177
32;80;02;21;179;Caulières;219;4;223;80179
32;80;02;04;180;Cavillon;104;1;105;80180
32;80;03;19;181;Cayeux-en-Santerre;123;0;123;80181
32;80;01;16;182;Cayeux-sur-Mer;2445;31;2476;80182
32;80;02;21;183;Cerisy-Buleux;264;5;269;80183
32;80;02;13;184;Cerisy;534;5;539;80184
32;80;03;22;185;Champien;284;10;294;80185
32;80;04;18;186;Chaulnes;2026;22;2048;80186
32;80;02;04;187;La Chaussée-Tirancourt;650;11;661;80187
32;80;03;03;188;Chaussoy-Epagny;590;7;597;80188
32;80;04;19;189;La Chavatte;72;1;73;80189
32;80;01;17;190;Chépy;1231;17;1248;80190
32;80;04;19;191;Chilly;174;5;179;80191
32;80;02;13;192;Chipilly;167;2;169;80192
32;80;03;03;193;Chirmont;136;3;139;80193
32;80;04;18;194;Chuignes;139;1;140;80194
32;80;04;05;195;Chuignolles;150;1;151;80195
32;80;01;17;196;Citerne;243;8;251;80196
32;80;04;18;197;Cizancourt;31;0;31;80197
32;80;02;04;198;Clairy-Saulchoix;378;4;382;80198
32;80;04;20;199;Cléry-sur-Somme;522;11;533;80199
32;80;01;23;200;Cocquerel;223;2;225;80200
32;80;04;05;201;Coigneux;49;2;51;80201
32;80;02;07;202;Coisy;361;3;364;80202
32;80;04;05;203;Colincamps;87;2;89;80203
32;80;04;20;204;Combles;738;12;750;80204
32;80;01;15;205;Condé-Folie;912;10;922;80205
32;80;04;05;206;Contalmaison;117;0;117;80206
32;80;02;13;207;Contay;364;2;366;80207
32;80;02;14;208;Conteville;219;4;223;80208
32;80;02;03;210;Contre;146;7;153;80210
32;80;02;03;211;Conty;1796;49;1845;80211
32;80;02;13;212;Corbie;6292;79;6371;80212
32;80;03;03;213;Cottenchy;571;170;741;80213
32;80;03;03;214;Coullemelle;320;1;321;80214
32;80;01;23;215;Coulonvillers;220;8;228;80215
32;80;04;05;216;Courcelette;155;1;156;80216
32;80;04;05;217;Courcelles-au-Bois;75;0;75;80217
32;80;02;21;218;Courcelles-sous-Moyencourt;144;3;147;80218
32;80;02;03;219;Courcelles-sous-Thoix;68;1;69;80219
32;80;03;22;220;Courtemanche;100;2;102;80220
32;80;01;23;221;Cramont;305;5;310;80221
32;80;01;23;222;Crécy-en-Ponthieu;1370;28;1398;80222
32;80;03;22;223;Crémery;133;0;133;80223
32;80;03;22;224;Cressy-Omencourt;123;1;124;80224
32;80;02;04;225;Creuse;193;4;197;80225
32;80;04;18;226;Croix-Moligneaux;272;5;277;80226
32;80;02;21;227;Croixrault;447;9;456;80227
32;80;01;23;228;Le Crotoy;1989;33;2022;80228
32;80;02;04;229;Crouy-Saint-Pierre;340;2;342;80229
32;80;04;18;230;Curchy;303;8;311;80230
32;80;04;05;231;Curlu;171;2;173;80231
32;80;03;22;232;Damery;229;5;234;80232
32;80;03;22;233;Dancourt-Popincourt;156;1;157;80233
32;80;02;08;234;Daours;776;16;792;80234
32;80;01;17;235;Dargnies;1197;18;1215;80235
32;80;03;22;236;Davenescourt;575;4;579;80236
32;80;03;19;237;Démuin;524;11;535;80237
32;80;04;05;238;Dernancourt;564;9;573;80238
32;80;04;20;239;Devise;53;2;55;80239
32;80;04;20;240;Doingt;1402;44;1446;80240
32;80;02;15;241;Domart-en-Ponthieu;1065;11;1076;80241
32;80;03;19;242;Domart-sur-la-Luce;409;9;418;80242
32;80;02;14;243;Domesmont;43;0;43;80243
32;80;01;23;244;Dominois;174;3;177;80244
32;80;02;14;245;Domléger-Longvillers;302;3;305;80245
32;80;03;03;246;Dommartin;347;5;352;80246
32;80;04;18;247;Dompierre-Becquincourt;715;8;723;80247
32;80;01;23;248;Dompierre-sur-Authie;418;6;424;80248
32;80;01;23;249;Domqueur;312;7;319;80249
32;80;01;01;250;Domvast;351;4;355;80250
32;80;01;17;251;Doudelainville;351;8;359;80251
32;80;04;18;252;Douilly;251;1;252;80252
32;80;02;14;253;Doullens;5890;172;6062;80253
32;80;02;04;256;Dreuil-lès-Amiens;1639;10;1649;80256
32;80;04;20;258;Driencourt;87;3;90;80258
32;80;02;21;259;Dromesnil;87;1;88;80259
32;80;01;01;260;Drucat;924;23;947;80260
32;80;02;11;261;Dury;1464;61;1525;80261
32;80;01;02;262;Eaucourt-sur-Somme;392;14;406;80262
32;80;03;22;263;L'Echelle-Saint-Aurin;50;1;51;80263
32;80;04;05;264;Eclusier-Vaux;84;39;123;80264
32;80;01;17;265;Embreville;569;7;576;80265
32;80;04;05;266;Englebelmer;305;0;305;80266
32;80;04;18;267;Ennemain;281;2;283;80267
32;80;01;02;268;Epagne-Epagnette;530;14;544;80268
32;80;02;21;269;Epaumesnil;119;2;121;80269
32;80;02;14;270;Epécamps;5;0;5;80270
32;80;04;20;271;Epehy;1129;14;1143;80271
32;80;04;18;272;Epénancourt;124;2;126;80272
32;80;02;21;273;Eplessier;351;5;356;80273
32;80;04;18;274;Eppeville;1789;18;1807;80274
32;80;04;20;275;Equancourt;298;2;300;80275
32;80;02;21;276;Equennes-Eramecourt;286;7;293;80276
32;80;03;22;278;Erches;188;3;191;80278
32;80;03;22;279;Ercheu;769;11;780;80279
32;80;01;02;280;Ercourt;123;2;125;80280
32;80;01;23;281;Ergnies;176;1;177;80281
32;80;01;17;282;Erondelle;511;5;516;80282
32;80;03;03;283;Esclainvillers;166;0;166;80283
32;80;04;18;284;Esmery-Hallon;748;36;784;80284
32;80;02;03;285;Essertaux;260;3;263;80285
32;80;01;02;287;EstrébÅ“uf;239;4;243;80287
32;80;04;18;288;Estrées-Deniécourt;328;10;338;80288
32;80;01;23;290;Estrées-lès-Crécy;391;5;396;80290
32;80;02;03;291;Estrées-sur-Noye;272;3;275;80291
32;80;03;22;292;Etalon;135;1;136;80292
32;80;03;22;293;Etelfay;362;3;365;80293
32;80;04;20;294;Eterpigny;159;3;162;80294
32;80;04;05;295;Etinehem-Méricourt;592;7;599;80295
32;80;02;15;296;L'Etoile;1182;8;1190;80296
32;80;02;21;297;Etréjust;40;1;41;80297
32;80;04;20;298;Etricourt-Manancourt;529;3;532;80298
32;80;03;03;299;La Faloise;236;1;237;80299
32;80;04;18;300;Falvy;156;1;157;80300
32;80;02;21;301;Famechon;274;2;276;80301
32;80;03;22;302;Faverolles;170;3;173;80302
32;80;01;23;303;Favières;462;7;469;80303
32;80;04;18;304;Fay;100;2;102;80304
32;80;02;04;305;Ferrières;474;12;486;80305
32;80;03;22;306;Fescamps;133;5;138;80306
32;80;04;20;307;Feuillères;153;2;155;80307
32;80;01;17;308;Feuquières-en-Vimeu;2499;42;2541;80308
32;80;02;14;310;Fienvillers;684;12;696;80310
32;80;03;22;311;Fignières;153;2;155;80311
32;80;04;20;312;Fins;279;1;280;80312
32;80;04;20;313;Flaucourt;292;5;297;80313
32;80;04;20;314;Flers;199;3;202;80314
32;80;03;03;315;Flers-sur-Noye;508;10;518;80315
32;80;02;15;316;Flesselles;2016;24;2040;80316
32;80;02;03;317;Fleury;212;3;215;80317
32;80;02;15;318;Flixecourt;3237;73;3310;80318
32;80;02;04;319;Fluy;340;0;340;80319
32;80;04;19;320;Folies;156;1;157;80320
32;80;03;03;321;Folleville;142;2;144;80321
32;80;03;22;322;Fonches-Fonchette;170;0;170;80322
32;80;02;21;324;Fontaine-le-Sec;145;5;150;80324
32;80;04;18;325;Fontaine-lès-Cappy;51;1;52;80325
32;80;03;22;326;Fontaine-sous-Montdidier;108;2;110;80326
32;80;01;23;327;Fontaine-sur-Maye;158;5;163;80327
32;80;01;17;328;Fontaine-sur-Somme;525;5;530;80328
32;80;04;05;329;Forceville;178;1;179;80329
32;80;02;21;330;Forceville-en-Vimeu;237;6;243;80330
32;80;01;01;331;Forest-l'Abbaye;308;12;320;80331
32;80;01;01;332;Forest-Montiers;397;9;406;80332
32;80;01;23;333;Fort-Mahon-Plage;1298;13;1311;80333
32;80;02;03;334;Fossemanant;96;3;99;80334
32;80;04;18;335;Foucaucourt-en-Santerre;244;3;247;80335
32;80;02;21;336;Foucaucourt-Hors-Nesle;81;1;82;80336
32;80;03;03;337;Fouencamps;204;3;207;80337
32;80;02;13;338;Fouilloy;1829;17;1846;80338
32;80;04;19;339;Fouquescourt;154;4;158;80339
32;80;02;21;340;Fourcigny;199;2;201;80340
32;80;02;04;341;Fourdrinoy;401;9;410;80341
32;80;04;18;342;Framerville-Rainecourt;459;3;462;80342
32;80;02;21;343;Framicourt;171;2;173;80343
32;80;01;23;344;Francières;182;8;190;80344
32;80;01;02;345;Franleu;530;5;535;80345
32;80;02;15;346;Franqueville;167;1;168;80346
32;80;04;19;347;Fransart;156;2;158;80347
32;80;02;15;348;Fransu;181;4;185;80348
32;80;03;03;349;Fransures;134;1;135;80349
32;80;02;13;350;Franvillers;506;7;513;80350
32;80;02;13;351;Fréchencourt;258;2;260;80351
32;80;02;03;352;Frémontiers;157;1;158;80352
32;80;04;18;353;Fresnes-Mazancourt;151;1;152;80353
32;80;02;21;354;Fresnes-Tilloloy;204;3;207;80354
32;80;02;21;355;Fresneville;102;2;104;80355
32;80;02;21;356;Fresnoy-Andainville;90;9;99;80356
32;80;02;04;357;Fresnoy-au-Val;234;6;240;80357
32;80;03;19;358;Fresnoy-en-Chaussée;137;2;139;80358
32;80;03;22;359;Fresnoy-lès-Roye;287;9;296;80359
32;80;01;16;360;Fressenneville;2181;43;2224;80360
32;80;02;21;361;Frettecuisse;75;0;75;80361
32;80;01;17;362;Frettemeule;308;7;315;80362
32;80;01;16;364;Friaucourt;703;11;714;80364
32;80;02;21;365;Fricamps;185;0;185;80365
32;80;04;05;366;Fricourt;490;4;494;80366
32;80;04;05;367;Frise;180;5;185;80367
32;80;01;16;368;Friville-Escarbotin;4491;98;4589;80368
32;80;02;14;369;Frohen-sur-Authie;235;5;240;80369
32;80;01;23;371;Froyelles;97;4;101;80371
32;80;01;17;372;Frucourt;124;4;128;80372
32;80;01;17;373;Gamaches;2480;84;2564;80373
32;80;01;01;374;Gapennes;280;3;283;80374
32;80;02;21;375;Gauville;341;7;348;80375
32;80;02;09;376;Gentelles;652;4;656;80376
32;80;02;14;377;Gézaincourt;409;5;414;80377
32;80;04;20;378;Ginchy;66;1;67;80378
32;80;02;09;379;Glisy;826;1;827;80379
32;80;01;23;380;Gorenflos;243;5;248;80380
32;80;02;14;381;Gorges;38;1;39;80381
32;80;03;22;383;Goyencourt;92;0;92;80383
32;80;04;05;384;Grandcourt;177;1;178;80384
32;80;01;01;385;Grand-Laviers;459;28;487;80385
32;80;03;22;386;Gratibus;179;3;182;80386
32;80;02;03;387;Grattepanche;324;1;325;80387
32;80;01;02;388;Grébault-Mesnil;213;2;215;80388
32;80;03;03;390;Grivesnes;411;6;417;80390
32;80;03;22;391;Grivillers;88;0;88;80391
32;80;02;14;392;Grouches-Luchuel;576;13;589;80392
32;80;03;22;393;Gruny;312;6;318;80393
32;80;03;22;395;Guerbigny;278;5;283;80395
32;80;01;23;396;Gueschart;361;4;365;80396
32;80;04;20;397;Gueudecourt;93;4;97;80397
32;80;02;04;399;Guignemicourt;395;4;399;80399
32;80;04;19;400;Guillaucourt;413;5;418;80400
32;80;04;20;401;Guillemont;130;1;131;80401
32;80;02;21;402;Guizancourt;136;1;137;80402
32;80;03;03;403;Guyencourt-sur-Noye;184;3;187;80403
32;80;04;20;404;Guyencourt-Saulcourt;142;3;145;80404
32;80;03;19;405;Hailles;429;2;431;80405
32;80;01;17;406;Hallencourt;1302;17;1319;80406
32;80;03;03;407;Hallivillers;141;6;147;80407
32;80;02;15;408;Halloy-lès-Pernois;334;1;335;80408
32;80;04;19;409;Hallu;153;5;158;80409
32;80;04;18;410;Ham;4559;98;4657;80410
32;80;02;13;411;Le Hamel;493;6;499;80411
32;80;02;13;412;Hamelet;638;6;644;80412
32;80;04;20;413;Hancourt;90;1;91;80413
32;80;03;19;414;Hangard;123;2;125;80414
32;80;03;19;415;Hangest-en-Santerre;1012;8;1020;80415
32;80;02;04;416;Hangest-sur-Somme;770;9;779;80416
32;80;04;19;417;Harbonnières;1640;11;1651;80417
32;80;04;20;418;Hardecourt-aux-Bois;84;0;84;80418
32;80;04;05;420;Harponville;175;1;176;80420
32;80;03;22;421;Hattencourt;294;4;298;80421
32;80;01;01;422;Hautvillers-Ouville;578;10;588;80422
32;80;02;15;423;Havernas;381;5;386;80423
32;80;02;11;424;Hébécourt;540;18;558;80424
32;80;04;05;425;Hédauville;116;1;117;80425
32;80;02;13;426;Heilly;435;8;443;80426
32;80;02;14;427;Hem-Hardinval;376;8;384;80427
32;80;04;20;428;Hem-Monacu;134;2;136;80428
32;80;02;13;429;Hénencourt;193;1;194;80429
32;80;04;20;430;Herbécourt;201;7;208;80430
32;80;04;05;431;Hérissart;683;11;694;80431
32;80;04;18;432;Herleville;190;1;191;80432
32;80;03;22;433;Herly;44;0;44;80433
32;80;04;20;434;Hervilly;190;4;194;80434
32;80;04;20;435;Hesbécourt;57;0;57;80435
32;80;02;21;436;Hescamps;522;13;535;80436
32;80;02;21;437;Heucourt-Croquoison;110;4;114;80437
32;80;04;20;438;Heudicourt;511;6;517;80438
32;80;02;14;439;Heuzecourt;167;1;168;80439
32;80;02;14;440;Hiermont;153;3;156;80440
32;80;04;18;442;Hombleux;1178;10;1188;80442
32;80;02;21;443;Hornoy-le-Bourg;1681;28;1709;80443
32;80;01;02;444;Huchenneville;661;13;674;80444
32;80;02;14;445;Humbercourt;272;2;274;80445
32;80;01;17;446;Huppy;755;20;775;80446
32;80;03;19;449;Ignaucourt;69;2;71;80449
32;80;02;21;450;Inval-Boiron;112;1;113;80450
32;80;04;05;451;Irles;123;0;123;80451
32;80;03;03;452;Jumel;521;3;524;80452
32;80;03;22;453;Laboissière-en-Santerre;142;0;142;80453
32;80;02;21;455;Lachapelle;91;2;93;80455
32;80;02;21;456;Lafresguimont-Saint-Martin;554;6;560;80456
32;80;02;13;458;Lahoussoye;451;11;462;80458
32;80;02;04;459;Laleu;108;0;108;80459
32;80;02;21;460;Lamaronde;65;1;66;80460
32;80;02;08;461;Lamotte-Brebière;216;4;220;80461
32;80;01;01;462;Lamotte-Buleux;357;11;368;80462
32;80;02;13;463;Lamotte-Warfusée;702;10;712;80463
32;80;01;16;464;Lanchères;918;14;932;80464
32;80;04;18;465;Languevoisin-Quiquery;196;5;201;80465
32;80;02;15;466;Lanches-Saint-Hilaire;133;1;134;80466
32;80;03;22;467;Laucourt;194;1;195;80467
32;80;04;05;468;Laviéville;170;3;173;80468
32;80;03;03;469;Lawarde-Mauger-l'Hortoy;162;1;163;80469
32;80;04;05;470;Léalvillers;164;2;166;80470
32;80;04;20;472;LesbÅ“ufs;173;7;180;80472
32;80;03;22;473;Liancourt-Fosse;295;2;297;80473
32;80;04;18;474;Licourt;396;3;399;80474
32;80;04;20;475;Liéramont;215;7;222;80475
32;80;01;17;476;Liercourt;372;4;376;80476
32;80;01;23;477;Ligescourt;222;4;226;80477
32;80;03;22;478;Lignières;145;2;147;80478
32;80;02;21;479;Lignières-Châtelain;354;6;360;80479
32;80;02;21;480;Lignières-en-Vimeu;113;2;115;80480
32;80;04;18;481;Lihons;458;5;463;80481
32;80;01;17;482;Limeux;140;2;142;80482
32;80;02;21;484;Liomer;388;6;394;80484
32;80;02;03;485;Ã”-de-Selle;1179;9;1188;80485
32;80;01;23;486;Long;618;8;626;80486
32;80;04;20;487;Longavesnes;79;2;81;80487
32;80;01;17;488;Longpré-les-Corps-Saints;1587;29;1616;80488
32;80;02;09;489;Longueau;5765;45;5810;80489
32;80;04;20;490;Longueval;273;9;282;80490
32;80;02;14;491;Longuevillette;75;1;76;80491
32;80;04;05;493;Louvencourt;294;5;299;80493
32;80;03;03;494;Louvrechy;201;3;204;80494
32;80;02;14;495;Lucheux;521;4;525;80495
32;80;01;23;496;Machiel;154;1;155;80496
32;80;01;23;497;Machy;118;5;123;80497
32;80;04;05;498;Mailly-Maillet;632;5;637;80498
32;80;03;03;499;Mailly-Raineval;300;6;306;80499
32;80;01;17;500;Maisnières;531;7;538;80500
32;80;01;23;501;Maison-Ponthieu;283;3;286;80501
32;80;01;23;502;Maison-Roland;101;3;104;80502
32;80;02;14;503;Maizicourt;186;2;188;80503
32;80;03;22;504;Malpart;76;0;76;80504
32;80;04;05;505;Carnoy-Mametz;292;4;296;80505
32;80;02;13;507;Marcelcave;1263;19;1282;80507
32;80;03;22;508;Marché-Allouarde;51;0;51;80508
32;80;04;18;509;Marchélepot-Misery;598;6;604;80509
32;80;03;22;511;Marestmontiers;111;1;112;80511
32;80;01;02;512;Mareuil-Caubert;836;11;847;80512
32;80;04;05;513;Maricourt;180;3;183;80513
32;80;04;05;514;Marieux;129;1;130;80514
32;80;02;21;515;Marlers;144;2;146;80515
32;80;04;20;516;Marquaix;194;1;195;80516
32;80;03;22;517;Marquivillers;197;3;200;80517
32;80;01;17;518;Martainneville;425;3;428;80518
32;80;04;18;519;Matigny;502;7;509;80519
32;80;04;19;520;Maucourt;182;3;185;80520
32;80;04;20;521;Maurepas;211;0;211;80521
32;80;02;21;522;Le Mazis;107;0;107;80522
32;80;04;05;523;Méaulte;1259;22;1281;80523
32;80;04;19;524;Méharicourt;588;6;594;80524
32;80;02;21;525;Meigneux;179;3;182;80525
32;80;02;14;526;Le Meillard;155;3;158;80526
32;80;01;16;527;Méneslies;303;7;310;80527
32;80;02;21;528;Méréaucourt;9;0;9;80528
32;80;01;17;529;Mérélessart;193;4;197;80529
32;80;02;13;530;Méricourt-l'Abbé;607;4;611;80530
32;80;02;21;531;Méricourt-en-Vimeu;102;0;102;80531
32;80;01;16;533;Mers-les-Bains;2655;56;2711;80533
32;80;02;04;535;Le Mesge;161;5;166;80535
32;80;04;20;536;Mesnil-Bruntel;287;3;290;80536
32;80;01;23;537;Mesnil-Domqueur;89;0;89;80537
32;80;04;20;538;Mesnil-en-Arrouaise;122;0;122;80538
32;80;04;05;540;Mesnil-Martinsart;235;4;239;80540
32;80;03;22;541;Mesnil-Saint-Georges;198;3;201;80541
32;80;04;18;542;Mesnil-Saint-Nicaise;561;6;567;80542
32;80;02;04;543;Métigny;117;3;120;80543
32;80;02;14;544;Mézerolles;184;3;187;80544
32;80;03;19;545;Mézières-en-Santerre;559;7;566;80545
32;80;01;02;546;Miannay;584;12;596;80546
32;80;04;05;547;Millencourt;205;4;209;80547
32;80;01;01;548;Millencourt-en-Ponthieu;354;2;356;80548
32;80;04;05;549;Miraumont;655;12;667;80549
32;80;02;13;550;Mirvaux;130;4;134;80550
32;80;04;20;552;Moislains;1153;22;1175;80552
32;80;02;13;553;Molliens-au-Bois;327;10;337;80553
32;80;02;04;554;Molliens-Dreuil;980;9;989;80554
32;80;04;18;555;Monchy-Lagache;601;19;620;80555
32;80;01;02;556;Mons-Boubert;552;6;558;80556
32;80;04;20;557;Estrées-Mons;594;11;605;80557
32;80;02;03;558;Monsures;223;3;226;80558
32;80;02;04;559;Montagne-Fayel;143;3;146;80559
32;80;04;05;560;Montauban-de-Picardie;214;1;215;80560
32;80;03;22;561;Montdidier;6113;105;6218;80561
32;80;02;13;562;Montigny-sur-l'Hallue;206;2;208;80562
32;80;02;14;563;Montigny-les-Jongleurs;96;1;97;80563
32;80;02;07;565;Montonvillers;82;2;84;80565
32;80;02;14;566;Fieffes-Montrelet;341;8;349;80566
32;80;04;18;568;Morchain;347;4;351;80568
32;80;02;13;569;Morcourt;327;3;330;80569
32;80;03;19;570;Moreuil;3986;28;4014;80570
32;80;03;19;571;Morisel;497;9;506;80571
32;80;04;05;572;Morlancourt;367;2;369;80572
32;80;02;21;573;Morvillers-Saint-Saturnin;398;5;403;80573
32;80;01;23;574;Mouflers;95;1;96;80574
32;80;02;21;575;Mouflières;80;8;88;80575
32;80;04;18;576;Moyencourt;321;0;321;80576
32;80;02;21;577;Moyencourt-lès-Poix;183;1;184;80577
32;80;01;02;578;Moyenneville;719;11;730;80578
32;80;04;18;579;Muille-Villette;851;12;863;80579
32;80;01;23;580;Nampont;250;3;253;80580
32;80;02;03;582;Namps-Maisnil;1002;15;1017;80582
32;80;02;03;583;Nampty;290;8;298;80583
32;80;02;13;584;Naours;1078;10;1088;80584
32;80;04;18;585;Nesle;2314;30;2344;80585
32;80;02;21;586;Nesle-l'Hôpital;156;1;157;80586
32;80;02;21;587;Neslette;82;2;84;80587
32;80;01;01;588;Neufmoulin;359;7;366;80588
32;80;01;23;589;Neuilly-le-Dien;100;0;100;80589
32;80;01;01;590;Neuilly-l'Hôpital;321;12;333;80590
32;80;02;21;591;Neuville-au-Bois;151;1;152;80591
32;80;02;21;592;Neuville-Coppegueule;507;7;514;80592
32;80;04;05;593;La Neuville-lès-Bray;254;2;256;80593
32;80;03;19;595;La Neuville-Sire-Bernard;301;1;302;80595
32;80;02;14;596;Neuvillette;221;6;227;80596
32;80;01;16;597;Nibas;852;15;867;80597
32;80;01;01;598;Nouvion;1259;37;1296;80598
32;80;01;23;599;Noyelles-en-Chaussée;241;3;244;80599
32;80;01;01;600;Noyelles-sur-Mer;685;10;695;80600
32;80;04;20;601;Nurlu;373;4;377;80601
32;80;02;14;602;Occoches;129;3;132;80602
32;80;01;16;603;Ochancourt;334;1;335;80603
32;80;02;21;604;Offignies;80;3;83;80604
32;80;04;18;605;Offoy;207;2;209;80605
32;80;02;21;606;Oisemont;1148;45;1193;80606
32;80;02;04;607;Oissy;212;3;215;80607
32;80;01;23;609;Oneux;408;6;414;80609
32;80;02;03;611;Oresmaux;924;11;935;80611
32;80;01;16;613;Oust-Marest;621;12;633;80613
32;80;02;14;614;Outrebois;317;6;323;80614
32;80;04;05;615;Ovillers-la-Boisselle;437;3;440;80615
32;80;04;18;616;Pargny;199;1;200;80616
32;80;04;19;617;Parvillers-le-Quesnoy;231;3;234;80617
32;80;01;16;618;Pendé;1051;14;1065;80618
32;80;02;15;619;Pernois;728;8;736;80619
32;80;04;20;620;Péronne;7577;207;7784;80620
32;80;04;18;621;Hypercourt;723;11;734;80621
32;80;02;04;622;Picquigny;1311;16;1327;80622
32;80;03;22;623;Piennes-Onvillers;371;6;377;80623
32;80;02;13;624;Pierregot;282;5;287;80624
32;80;03;22;625;Trois-Rivières;1516;12;1528;80625
32;80;02;04;626;Pissy;292;2;294;80626
32;80;02;03;627;Plachy-Buyon;829;20;849;80627
32;80;03;19;628;Le Plessier-Rozainvillers;776;4;780;80628
32;80;04;20;629;PÅ“uilly;108;2;110;80629
32;80;02;21;630;Poix-de-Picardie;2358;39;2397;80630
32;80;01;23;631;Ponches-Estruval;98;3;101;80631
32;80;02;12;632;Pont-de-Metz;2411;37;2448;80632
32;80;01;01;633;Ponthoile;608;10;618;80633
32;80;02;13;634;Pont-Noyelles;821;17;838;80634
32;80;01;23;635;Pont-Remy;1459;22;1481;80635
32;80;01;01;637;Port-le-Grand;288;1;289;80637
32;80;04;18;638;Potte;108;6;114;80638
32;80;02;07;639;Poulainville;1236;23;1259;80639
32;80;04;05;640;Pozières;266;3;269;80640
32;80;02;14;642;Prouville;321;2;323;80642
32;80;02;03;643;Prouzel;558;8;566;80643
32;80;04;18;644;Proyart;728;11;739;80644
32;80;04;05;645;Puchevillers;556;3;559;80645
32;80;04;18;646;Punchy;92;4;96;80646
32;80;04;18;647;Puzeaux;293;3;296;80647
32;80;04;05;648;Pys;121;1;122;80648
32;80;01;23;649;Quend;1313;29;1342;80649
32;80;02;07;650;Querrieu;632;17;649;80650
32;80;02;21;651;Le Quesne;265;2;267;80651
32;80;03;19;652;Le Quesnel;780;9;789;80652
32;80;01;02;654;Quesnoy-le-Montant;543;18;561;80654
32;80;02;04;655;Quesnoy-sur-Airaines;428;5;433;80655
32;80;02;04;656;Quevauvillers;1085;10;1095;80656
32;80;03;03;657;Quiry-le-Sec;322;2;324;80657
32;80;04;18;658;Quivières;144;3;147;80658
32;80;04;05;659;Raincheval;271;6;277;80659
32;80;02;07;661;Rainneville;1010;7;1017;80661
32;80;01;17;662;Ramburelles;284;2;286;80662
32;80;02;21;663;Rambures;340;7;347;80663
32;80;04;20;664;Rancourt;192;3;195;80664
32;80;01;23;665;Regnière-Ecluse;123;3;126;80665
32;80;02;14;666;Remaisnil;32;0;32;80666
32;80;03;22;667;Remaugies;132;0;132;80667
32;80;02;03;668;Remiencourt;168;3;171;80668
32;80;04;18;669;Rethonvillers;351;6;357;80669
32;80;02;04;670;Revelles;497;8;505;80670
32;80;02;15;671;Ribeaucourt;234;7;241;80671
32;80;02;13;672;Ribemont-sur-Ancre;648;12;660;80672
32;80;02;04;673;Riencourt;175;7;182;80673
32;80;02;08;674;Rivery;3599;34;3633;80674
32;80;03;03;675;Rogy;127;2;129;80675
32;80;03;22;676;Roiglise;154;7;161;80676
32;80;04;20;677;Roisel;1593;19;1612;80677
32;80;03;22;678;Rollot;770;19;789;80678
32;80;04;20;679;Ronssoy;591;5;596;80679
32;80;04;19;680;Rosières-en-Santerre;3017;25;3042;80680
32;80;03;03;681;Rouvrel;309;8;317;80681
32;80;04;19;682;Rouvroy-en-Santerre;213;6;219;80682
32;80;04;18;683;Rouy-le-Grand;103;3;106;80683
32;80;04;18;684;Rouy-le-Petit;109;4;113;80684
32;80;03;22;685;Roye;5693;61;5754;80685
32;80;02;13;686;Rubempré;728;9;737;80686
32;80;03;22;687;Rubescourt;133;2;135;80687
32;80;01;23;688;Rue;3111;91;3202;80688
32;80;02;11;690;Rumigny;628;9;637;80690
32;80;01;02;691;Saigneville;353;13;366;80691
32;80;01;01;692;Sailly-Flibeaucourt;1023;18;1041;80692
32;80;02;13;693;Sailly-Laurette;327;1;328;80693
32;80;02;13;694;Sailly-le-Sec;350;6;356;80694
32;80;04;20;695;Sailly-Saillisel;483;6;489;80695
32;80;02;11;696;Sains-en-Amiénois;1220;32;1252;80696
32;80;02;14;697;Saint-Acheul;32;0;32;80697
32;80;02;04;698;Saint-Aubin-Montenoy;221;4;225;80698
32;80;02;21;699;Saint-Aubin-Rivière;111;0;111;80699
32;80;01;16;700;Saint-Blimont;878;16;894;80700
32;80;04;18;701;Saint-Christ-Briost;432;10;442;80701
32;80;02;11;702;Saint-Fuscien;1309;27;1336;80702
32;80;02;21;703;Saint-Germain-sur-Bresle;203;3;206;80703
32;80;02;07;704;Saint-Gratien;382;5;387;80704
32;80;04;05;705;Saint-Léger-lès-Authie;82;1;83;80705
32;80;02;15;706;Saint-Léger-lès-Domart;1854;16;1870;80706
32;80;02;21;707;Saint-Léger-sur-Bresle;75;4;79;80707
32;80;03;22;708;Saint-Mard;155;3;158;80708
32;80;02;21;709;Saint-Maulvis;268;8;276;80709
32;80;01;17;710;Saint-Maxent;395;5;400;80710
32;80;02;15;711;Saint-Ouen;1828;15;1843;80711
32;80;01;23;713;Saint-Quentin-en-Tourmont;281;5;286;80713
32;80;01;16;714;Saint-Quentin-la-Motte-Croix-au-Bailly;1280;21;1301;80714
32;80;01;23;716;Saint-Riquier;1265;29;1294;80716
32;80;02;03;717;Saint-Sauflieu;992;7;999;80717
32;80;02;04;718;Saint-Sauveur;1341;16;1357;80718
32;80;02;21;719;Sainte-Segrée;52;5;57;80719
32;80;01;02;721;Saint-Valery-sur-Somme;2469;41;2510;80721
32;80;02;15;722;Saint-Vaast-en-Chaussée;488;7;495;80722
32;80;02;04;723;Saisseval;240;1;241;80723
32;80;02;12;724;Saleux;2805;30;2835;80724
32;80;02;12;725;SalouÃ«l;3918;54;3972;80725
32;80;04;18;726;Sancourt;265;6;271;80726
32;80;02;21;728;Saulchoy-sous-Poix;75;0;75;80728
32;80;03;03;729;Sauvillers-Mongival;177;0;177;80729
32;80;02;04;730;Saveuse;952;8;960;80730
32;80;02;21;732;Senarpont;628;14;642;80732
32;80;04;05;733;Senlis-le-Sec;307;3;310;80733
32;80;02;03;734;Sentelie;212;3;215;80734
32;80;02;04;735;Seux;167;2;169;80735
32;80;01;17;736;Sorel-en-Vimeu;208;5;213;80736
32;80;04;20;737;Sorel;161;1;162;80737
32;80;02;04;738;Soues;126;3;129;80738
32;80;03;03;740;Sourdon;344;2;346;80740
32;80;04;18;741;Soyécourt;190;4;194;80741
32;80;02;15;742;Surcamps;65;2;67;80742
32;80;04;05;743;Suzanne;192;4;196;80743
32;80;02;04;744;Tailly;57;2;59;80744
32;80;02;13;746;Talmas;1069;12;1081;80746
32;80;04;20;747;Templeux-la-Fosse;136;3;139;80747
32;80;04;20;748;Templeux-le-Guérard;185;3;188;80748
32;80;02;14;749;Terramesnil;317;4;321;80749
32;80;04;18;750;Tertry;146;1;147;80750
32;80;03;19;751;Thennes;580;6;586;80751
32;80;02;03;752;Thézy-Glimont;678;8;686;80752
32;80;04;05;753;Thiepval;124;2;126;80753
32;80;02;21;754;Thieulloy-l'Abbaye;399;4;403;80754
32;80;02;21;755;Thieulloy-la-Ville;147;4;151;80755
32;80;04;05;756;Thièvres;63;0;63;80756
32;80;02;03;757;Thoix;146;2;148;80757
32;80;03;03;758;Thory;207;0;207;80758
32;80;03;22;759;Tilloloy;349;9;358;80759
32;80;01;17;760;Tilloy-Floriville;378;10;388;80760
32;80;04;20;762;Tincourt-Boucly;346;10;356;80762
32;80;01;01;763;Le Titre;344;8;352;80763
32;80;01;02;764;TÅ“ufles;296;7;303;80764
32;80;01;02;765;Tours-en-Vimeu;809;10;819;80765
32;80;04;05;766;Toutencourt;439;5;444;80766
32;80;02;21;767;Le Translay;258;6;264;80767
32;80;02;13;769;Treux;232;0;232;80769
32;80;01;16;770;Tully;538;9;547;80770
32;80;04;18;771;Ugny-l'Equipée;33;0;33;80771
32;80;02;13;773;Vadencourt;104;0;104;80773
32;80;02;13;774;Vaire-sous-Corbie;291;3;294;80774
32;80;01;16;775;Valines;632;6;638;80775
32;80;04;05;776;Varennes;218;1;219;80776
32;80;04;05;777;Vauchelles-lès-Authie;139;1;140;80777
32;80;02;15;778;Vauchelles-lès-Domart;127;0;127;80778
32;80;01;01;779;Vauchelles-les-Quesnoy;848;19;867;80779
32;80;01;16;780;Vaudricourt;406;5;411;80780
32;80;04;18;781;Vauvillers;225;5;230;80781
32;80;02;15;782;Vaux-en-Amiénois;418;7;425;80782
32;80;01;17;783;Vaux-Marquenneville;84;1;85;80783
32;80;02;13;784;Vaux-sur-Somme;306;6;312;80784
32;80;02;08;785;Vecquemont;544;9;553;80785
32;80;02;03;786;Velennes;149;0;149;80786
32;80;01;23;787;Vercourt;95;1;96;80787
32;80;02;21;788;Vergies;173;2;175;80788
32;80;04;18;789;Vermandovillers;152;0;152;80789
32;80;03;22;790;Verpillières;169;3;172;80790
32;80;02;12;791;Vers-sur-Selle;732;6;738;80791
32;80;02;13;792;La Vicogne;246;1;247;80792
32;80;02;15;793;Vignacourt;2338;34;2372;80793
32;80;04;18;794;Villecourt;57;1;58;80794
32;80;02;15;795;Ville-le-Marclet;469;42;511;80795
32;80;02;21;796;Villeroy;182;6;188;80796
32;80;03;19;797;Villers-aux-Erables;138;3;141;80797
32;80;02;07;798;Villers-Bocage;1435;53;1488;80798
32;80;02;09;799;Villers-Bretonneux;4592;56;4648;80799
32;80;02;21;800;Villers-Campsart;143;7;150;80800
32;80;04;20;801;Villers-Carbonnel;330;4;334;80801
32;80;04;20;802;Villers-Faucon;557;9;566;80802
32;80;03;22;803;Villers-lès-Roye;275;0;275;80803
32;80;01;23;804;Villers-sous-Ailly;179;5;184;80804
32;80;03;22;805;Villers-Tournelle;159;6;165;80805
32;80;01;23;806;Villers-sur-Authie;471;8;479;80806
32;80;04;05;807;Ville-sur-Ancre;266;3;269;80807
32;80;01;23;808;Vironchaux;498;9;507;80808
32;80;01;17;809;Vismes;477;12;489;80809
32;80;01;23;810;Vitz-sur-Authie;135;1;136;80810
32;80;04;18;811;Voyennes;591;7;598;80811
32;80;04;20;812;Vraignes-en-Vermandois;139;3;142;80812
32;80;02;21;813;Vraignes-lès-Hornoy;97;3;100;80813
32;80;04;19;814;Vrély;449;9;458;80814
32;80;01;23;815;Vron;836;26;862;80815
32;80;02;13;819;Wargnies;84;3;87;80819
32;80;02;13;820;Warloy-Baillon;753;10;763;80820
32;80;02;04;821;Warlus;220;5;225;80821
32;80;03;22;822;Warsy;143;2;145;80822
32;80;04;19;823;Warvillers;134;10;144;80823
32;80;04;19;824;Wiencourt-l'Equipée;270;2;272;80824
32;80;01;17;825;Wiry-au-Mont;115;1;116;80825
32;80;01;16;826;Woignarue;791;17;808;80826
32;80;01;16;827;Woincourt;1239;14;1253;80827
32;80;02;21;828;Woirel;67;0;67;80828
32;80;04;18;829;Y;91;2;93;80829
32;80;01;23;830;Yaucourt-Bussus;245;5;250;80830
32;80;01;23;832;Yvrench;305;4;309;80832
32;80;01;23;833;Yvrencheux;123;2;125;80833
32;80;01;16;834;Yzengremer;514;42;556;80834
32;80;02;04;835;Yzeux;269;0;269;80835
32;80;01;02;836;Yonval;220;7;227;80836
76;81;02;15;001;Aguts;226;9;235;81001
76;81;02;16;002;Aiguefonde;2512;57;2569;81002
76;81;01;13;003;Alban;928;36;964;81003
76;81;01;96;004;Albi;48902;1723;50625;81004
76;81;02;17;005;Albine;518;5;523;81005
76;81;02;15;006;Algans;198;3;201;81006
76;81;01;23;007;Alos;95;2;97;81007
76;81;01;05;008;Almayrac;294;4;298;81008
76;81;01;06;009;Amarens;68;0;68;81009
76;81;01;13;010;Ambialet;467;6;473;81010
76;81;02;21;011;Ambres;1010;40;1050;81011
76;81;01;23;012;Andillac;121;1;122;81012
76;81;01;05;013;Andouque;406;8;414;81013
76;81;02;14;014;Anglès;502;8;510;81014
76;81;02;19;015;Appelle;73;1;74;81015
76;81;02;18;016;Arfons;165;7;172;81016
76;81;02;13;017;Arifat;160;1;161;81017
76;81;01;22;018;Arthès;2512;50;2562;81018
76;81;01;05;019;Assac;143;1;144;81019
76;81;01;10;020;Aussac;271;12;283;81020
76;81;02;16;021;Aussillon;5827;135;5962;81021
76;81;02;15;022;Bannières;203;7;210;81022
76;81;02;14;023;Barre;208;2;210;81023
76;81;01;23;024;Beauvais-sur-Tescou;363;9;372;81024
76;81;02;15;025;Belcastel;244;9;253;81025
76;81;01;13;026;Bellegarde-Marsal;703;7;710;81026
76;81;02;18;027;Belleserre;158;2;160;81027
76;81;02;14;028;Berlats;103;1;104;81028
76;81;01;10;029;Bernac;186;5;191;81029
76;81;02;19;030;Bertre;111;1;112;81030
76;81;02;14;031;Le Bez;821;18;839;81031
76;81;02;19;032;Blan;1135;19;1154;81032
76;81;01;06;033;Blaye-les-Mines;2946;186;3132;81033
76;81;02;16;034;Boissezon;387;7;394;81034
76;81;01;06;035;Bournazel;218;7;225;81035
76;81;02;17;036;Bout-du-Pont-de-Larn;1267;22;1289;81036
76;81;02;14;037;Brassac;1305;33;1338;81037
76;81;01;11;038;Brens;2341;64;2405;81038
76;81;02;12;039;Briatexte;2040;30;2070;81039
76;81;02;20;040;Brousse;427;11;438;81040
76;81;01;11;041;Broze;121;1;122;81041
76;81;02;08;042;Burlats;2053;41;2094;81042
76;81;02;12;043;Busque;736;13;749;81043
76;81;02;20;044;Cabanès;303;4;307;81044
76;81;01;06;045;Les Cabannes;369;9;378;81045
76;81;01;10;046;Cadalen;1529;45;1574;81046
76;81;01;05;047;Cadix;225;7;232;81047
76;81;01;03;048;Cagnac-les-Mines;2578;32;2610;81048
76;81;02;18;049;Cahuzac;350;3;353;81049
76;81;02;15;050;Cambon-lès-Lavaur;342;10;352;81050
76;81;01;23;051;Cahuzac-sur-Vère;1158;20;1178;81051
76;81;01;22;052;Cambon;2128;56;2184;81052
76;81;02;14;053;Cambounès;334;10;344;81053
76;81;02;19;054;Cambounet-sur-le-Sor;939;28;967;81054
76;81;02;18;055;Les Cammazes;349;1;350;81055
76;81;01;23;056;Campagnac;157;2;159;81056
76;81;02;20;058;Carbes;230;7;237;81058
76;81;01;02;059;Carlus;669;15;684;81059
76;81;01;97;060;Carmaux;9782;156;9938;81060
76;81;01;10;061;Castanet;191;2;193;81061
76;81;02;14;062;Fontrieu;935;18;953;81062
76;81;01;03;063;Castelnau-de-Lévis;1621;38;1659;81063
76;81;01;23;064;Castelnau-de-Montmiral;1041;25;1066;81064
76;81;02;98;065;Castres;42079;1470;43549;81065
76;81;02;16;066;Caucalières;280;6;286;81066
76;81;01;10;067;Cestayrols;469;16;485;81067
76;81;01;06;068;Combefa;153;6;159;81068
76;81;01;06;069;Cordes-sur-Ciel;822;39;861;81069
76;81;01;21;070;Coufouleux;2939;54;2993;81070
76;81;01;05;071;Courris;79;3;82;81071
76;81;01;05;072;Crespin;134;3;137;81072
76;81;01;05;073;Crespinet;177;1;178;81073
76;81;01;22;074;Cunac;1607;62;1669;81074
76;81;02;20;075;Cuq;502;11;513;81075
76;81;02;15;076;Cuq-Toulza;698;20;718;81076
76;81;01;13;077;Curvalle;399;10;409;81077
76;81;02;20;078;Damiatte;1028;18;1046;81078
76;81;01;22;079;Dénat;803;33;836;81079
76;81;01;06;080;Donnazac;71;2;73;81080
76;81;02;18;081;Dourgne;1311;36;1347;81081
76;81;01;05;082;Le Dourn;111;1;112;81082
76;81;02;18;083;Durfort;246;1;247;81083
76;81;02;18;084;Escoussens;614;21;635;81084
76;81;02;14;085;Escroux;45;1;46;81085
76;81;02;14;086;Espérausses;173;3;176;81086
76;81;01;10;087;Fayssac;357;10;367;81087
76;81;01;13;088;Fauch;554;14;568;81088
76;81;01;05;089;Faussergues;136;5;141;81089
76;81;01;10;090;Fénols;253;6;259;81090
76;81;02;20;092;Fiac;926;15;941;81092
76;81;01;10;093;Florentin;682;46;728;81093
76;81;01;05;094;Fraissines;93;3;96;81094
76;81;01;06;095;Frausseilles;83;1;84;81095
76;81;01;13;096;Le Fraysse;410;5;415;81096
76;81;01;22;097;Fréjairolles;1328;35;1363;81097
76;81;02;20;098;Fréjeville;701;20;721;81098
76;81;01;11;099;Gaillac;15265;323;15588;81099
76;81;02;19;100;Garrevaques;402;10;412;81100
76;81;01;04;101;Le Garric;1270;18;1288;81101
76;81;02;21;102;Garrigues;271;14;285;81102
76;81;02;14;103;Gijounet;134;7;141;81103
76;81;02;21;104;Giroussens;1506;36;1542;81104
76;81;02;12;105;Graulhet;12844;245;13089;81105
76;81;01;23;106;Grazac;618;11;629;81106
76;81;01;06;108;Itzac;168;1;169;81108
76;81;02;20;109;Jonquières;438;7;445;81109
76;81;01;05;110;Jouqueviel;96;3;99;81110
76;81;01;06;111;Labarthe-Bleys;77;0;77;81111
76;81;01;10;112;Labastide-de-Lévis;937;24;961;81112
76;81;01;06;114;Labastide-Gabausse;513;12;525;81114
76;81;02;17;115;Labastide-Rouairoux;1414;25;1439;81115
76;81;02;15;116;Labastide-Saint-Georges;1937;46;1983;81116
76;81;01;10;117;Labessière-Candeil;753;22;775;81117
76;81;02;20;118;Laboulbène;152;4;156;81118
76;81;01;13;119;Laboutarie;489;6;495;81119
76;81;02;18;120;Labruguière;6506;114;6620;81120
76;81;02;17;121;Lacabarède;298;1;299;81121
76;81;01;05;122;Lacapelle-Pinet;81;2;83;81122
76;81;01;06;123;Lacapelle-Ségalar;95;3;98;81123
76;81;02;14;124;Lacaune;2464;77;2541;81124
76;81;02;14;125;Lacaze;310;8;318;81125
76;81;02;15;126;Lacougotte-Cadoul;179;8;187;81126
76;81;02;15;127;Lacroisille;109;7;116;81127
76;81;02;14;128;Lacrouzette;1590;35;1625;81128
76;81;02;18;129;Lagardiolle;232;5;237;81129
76;81;02;16;130;Lagarrigue;1818;35;1853;81130
76;81;01;10;131;Lagrave;2213;41;2254;81131
76;81;02;20;132;Guitalens-L'Albarède;825;12;837;81132
76;81;01;13;133;Lamillarié;504;13;517;81133
76;81;02;14;134;Lamontélarié;58;0;58;81134
76;81;01;06;135;Laparrouquial;96;0;96;81135
76;81;01;23;136;Larroque;153;3;156;81136
76;81;02;14;137;Lasfaillades;87;1;88;81137
76;81;01;10;138;Lasgraisses;550;9;559;81138
76;81;02;20;139;Lautrec;1731;51;1782;81139
76;81;02;15;140;Lavaur;10879;426;11305;81140
76;81;01;05;141;Lédas-et-Penthiès;149;5;154;81141
76;81;02;19;142;Lempaut;889;14;903;81142
76;81;02;19;143;Lescout;731;13;744;81143
76;81;01;04;144;Lescure-d'Albigeois;4574;91;4665;81144
76;81;01;23;145;Lisle-sur-Tarn;4676;84;4760;81145
76;81;01;06;146;Livers-Cazelles;230;5;235;81146
76;81;01;13;147;Lombers;1139;14;1153;81147
76;81;01;06;148;Loubers;75;6;81;81148
76;81;01;21;149;Loupiac;421;15;436;81149
76;81;02;21;150;Lugan;424;13;437;81150
76;81;02;20;151;Magrin;128;6;134;81151
76;81;01;03;152;Mailhoc;319;3;322;81152
76;81;01;06;154;Marnaves;76;1;77;81154
76;81;01;03;156;Marssac-sur-Tarn;3395;79;3474;81156
76;81;02;15;157;Marzens;312;11;323;81157
76;81;02;14;158;Le Masnau-Massuguiès;265;6;271;81158
76;81;02;15;159;Massac-Séran;405;18;423;81159
76;81;02;18;160;Massaguel;372;8;380;81160
76;81;01;13;161;Massals;108;1;109;81161
76;81;02;15;162;Maurens-Scopont;162;2;164;81162
76;81;02;99;163;Mazamet;9996;422;10418;81163
76;81;01;23;164;Mézens;509;12;521;81164
76;81;01;06;165;Milhars;247;3;250;81165
76;81;01;03;166;Milhavet;91;3;94;81166
76;81;01;13;167;Miolles;105;1;106;81167
76;81;01;05;168;Mirandol-Bourgnounac;1046;22;1068;81168
76;81;02;12;169;Missècle;98;1;99;81169
76;81;01;06;170;Monestiés;1358;13;1371;81170
76;81;01;10;171;Montans;1513;32;1545;81171
76;81;01;05;172;Montauriol;59;0;59;81172
76;81;02;15;173;Montcabrier;319;7;326;81173
76;81;02;20;174;Montdragon;623;6;629;81174
76;81;01;23;175;Montdurausse;441;5;446;81175
76;81;01;23;176;Montels;104;5;109;81176
76;81;02;08;177;Montfa;493;6;499;81177
76;81;01;23;178;Montgaillard;367;13;380;81178
76;81;02;15;179;Montgey;280;8;288;81179
76;81;01;06;180;Montirat;249;9;258;81180
76;81;02;20;181;Montpinier;190;4;194;81181
76;81;02;13;182;Montredon-Labessonnié;1987;42;2029;81182
76;81;02;13;183;Mont-Roc;188;6;194;81183
76;81;01;06;184;Montrosier;35;0;35;81184
76;81;01;23;185;Montvalen;237;3;240;81185
76;81;01;05;186;Moularès;262;5;267;81186
76;81;02;12;187;Moulayrès;211;3;214;81187
76;81;02;14;188;Moulin-Mage;316;3;319;81188
76;81;02;15;189;Mouzens;126;2;128;81189
76;81;01;13;190;Mouzieys-Teulet;534;9;543;81190
76;81;01;06;191;Mouzieys-Panens;236;1;237;81191
76;81;02;14;192;Murat-sur-Vèbre;862;12;874;81192
76;81;02;14;193;Nages;338;4;342;81193
76;81;02;09;195;Navès;691;23;714;81195
76;81;02;16;196;Noailhac;850;21;871;81196
76;81;01;06;197;Noailles;213;4;217;81197
76;81;01;13;198;Orban;329;4;333;81198
76;81;01;05;199;Padiès;189;3;192;81199
76;81;02;19;200;Palleville;433;52;485;81200
76;81;01;05;201;Pampelonne;840;20;860;81201
76;81;01;10;202;Parisot;960;18;978;81202
76;81;01;13;203;Paulinet;559;8;567;81203
76;81;02;16;204;Payrin-Augmontel;2170;37;2207;81204
76;81;02;15;205;Péchaudier;193;9;202;81205
76;81;01;06;206;Penne;586;19;605;81206
76;81;02;20;207;Peyregoux;78;29;107;81207
76;81;01;10;208;Peyrole;594;11;605;81208
76;81;02;17;209;Pont-de-Larn;2775;79;2854;81209
76;81;02;19;210;Poudis;261;7;268;81210
76;81;01;13;211;Poulan-Pouzols;495;10;505;81211
76;81;02;20;212;Prades;125;4;129;81212
76;81;02;20;213;Pratviel;89;2;91;81213
76;81;02;15;214;Puéchoursi;101;1;102;81214
76;81;02;12;215;Puybegon;638;9;647;81215
76;81;02;20;216;Puycalvel;213;3;216;81216
76;81;01;23;217;Puycelsi;452;11;463;81217
76;81;01;02;218;Puygouzon;3510;80;3590;81218
76;81;02;19;219;Puylaurens;3160;72;3232;81219
76;81;01;23;220;Rabastens;5713;146;5859;81220
76;81;02;13;221;Rayssac;236;1;237;81221
76;81;01;13;222;Réalmont;3480;58;3538;81222
76;81;02;17;223;Le Rialet;54;0;54;81223
76;81;01;06;224;Le Riols;101;0;101;81224
76;81;01;10;225;Rivières;1064;30;1094;81225
76;81;02;08;227;Roquecourbe;2187;46;2233;81227
76;81;01;23;228;Roquemaure;458;10;468;81228
76;81;02;15;229;Roquevidal;131;4;135;81229
76;81;01;05;230;Rosières;731;14;745;81230
76;81;02;17;231;Rouairoux;378;7;385;81231
76;81;01;02;232;Rouffiac;626;13;639;81232
76;81;01;13;233;Terre-de-Bancalié;1717;27;1744;81233
76;81;01;06;234;Roussayrolles;86;3;89;81234
76;81;02;18;235;Saint-Affrique-les-Montagnes;723;28;751;81235
76;81;02;21;236;Saint-Agnan;254;8;262;81236
76;81;02;18;237;Saint-Amancet;186;3;189;81237
76;81;02;17;238;Saint-Amans-Soult;1527;123;1650;81238
76;81;02;17;239;Saint-Amans-Valtoret;877;12;889;81239
76;81;01;13;240;Saint-André;101;4;105;81240
76;81;02;18;242;Saint-Avit;260;3;263;81242
76;81;01;23;243;Saint-Beauzile;133;2;135;81243
76;81;01;06;244;Saint-Benoît-de-Carmaux;2094;34;2128;81244
76;81;01;06;245;Saint-Christophe;124;6;130;81245
76;81;01;23;246;Sainte-Cécile-du-Cayrou;111;2;113;81246
76;81;01;05;247;Saint-Cirgue;208;3;211;81247
76;81;02;12;248;Saint-Gauzens;889;20;909;81248
76;81;01;05;249;Sainte-Gemme;925;13;938;81249
76;81;02;20;250;Saint-Genest-de-Contest;281;9;290;81250
76;81;02;19;251;Saint-Germain-des-Prés;932;18;950;81251
76;81;02;08;252;Saint-Germier;145;1;146;81252
76;81;01;05;253;Saint-Grégoire;456;7;463;81253
76;81;01;05;254;Saint-Jean-de-Marcel;376;5;381;81254
76;81;02;21;255;Saint-Jean-de-Rives;532;12;544;81255
76;81;02;08;256;Saint-Jean-de-Vals;76;1;77;81256
76;81;01;22;257;Saint-Juéry;6694;103;6797;81257
76;81;02;20;258;Saint-Julien-du-Puy;439;16;455;81258
76;81;01;05;259;Saint-Julien-Gaulène;223;1;224;81259
76;81;02;21;261;Saint-Lieux-lès-Lavaur;1121;18;1139;81261
76;81;01;06;262;Saint-Marcel-Campes;213;2;215;81262
76;81;01;06;263;Saint-Martin-Laguépie;390;11;401;81263
76;81;01;05;264;Saint-Michel-Labadié;90;2;92;81264
76;81;01;06;265;Saint-Michel-de-Vax;77;1;78;81265
76;81;02;20;266;Saint-Paul-Cap-de-Joux;1084;28;1112;81266
76;81;02;14;267;Saint-Pierre-de-Trivisy;618;12;630;81267
76;81;02;14;268;Saint-Salvi-de-Carcavès;75;4;79;81268
76;81;02;08;269;Saint-Salvy-de-la-Balme;510;8;518;81269
76;81;02;19;270;Saint-Sernin-lès-Lavaur;167;3;170;81270
76;81;02;21;271;Saint-Sulpice-la-Pointe;9336;268;9604;81271
76;81;01;23;272;Saint-Urcisse;217;1;218;81272
76;81;02;19;273;SaÃ¯x;3602;72;3674;81273
76;81;01;02;274;Saliès;836;18;854;81274
76;81;01;06;275;Salles;195;2;197;81275
76;81;01;23;276;Salvagnac;1223;19;1242;81276
76;81;01;05;277;Saussenac;596;9;605;81277
76;81;02;17;278;Sauveterre;161;2;163;81278
76;81;01;23;279;La Sauzière-Saint-Jean;261;8;269;81279
76;81;01;06;280;Le Ségur;262;7;269;81280
76;81;02;20;281;Sémalens;2008;55;2063;81281
76;81;02;14;282;Senaux;34;0;34;81282
76;81;01;10;283;Senouillac;1115;33;1148;81283
76;81;01;02;284;Le Sequestre;1917;29;1946;81284
76;81;01;05;285;Sérénac;487;2;489;81285
76;81;02;20;286;Serviès;612;20;632;81286
76;81;01;13;287;Sieurac;264;2;266;81287
76;81;02;18;288;Sorèze;2903;64;2967;81288
76;81;02;19;289;Soual;2622;41;2663;81289
76;81;01;06;290;Souel;165;2;167;81290
76;81;01;06;291;TaÃ¯x;504;6;510;81291
76;81;01;05;292;Tanus;531;18;549;81292
76;81;01;23;293;Tauriac;356;3;359;81293
76;81;01;10;294;Técou;1002;18;1020;81294
76;81;01;13;295;Teillet;441;6;447;81295
76;81;01;03;297;Terssac;1229;29;1258;81297
76;81;02;15;298;Teulat;483;13;496;81298
76;81;02;20;299;Teyssode;382;16;398;81299
76;81;01;06;300;Tonnac;98;2;100;81300
76;81;01;05;302;Tréban;52;1;53;81302
76;81;01;05;303;Trébas;410;4;414;81303
76;81;01;06;304;Trévien;184;4;188;81304
76;81;02;14;305;Vabre;738;19;757;81305
76;81;01;05;306;Valderiès;840;23;863;81306
76;81;02;16;307;Valdurenque;857;18;875;81307
76;81;01;05;308;Valence-d'Albigeois;1299;27;1326;81308
76;81;01;06;309;Vaour;303;15;318;81309
76;81;02;15;310;Veilhes;163;4;167;81310
76;81;02;20;311;Vénès;759;20;779;81311
76;81;02;18;312;Verdalle;1009;173;1182;81312
76;81;01;23;313;Le Verdier;229;6;235;81313
76;81;02;14;314;Viane;531;39;570;81314
76;81;02;20;315;Vielmur-sur-Agout;1421;48;1469;81315
76;81;01;23;316;Vieux;226;3;229;81316
76;81;01;13;317;Villefranche-d'Albigeois;1248;30;1278;81317
76;81;02;15;318;Villeneuve-lès-Lavaur;141;2;143;81318
76;81;01;03;319;Villeneuve-sur-Vère;493;14;507;81319
76;81;01;06;320;Vindrac-Alayrac;149;5;154;81320
76;81;02;17;321;Le Vintrou;89;1;90;81321
76;81;01;06;322;Virac;245;6;251;81322
76;81;02;20;323;Viterbe;360;6;366;81323
76;81;02;15;324;Viviers-lès-Lavaur;226;5;231;81324
76;81;02;19;325;Viviers-lès-Montagnes;1968;39;2007;81325
76;81;01;03;326;Sainte-Croix;386;13;399;81326
76;82;01;09;001;Albefeuille-Lagarde;627;18;645;82001
76;82;02;11;002;Albias;3294;58;3352;82002
76;82;01;02;003;Angeville;249;5;254;82003
76;82;01;04;004;Asques;135;0;135;82004
76;82;02;15;005;Aucamville;1504;20;1524;82005
76;82;01;02;006;Auterive;84;2;86;82006
76;82;02;11;007;Auty;144;1;145;82007
76;82;01;04;008;Auvillar;914;42;956;82008
76;82;01;04;009;Balignac;40;2;42;82009
76;82;01;04;010;Bardigues;260;5;265;82010
76;82;01;03;011;Barry-d'Islemade;941;14;955;82011
76;82;01;03;012;Les Barthes;564;8;572;82012
76;82;01;02;013;Beaumont-de-Lomagne;3773;174;3947;82013
76;82;02;15;014;Beaupuy;257;6;263;82014
76;82;01;02;015;Belbèze-en-Lomagne;149;4;153;82015
76;82;01;10;016;Belvèze;215;2;217;82016
76;82;02;09;017;Bessens;1487;25;1512;82017
76;82;02;01;018;Bioule;1148;30;1178;82018
76;82;01;14;019;Boudou;751;17;768;82019
76;82;02;15;020;Bouillac;594;14;608;82020
76;82;01;10;021;Bouloc-en-Quercy;193;3;196;82021
76;82;01;14;022;Bourg-de-Visa;382;10;392;82022
76;82;02;02;023;Bourret;959;11;970;82023
76;82;01;14;024;Brassac;248;3;251;82024
76;82;02;09;025;Bressols;3697;104;3801;82025
76;82;02;13;026;Bruniquel;600;9;609;82026
76;82;02;15;027;Campsas;1405;23;1428;82027
76;82;02;15;028;Canals;793;11;804;82028
76;82;02;12;029;Castanet;281;3;284;82029
76;82;01;02;030;Castelferrus;491;4;495;82030
76;82;01;04;031;Castelmayran;1222;17;1239;82031
76;82;01;14;032;Castelsagrat;542;13;555;82032
76;82;01;03;033;Castelsarrasin;14114;323;14437;82033
76;82;01;04;034;Castéra-Bouzet;108;3;111;82034
76;82;01;04;035;Caumont;335;9;344;82035
76;82;01;02;036;Le Causé;135;2;137;82036
76;82;02;01;037;Caussade;6808;202;7010;82037
76;82;02;12;038;Caylus;1473;28;1501;82038
76;82;02;11;039;Cayrac;555;22;577;82039
76;82;02;12;040;Cayriech;280;9;289;82040
76;82;02;12;041;Cazals;233;3;236;82041
76;82;01;10;042;Cazes-Mondenard;1192;21;1213;82042
76;82;02;02;043;Comberouger;269;10;279;82043
76;82;02;13;044;Corbarieu;1647;50;1697;82044
76;82;01;02;045;Cordes-Tolosannes;354;6;360;82045
76;82;01;02;046;Coutures;114;0;114;82046
76;82;01;02;047;Cumont;51;0;51;82047
76;82;02;15;048;Dieupentale;1650;14;1664;82048
76;82;01;04;049;Donzac;1034;13;1047;82049
76;82;01;04;050;Dunes;1208;24;1232;82050
76;82;01;10;051;Durfort-Lacapelette;841;90;931;82051
76;82;02;02;052;Escatalens;1114;106;1220;82052
76;82;01;02;053;Escazeaux;288;3;291;82053
76;82;01;14;054;Espalais;382;7;389;82054
76;82;01;02;055;Esparsac;255;8;263;82055
76;82;02;12;056;Espinas;173;4;177;82056
76;82;02;15;057;Fabas;658;15;673;82057
76;82;01;02;058;Fajolles;100;2;102;82058
76;82;01;02;059;Faudoas;290;10;300;82059
76;82;01;10;060;Fauroux;194;4;198;82060
76;82;02;12;061;Féneyrols;142;2;144;82061
76;82;02;09;062;Finhan;1546;19;1565;82062
76;82;01;02;063;Garganvillar;679;13;692;82063
76;82;01;02;064;Gariès;121;0;121;82064
76;82;01;14;065;Gasques;409;10;419;82065
76;82;02;13;066;Génébrières;609;13;622;82066
76;82;01;04;067;Gensac;107;1;108;82067
76;82;01;02;068;Gimat;240;6;246;82068
76;82;02;12;069;Ginals;202;6;208;82069
76;82;01;02;070;Glatens;73;2;75;82070
76;82;01;02;071;Goas;37;2;39;82071
76;82;01;14;072;Golfech;1014;27;1041;82072
76;82;01;14;073;Goudourville;937;31;968;82073
76;82;01;04;074;Gramont;133;5;138;82074
76;82;02;15;075;Grisolles;4177;56;4233;82075
76;82;02;11;076;L'Honor-de-Cos;1587;35;1622;82076
76;82;02;10;077;Labarthe;400;5;405;82077
76;82;02;12;078;Labastide-de-Penne;128;0;128;82078
76;82;02;13;079;Labastide-Saint-Pierre;3783;80;3863;82079
76;82;01;03;080;Labastide-du-Temple;1143;27;1170;82080
76;82;01;02;081;Labourgade;194;2;196;82081
76;82;02;12;082;Lacapelle-Livron;196;5;201;82082
76;82;01;04;083;Lachapelle;118;1;119;82083
76;82;01;10;084;Lacour;168;5;173;82084
76;82;02;09;085;Lacourt-Saint-Pierre;1239;11;1250;82085
76;82;01;02;086;Lafitte;221;3;224;82086
76;82;02;10;087;Lafrançaise;2835;65;2900;82087
76;82;02;12;088;Laguépie;604;13;617;82088
76;82;01;14;089;Lamagistère;1167;18;1185;82089
76;82;02;11;090;Lamothe-Capdeville;1052;28;1080;82090
76;82;01;02;091;Lamothe-Cumont;126;3;129;82091
76;82;02;12;092;Lapenche;284;4;288;82092
76;82;01;02;093;Larrazet;693;8;701;82093
76;82;01;10;094;Lauzerte;1454;17;1471;82094
76;82;02;12;095;Lavaurette;217;13;230;82095
76;82;02;03;096;La Ville-Dieu-du-Temple;3148;44;3192;82096
76;82;01;04;097;Lavit;1619;18;1637;82097
76;82;02;13;098;Léojac;1269;28;1297;82098
76;82;01;05;099;Lizac;529;7;536;82099
76;82;02;12;100;Loze;132;7;139;82100
76;82;01;04;101;Malause;1199;17;1216;82101
76;82;01;04;102;Mansonville;294;4;298;82102
76;82;01;02;103;Marignac;107;6;113;82103
76;82;01;04;104;Marsac;186;5;191;82104
76;82;02;15;105;Mas-Grenier;1342;18;1360;82105
76;82;01;02;106;Maubec;137;1;138;82106
76;82;01;04;107;Maumusson;46;1;47;82107
76;82;01;03;108;Meauzac;1360;29;1389;82108
76;82;01;04;109;Merles;201;13;214;82109
76;82;02;11;110;Mirabel;1037;18;1055;82110
76;82;01;10;111;Miramont-de-Quercy;316;9;325;82111
76;82;01;05;112;Moissac;13378;319;13697;82112
76;82;02;11;113;Molières;1182;25;1207;82113
76;82;02;09;114;Monbéqui;645;7;652;82114
76;82;02;13;115;Monclar-de-Quercy;2004;18;2022;82115
76;82;01;10;116;Montagudet;194;4;198;82116
76;82;01;10;117;Montaigu-de-Quercy;1302;25;1327;82117
76;82;01;02;118;MontaÃ¯n;100;1;101;82118
76;82;02;11;119;Montalzat;654;18;672;82119
76;82;02;11;120;Montastruc;295;5;300;82120
76;82;02;99;121;Montauban;61372;1460;62832;82121
76;82;01;10;122;Montbarla;183;3;186;82122
76;82;02;09;123;Montbartier;1474;22;1496;82123
76;82;02;09;124;Montbeton;4241;87;4328;82124
76;82;02;09;125;Montech;6589;127;6716;82125
76;82;02;12;126;Monteils;1359;102;1461;82126
76;82;01;05;127;Montesquieu;758;19;777;82127
76;82;02;11;128;Montfermier;106;3;109;82128
76;82;01;04;129;Montgaillard;145;4;149;82129
76;82;01;14;130;Montjoi;166;1;167;82130
76;82;02;11;131;Montpezat-de-Quercy;1590;41;1631;82131
76;82;02;01;132;Montricoux;1186;27;1213;82132
76;82;02;12;133;Mouillac;93;1;94;82133
76;82;02;01;134;Nègrepelisse;5685;81;5766;82134
76;82;02;13;135;Nohic;1340;18;1358;82135
76;82;02;13;136;Orgueil;1754;34;1788;82136
76;82;02;12;137;Parisot;570;11;581;82137
76;82;01;14;138;Perville;162;2;164;82138
76;82;01;04;139;Le Pin;121;3;124;82139
76;82;02;11;140;Piquecos;444;3;447;82140
76;82;01;14;141;Pommevic;546;4;550;82141
76;82;02;15;142;Pompignan;1544;20;1564;82142
76;82;01;04;143;Poupas;85;0;85;82143
76;82;02;10;144;Puycornet;746;11;757;82144
76;82;02;13;145;Puygaillard-de-Quercy;379;8;387;82145
76;82;01;04;146;Puygaillard-de-Lomagne;60;2;62;82146
76;82;02;12;147;Puylagarde;331;8;339;82147
76;82;02;12;148;Puylaroque;694;25;719;82148
76;82;02;11;149;Réalville;1879;32;1911;82149
76;82;02;13;150;Reyniès;862;24;886;82150
76;82;01;10;151;Roquecor;401;9;410;82151
76;82;01;04;152;Saint-Aignan;398;11;409;82152
76;82;01;10;153;Saint-Amans-du-Pech;226;1;227;82153
76;82;01;10;154;Saint-Amans-de-Pellagal;212;5;217;82154
76;82;02;12;155;Saint-Antonin-Noble-Val;1851;46;1897;82155
76;82;01;02;156;Saint-Arroumex;148;3;151;82156
76;82;01;10;157;Saint-Beauzeil;96;2;98;82157
76;82;01;04;158;Saint-Cirice;147;6;153;82158
76;82;02;12;159;Saint-Cirq;557;17;574;82159
76;82;01;14;160;Saint-Clair;264;8;272;82160
76;82;02;01;161;Saint-Etienne-de-Tulmont;3901;78;3979;82161
76;82;02;12;162;Saint-Georges;261;7;268;82162
76;82;01;04;163;Saint-Jean-du-Bouzet;49;0;49;82163
76;82;01;10;164;Sainte-Juliette;126;3;129;82164
76;82;01;04;165;Saint-Loup;531;4;535;82165
76;82;01;04;166;Saint-Michel;276;3;279;82166
76;82;02;13;167;Saint-Nauphary;1875;41;1916;82167
76;82;01;14;168;Saint-Nazaire-de-Valentane;323;3;326;82168
76;82;01;04;169;Saint-Nicolas-de-la-Grave;2296;30;2326;82169
76;82;01;14;170;Saint-Paul-d'Espis;566;18;584;82170
76;82;02;02;171;Saint-Porquier;1414;24;1438;82171
76;82;02;12;172;Saint-Projet;278;8;286;82172
76;82;02;15;173;Saint-Sardos;1155;14;1169;82173
76;82;02;11;174;Saint-Vincent-d'Autéjac;285;2;287;82174
76;82;01;14;175;Saint-Vincent-Lespinasse;277;4;281;82175
76;82;02;13;176;La Salvetat-Belmontet;856;13;869;82176
76;82;01;10;177;Sauveterre;160;3;163;82177
76;82;02;15;178;Savenès;811;17;828;82178
76;82;02;12;179;Septfonds;2238;50;2288;82179
76;82;01;02;180;Sérignac;526;8;534;82180
76;82;01;04;181;Sistels;207;4;211;82181
76;82;01;10;182;Touffailles;339;3;342;82182
76;82;01;10;183;Tréjouls;238;10;248;82183
76;82;02;01;184;VaÃ¯ssac;896;10;906;82184
76;82;01;10;185;Valeilles;248;6;254;82185
76;82;01;14;186;Valence;5205;153;5358;82186
76;82;02;12;187;Varen;654;13;667;82187
76;82;02;13;188;Varennes;632;14;646;82188
76;82;02;10;189;Vazerac;743;14;757;82189
76;82;02;15;190;Verdun-sur-Garonne;4808;67;4875;82190
76;82;02;12;191;Verfeil;416;3;419;82191
76;82;02;13;192;Verlhac-Tescou;522;14;536;82192
76;82;01;02;193;Vigueron;137;3;140;82193
76;82;02;13;194;Villebrumier;1368;35;1403;82194
76;82;02;11;195;Villemade;779;13;792;82195
93;83;01;14;001;Les Adrets-de-l'Estérel;2784;74;2858;83001
93;83;03;04;002;Aiguines;270;5;275;83002
93;83;01;04;003;Ampus;913;24;937;83003
93;83;01;23;004;Les Arcs;7066;174;7240;83004
93;83;03;04;005;Artignosc-sur-Verdon;288;6;294;83005
93;83;03;13;006;Artigues;283;8;291;83006
93;83;03;04;007;Aups;2284;37;2321;83007
93;83;01;11;008;Bagnols-en-Forêt;2862;59;2921;83008
93;83;02;10;009;Bandol;8403;145;8548;83009
93;83;01;04;010;Bargème;225;1;226;83010
93;83;01;04;011;Bargemon;1334;21;1355;83011
93;83;03;13;012;Barjols;2990;39;3029;83012
93;83;01;04;013;La Bastide;208;1;209;83013
93;83;03;04;014;Baudinard-sur-Verdon;235;9;244;83014
93;83;03;04;015;Bauduen;321;4;325;83015
93;83;02;12;016;Le Beausset;9845;175;10020;83016
93;83;02;18;017;Belgentier;2423;30;2453;83017
93;83;03;09;018;Besse-sur-Issole;3038;44;3082;83018
93;83;02;02;019;Bormes-les-Mimosas;8162;117;8279;83019
93;83;01;04;020;Le Bourguet;41;1;42;83020
93;83;03;13;021;Bras;2629;52;2681;83021
93;83;01;04;022;Brenon;25;0;25;83022
93;83;03;01;023;Brignoles;17361;345;17706;83023
93;83;03;13;025;Brue-Auriac;1419;22;1441;83025
93;83;03;09;026;Cabasse;1951;36;1987;83026
93;83;02;12;027;La Cadière-d'Azur;5574;98;5672;83027
93;83;01;04;028;Callas;1948;39;1987;83028
93;83;01;11;029;Callian;3341;61;3402;83029
93;83;03;07;030;Camps-la-Source;1897;47;1944;83030
93;83;03;09;031;Le Cannet-des-Maures;4279;59;4338;83031
93;83;03;01;032;Carcès;3380;81;3461;83032
93;83;03;07;033;Carnoules;3525;36;3561;83033
93;83;02;06;034;Carqueiranne;9518;163;9681;83034
93;83;02;12;035;Le Castellet;3873;42;3915;83035
93;83;01;15;036;Cavalaire-sur-Mer;7586;86;7672;83036
93;83;03;01;037;La Celle;1483;55;1538;83037
93;83;01;04;038;Châteaudouble;477;15;492;83038
93;83;03;13;039;Châteauvert;147;14;161;83039
93;83;01;04;040;Châteauvieux;79;1;80;83040
93;83;01;04;041;Claviers;720;12;732;83041
93;83;01;15;042;Cogolin;11311;238;11549;83042
93;83;02;09;043;Collobrières;1874;89;1963;83043
93;83;01;04;044;Comps-sur-Artuby;328;5;333;83044
93;83;03;01;045;Correns;906;8;914;83045
93;83;03;01;046;Cotignac;2111;39;2150;83046
93;83;02;02;047;La Crau;18774;428;19202;83047
93;83;01;15;048;La Croix-Valmer;3779;96;3875;83048
93;83;02;18;049;Cuers;11962;139;12101;83049
93;83;01;03;050;Draguignan;39433;911;40344;83050
93;83;03;01;051;Entrecasteaux;1118;23;1141;83051
93;83;03;13;052;Esparron;371;5;376;83052
93;83;02;10;053;Evenos;2416;51;2467;83053
93;83;02;18;054;La Farlède;9614;118;9732;83054
93;83;01;11;055;Fayence;5735;85;5820;83055
93;83;01;04;056;Figanières;2623;53;2676;83056
93;83;03;09;057;Flassans-sur-Issole;3564;67;3631;83057
93;83;01;04;058;Flayosc;4247;104;4351;83058
93;83;03;07;059;Forcalqueiret;3101;47;3148;83059
93;83;03;04;060;Fox-Amphoux;458;4;462;83060
93;83;01;96;061;Fréjus;54458;843;55301;83061
93;83;02;06;062;La Garde;25505;313;25818;83062
93;83;01;09;063;La Garde-Freinet;1847;42;1889;83063
93;83;03;07;064;Garéoult;5303;99;5402;83064
93;83;01;15;065;Gassin;2614;55;2669;83065
93;83;03;13;066;Ginasservis;1874;35;1909;83066
93;83;03;09;067;Gonfaron;4329;60;4389;83067
93;83;01;15;068;Grimaud;4562;60;4622;83068
93;83;02;97;069;Hyères;54821;977;55798;83069
93;83;02;02;070;Le Lavandou;5985;60;6045;83070
93;83;02;02;071;La Londe-les-Maures;10641;135;10776;83071
93;83;01;23;072;Lorgues;9054;292;9346;83072
93;83;03;09;073;Le Luc;11094;112;11206;83073
93;83;01;04;074;La Martre;204;5;209;83074
93;83;03;09;075;Les Mayons;631;8;639;83075
93;83;03;07;076;Mazaugues;868;13;881;83076
93;83;03;07;077;Méounes-lès-Montrieux;2226;20;2246;83077
93;83;03;04;078;Moissac-Bellevue;290;7;297;83078
93;83;01;15;079;La Môle;1461;25;1486;83079
93;83;01;11;080;Mons;806;15;821;83080
93;83;01;11;081;Montauroux;6548;132;6680;83081
93;83;01;04;082;Montferrat;1527;22;1549;83082
93;83;03;01;083;Montfort-sur-Argens;1420;26;1446;83083
93;83;03;04;084;Montmeyan;533;3;536;83084
93;83;01;04;085;La Motte;2804;52;2856;83085
93;83;01;23;086;Le Muy;9288;249;9537;83086
93;83;03;12;087;Nans-les-Pins;4835;85;4920;83087
93;83;03;07;088;Néoules;2828;68;2896;83088
93;83;03;13;089;Ollières;650;23;673;83089
93;83;02;10;090;Ollioules;13866;253;14119;83090
93;83;02;07;091;Pierrefeu-du-Var;6068;105;6173;83091
93;83;03;09;092;Pignans;4588;47;4635;83092
93;83;03;12;093;Plan-d'Aups-Sainte-Baume;2187;27;2214;83093
93;83;01;15;094;Le Plan-de-la-Tour;3048;52;3100;83094
93;83;03;13;095;Pontevès;737;18;755;83095
93;83;03;13;096;Pourcieux;1574;22;1596;83096
93;83;03;13;097;Pourrières;5181;91;5272;83097
93;83;02;06;098;Le Pradet;10277;149;10426;83098
93;83;01;11;099;Puget-sur-Argens;8062;108;8170;83099
93;83;03;07;100;Puget-Ville;4357;51;4408;83100
93;83;01;15;101;Ramatuelle;2115;48;2163;83101
93;83;03;04;102;Régusse;2642;16;2658;83102
93;83;02;21;103;Le Revest-les-Eaux;3962;59;4021;83103
93;83;03;13;104;Rians;4278;85;4363;83104
93;83;02;12;105;Riboux;49;0;49;83105
93;83;03;07;106;Rocbaron;5250;68;5318;83106
93;83;01;11;107;Roquebrune-sur-Argens;14937;191;15128;83107
93;83;03;07;108;La Roquebrussanne;2203;41;2244;83108
93;83;01;04;109;La Roque-Esclapon;256;0;256;83109
93;83;03;01;110;Rougiers;1662;30;1692;83110
93;83;03;07;111;Sainte-Anastasie-sur-Issole;2048;25;2073;83111
93;83;02;12;112;Saint-Cyr-sur-Mer;11484;241;11725;83112
93;83;03;13;113;Saint-Julien;2402;41;2443;83113
93;83;03;13;114;Saint-Martin-de-Pallières;247;4;251;83114
93;83;01;15;115;Sainte-Maxime;14448;224;14672;83115
93;83;03;13;116;Saint-Maximin-la-Sainte-Baume;17095;497;17592;83116
93;83;01;11;117;Saint-Paul-en-Forêt;1757;42;1799;83117
93;83;01;14;118;Saint-RaphaÃ«l;36027;601;36628;83118
93;83;01;15;119;Saint-Tropez;3851;71;3922;83119
93;83;03;12;120;Saint-Zacharie;6051;83;6134;83120
93;83;01;04;121;Salernes;3761;77;3838;83121
93;83;03;04;122;Les Salles-sur-Verdon;226;4;230;83122
93;83;02;10;123;Sanary-sur-Mer;16889;271;17160;83123
93;83;01;11;124;Seillans;2669;33;2702;83124
93;83;03;13;125;Seillons-Source-d'Argens;2492;38;2530;83125
93;83;02;98;126;La Seyne-sur-Mer;62987;762;63749;83126
93;83;02;12;127;Signes;2927;44;2971;83127
93;83;01;04;128;Sillans-la-Cascade;745;55;800;83128
93;83;02;17;129;Six-Fours-les-Plages;34592;562;35154;83129
93;83;02;18;130;Solliès-Pont;11762;184;11946;83130
93;83;02;18;131;Solliès-Toucas;5753;108;5861;83131
93;83;02;18;132;Solliès-Ville;2526;46;2572;83132
93;83;01;11;133;Tanneron;1671;33;1704;83133
93;83;01;23;134;Taradeau;1784;33;1817;83134
93;83;03;04;135;Tavernes;1405;16;1421;83135
93;83;03;09;136;Le Thoronet;2552;47;2599;83136
93;83;02;99;137;Toulon;178745;1896;180641;83137
93;83;01;11;138;Tourrettes;2877;51;2928;83138
93;83;03;04;139;Tourtour;585;15;600;83139
93;83;03;01;140;Tourves;5042;71;5113;83140
93;83;01;03;141;Trans-en-Provence;5947;134;6081;83141
93;83;01;04;142;Trigance;203;5;208;83142
93;83;03;01;143;Le Val;4292;95;4387;83143
93;83;02;21;144;La Valette-du-Var;24087;259;24346;83144
93;83;03;13;145;Varages;1176;15;1191;83145
93;83;03;13;146;La Verdière;1603;13;1616;83146
93;83;03;04;147;Vérignon;9;0;9;83147
93;83;01;23;148;Vidauban;12616;144;12760;83148
93;83;03;04;149;Villecroze;1466;28;1494;83149
93;83;03;13;150;Vinon-sur-Verdon;4248;88;4336;83150
93;83;03;01;151;Vins-sur-Caramy;963;15;978;83151
93;83;01;02;152;Rayol-Canadel-sur-Mer;667;13;680;83152
93;83;02;17;153;Saint-Mandrier-sur-Mer;6095;68;6163;83153
93;83;01;01;154;Saint-Antonin-du-Var;722;14;736;83154
93;84;03;10;001;Althen-des-Paluds;2851;46;2897;84001
93;84;01;13;002;Ansouis;1046;25;1071;84002
93;84;01;01;003;Apt;11037;221;11258;84003
93;84;03;06;004;Aubignan;5778;94;5872;84004
93;84;03;12;005;Aurel;193;2;195;84005
93;84;01;01;006;Auribeau;70;4;74;84006
93;84;02;99;007;Avignon;91143;1678;92821;84007
93;84;03;16;008;Le Barroux;639;50;689;84008
93;84;01;13;009;La Bastide-des-Jourdans;1614;95;1709;84009
93;84;01;13;010;La Bastidonne;873;22;895;84010
93;84;03;12;011;Le Beaucet;355;9;364;84011
93;84;03;10;012;Beaumes-de-Venise;2389;48;2437;84012
93;84;01;01;013;Beaumettes;280;4;284;84013
93;84;01;13;014;Beaumont-de-Pertuis;1134;16;1150;84014
93;84;03;16;015;Beaumont-du-Ventoux;296;5;301;84015
93;84;02;15;016;Bédarrides;5316;76;5392;84016
93;84;03;12;017;Bédoin;3093;68;3161;84017
93;84;03;12;018;Blauvac;518;8;526;84018
93;84;03;05;019;Bollène;13439;232;13671;84019
93;84;01;01;020;Bonnieux;1206;23;1229;84020
93;84;03;16;021;Brantes;90;3;93;84021
93;84;03;16;022;Buisson;277;12;289;84022
93;84;01;01;023;Buoux;87;3;90;84023
93;84;01;13;024;Cabrières-d'Aigues;957;14;971;84024
93;84;01;08;025;Cabrières-d'Avignon;1835;37;1872;84025
93;84;01;08;026;Cadenet;4201;77;4278;84026
93;84;03;11;027;Caderousse;2651;47;2698;84027
93;84;03;16;028;Cairanne;1084;20;1104;84028
93;84;03;16;029;Camaret-sur-Aigues;4542;111;4653;84029
93;84;03;10;030;Caromb;3399;58;3457;84030
93;84;03;06;031;Carpentras;29236;713;29949;84031
93;84;01;01;032;Caseneuve;493;8;501;84032
93;84;01;01;033;Castellet-en-Luberon;120;0;120;84033
93;84;02;07;034;Caumont-sur-Durance;4914;99;5013;84034
93;84;01;07;035;Cavaillon;26236;412;26648;84035
93;84;02;09;036;Châteauneuf-de-Gadagne;3321;75;3396;84036
93;84;03;15;037;Châteauneuf-du-Pape;2055;30;2085;84037
93;84;01;08;038;Cheval-Blanc;4290;75;4365;84038
93;84;02;15;039;Courthézon;6026;76;6102;84039
93;84;03;16;040;Crestet;416;16;432;84040
93;84;03;12;041;Crillon-le-Brave;475;20;495;84041
93;84;01;08;042;Cucuron;1771;32;1803;84042
93;84;02;10;043;Entraigues-sur-la-Sorgue;8595;123;8718;84043
93;84;03;16;044;Entrechaux;1134;33;1167;84044
93;84;03;16;045;Faucon;450;8;458;84045
93;84;03;12;046;Flassan;478;14;492;84046
93;84;01;01;047;Gargas;3078;49;3127;84047
93;84;01;01;048;Gignac;71;1;72;84048
93;84;03;16;049;Gigondas;434;10;444;84049
93;84;01;01;050;Gordes;1670;34;1704;84050
93;84;01;01;051;Goult;1100;27;1127;84051
93;84;01;13;052;Grambois;1226;29;1255;84052
93;84;03;17;053;Grillon;1749;31;1780;84053
93;84;02;09;054;L'Isle-sur-la-Sorgue;20042;493;20535;84054
93;84;02;14;055;Jonquerettes;1550;37;1587;84055
93;84;03;15;056;Jonquières;5469;63;5532;84056
93;84;01;01;057;Joucas;347;5;352;84057
93;84;01;01;058;Lacoste;423;7;430;84058
93;84;03;16;059;Lafare;121;1;122;84059
93;84;01;01;060;Lagarde-d'Apt;32;1;33;84060
93;84;03;05;061;Lagarde-Paréol;327;13;340;84061
93;84;01;08;062;Lagnes;1641;33;1674;84062
93;84;03;05;063;Lamotte-du-Rhône;395;1;396;84063
93;84;03;05;064;Lapalud;3830;79;3909;84064
93;84;01;08;065;Lauris;3879;69;3948;84065
93;84;01;01;066;Lioux;291;4;295;84066
93;84;03;06;067;Loriol-du-Comtat;2520;55;2575;84067
93;84;01;08;068;Lourmarin;1040;22;1062;84068
93;84;03;16;069;Malaucène;2785;60;2845;84069
93;84;03;12;070;Malemort-du-Comtat;1887;24;1911;84070
93;84;01;08;071;Maubec;1920;48;1968;84071
93;84;03;12;072;Mazan;6201;158;6359;84072
93;84;01;01;073;Ménerbes;1002;17;1019;84073
93;84;01;08;074;Mérindol;2189;37;2226;84074
93;84;03;12;075;Méthamis;442;8;450;84075
93;84;01;13;076;Mirabeau;1344;39;1383;84076
93;84;03;12;077;Modène;465;7;472;84077
93;84;03;05;078;Mondragon;3736;63;3799;84078
93;84;03;12;079;Monieux;282;5;287;84079
93;84;03;10;080;Monteux;12935;226;13161;84080
93;84;02;04;081;Morières-lès-Avignon;8786;130;8916;84081
93;84;03;12;082;Mormoiron;1864;49;1913;84082
93;84;03;05;083;Mornas;2438;47;2485;84083
93;84;01;13;084;La Motte-d'Aigues;1371;41;1412;84084
93;84;01;01;085;Murs;418;6;424;84085
93;84;01;01;086;Oppède;1295;27;1322;84086
93;84;03;11;087;Orange;28772;665;29437;84087
93;84;03;12;088;Pernes-les-Fontaines;10170;287;10457;84088
93;84;01;13;089;Pertuis;20557;309;20866;84089
93;84;01;13;090;Peypin-d'Aigues;673;15;688;84090
93;84;03;11;091;Piolenc;5394;95;5489;84091
93;84;02;14;092;Le Pontet;17041;136;17177;84092
93;84;01;08;093;Puget;819;21;840;84093
93;84;03;16;094;Puyméras;580;12;592;84094
93;84;01;08;095;Puyvert;830;14;844;84095
93;84;03;16;096;Rasteau;803;20;823;84096
93;84;03;17;097;Richerenches;537;81;618;84097
93;84;03;16;098;Roaix;634;9;643;84098
93;84;01;08;099;Robion;4631;75;4706;84099
93;84;03;16;100;La Roque-Alric;52;0;52;84100
93;84;03;12;101;La Roque-sur-Pernes;416;13;429;84101
93;84;01;01;102;Roussillon;1289;31;1320;84102
93;84;01;01;103;Rustrel;661;20;681;84103
93;84;03;16;104;Sablet;1349;32;1381;84104
93;84;01;01;105;Saignon;929;22;951;84105
93;84;03;05;106;Sainte-Cécile-les-Vignes;2591;53;2644;84106
93;84;03;12;107;Saint-Christol;1401;20;1421;84107
93;84;03;12;108;Saint-Didier;1996;41;2037;84108
93;84;03;10;109;Saint-Hippolyte-le-Graveyron;167;9;176;84109
93;84;03;16;110;Saint-Léger-du-Ventoux;33;0;33;84110
93;84;03;16;111;Saint-Marcellin-lès-Vaison;327;11;338;84111
93;84;01;01;112;Saint-Martin-de-Castillon;728;6;734;84112
93;84;01;13;113;Saint-Martin-de-la-Brasque;815;17;832;84113
93;84;01;01;114;Saint-Pantaléon;189;3;192;84114
93;84;03;12;115;Saint-Pierre-de-Vassols;509;12;521;84115
93;84;03;16;116;Saint-Romain-en-Viennois;783;21;804;84116
93;84;03;16;117;Saint-Roman-de-Malegarde;330;7;337;84117
93;84;01;01;118;Saint-Saturnin-lès-Apt;2877;71;2948;84118
93;84;02;14;119;Saint-Saturnin-lès-Avignon;4935;113;5048;84119
93;84;03;12;120;Saint-Trinit;118;1;119;84120
93;84;01;13;121;Sannes;265;0;265;84121
93;84;03;10;122;Sarrians;6128;78;6206;84122
93;84;03;12;123;Sault;1361;23;1384;84123
93;84;02;09;124;Saumane-de-Vaucluse;946;16;962;84124
93;84;03;16;125;Savoillan;61;0;61;84125
93;84;03;16;126;Séguret;856;23;879;84126
93;84;03;05;127;Sérignan-du-Comtat;2853;81;2934;84127
93;84;01;01;128;Sivergues;46;1;47;84128
93;84;02;15;129;Sorgues;18893;234;19127;84129
93;84;03;16;130;Suzette;113;3;116;84130
93;84;01;08;131;Taillades;1921;40;1961;84131
93;84;02;09;132;Le Thor;8940;177;9117;84132
93;84;01;13;133;La Tour-d'Aigues;4334;138;4472;84133
93;84;03;16;134;Travaillan;711;13;724;84134
93;84;03;05;135;Uchaux;1666;51;1717;84135
93;84;03;16;136;Vacqueyras;1240;31;1271;84136
93;84;03;16;137;Vaison-la-Romaine;5908;129;6037;84137
93;84;03;17;138;Valréas;9403;230;9633;84138
93;84;02;09;139;Fontaine-de-Vaucluse;579;16;595;84139
93;84;01;08;140;Vaugines;558;19;577;84140
93;84;02;14;141;Vedène;11383;368;11751;84141
93;84;02;14;142;Velleron;2976;54;3030;84142
93;84;03;12;143;Venasque;1013;18;1031;84143
93;84;01;01;144;Viens;641;18;659;84144
93;84;01;01;145;Villars;781;14;795;84145
93;84;03;16;146;Villedieu;489;14;503;84146
93;84;01;13;147;Villelaure;3356;86;3442;84147
93;84;03;12;148;Villes-sur-Auzon;1284;34;1318;84148
93;84;03;16;149;Violès;1710;33;1743;84149
93;84;03;17;150;Visan;1956;57;2013;84150
93;84;01;13;151;Vitrolles-en-Lubéron;164;5;169;84151
52;85;01;09;001;L'Aiguillon-sur-Mer;2061;35;2096;85001
52;85;03;15;002;L'Aiguillon-sur-Vie;2024;24;2048;85002
52;85;02;01;003;Aizenay;9881;198;10079;85003
52;85;03;09;004;Angles;2878;34;2912;85004
52;85;01;04;005;Antigny;1054;21;1075;85005
52;85;02;02;006;Apremont;1854;13;1867;85006
52;85;02;13;008;Aubigny-Les Clouzeaux;6880;104;6984;85008
52;85;01;05;009;Auchay-sur-Vendée;1165;24;1189;85009
52;85;03;17;010;Avrillé;1423;20;1443;85010
52;85;03;16;011;Barbâtre;1723;52;1775;85011
52;85;03;16;012;La Barre-de-Monts;2179;48;2227;85012
52;85;02;10;013;Bazoges-en-Paillers;1460;28;1488;85013
52;85;01;04;014;Bazoges-en-Pareds;1149;27;1176;85014
52;85;02;01;015;Beaufou;1514;21;1535;85015
52;85;03;17;016;Beaulieu-sous-la-Roche;2252;30;2282;85016
52;85;02;11;017;Beaurepaire;2442;49;2491;85017
52;85;03;16;018;Beauvoir-sur-Mer;3880;60;3940;85018
52;85;02;01;019;Bellevigny;6095;123;6218;85019
52;85;01;05;020;Benet;4014;75;4089;85020
52;85;02;11;021;La Bernardière;1868;35;1903;85021
52;85;03;17;022;Le Bernard;1239;18;1257;85022
52;85;01;09;023;Bessay;439;9;448;85023
52;85;03;02;024;Bois-de-Céné;2048;34;2082;85024
52;85;02;10;025;La Boissière-de-Montaigu;2272;52;2324;85025
52;85;03;09;026;La Boissière-des-Landes;1417;18;1435;85026
52;85;01;05;028;Bouillé-Courdault;595;8;603;85028
52;85;03;16;029;Bouin;2156;36;2192;85029
52;85;01;03;031;Le Boupère;3227;43;3270;85031
52;85;01;04;033;Bourneau;731;19;750;85033
52;85;02;03;034;Bournezeau;3403;101;3504;85034
52;85;03;15;035;Bretignolles-sur-Mer;5066;89;5155;85035
52;85;01;09;036;La Bretonnière-la-Claye;573;11;584;85036
52;85;01;04;037;Breuil-Barret;590;16;606;85037
52;85;02;10;038;Les Brouzils;2816;44;2860;85038
52;85;02;11;039;La Bruffière;4028;61;4089;85039
52;85;01;04;040;La Caillère-Saint-Hilaire;1128;24;1152;85040
52;85;01;04;041;Cezais;296;12;308;85041
52;85;01;08;042;Chaillé-les-Marais;1883;24;1907;85042
52;85;03;15;045;La Chaize-Giraud;1083;14;1097;85045
52;85;02;13;046;La Chaize-le-Vicomte;3799;58;3857;85046
52;85;03;02;047;Challans;21322;773;22095;85047
52;85;01;08;049;Champagné-les-Marais;1783;16;1799;85049
52;85;03;09;050;Le Champ-Saint-Père;1857;22;1879;85050
52;85;02;03;051;Chantonnay;8394;471;8865;85051
52;85;01;04;053;La Chapelle-aux-Lys;260;3;263;85053
52;85;03;17;054;La Chapelle-Hermier;900;7;907;85054
52;85;02;02;055;La Chapelle-Palluau;935;18;953;85055
52;85;01;04;056;La Chapelle-Thémer;391;9;400;85056
52;85;01;08;058;Chasnais;735;20;755;85058
52;85;01;04;059;La Châtaigneraie;2586;36;2622;85059
52;85;01;09;061;Château-Guibert;1506;33;1539;85061
52;85;03;02;062;Châteauneuf;1114;20;1134;85062
52;85;02;10;064;Chauché;2469;33;2502;85064
52;85;02;10;065;Chavagnes-en-Paillers;3552;101;3653;85065
52;85;01;06;066;Chavagnes-les-Redoux;834;17;851;85066
52;85;01;04;067;Cheffois;994;21;1015;85067
52;85;03;15;070;CoÃ«x;3285;37;3322;85070
52;85;03;15;071;Commequiers;3605;57;3662;85071
52;85;02;10;072;La Copechagnière;1018;11;1029;85072
52;85;01;09;073;Corpe;1014;16;1030;85073
52;85;01;09;074;La Couture;224;3;227;85074
52;85;02;11;076;Cugand;3563;90;3653;85076
52;85;03;09;077;Curzon;538;8;546;85077
52;85;01;05;078;Damvix;741;17;758;85078
52;85;01;05;080;Doix lès Fontaines;1731;33;1764;85080
52;85;02;12;081;Dompierre-sur-Yon;4344;114;4458;85081
52;85;02;06;082;Les Epesses;2914;57;2971;85082
52;85;03;16;083;L'Epine;1633;40;1673;85083
52;85;02;03;084;Essarts en Bocage;9174;166;9340;85084
52;85;02;02;086;Falleron;1637;15;1652;85086
52;85;01;05;087;Faymoreau;198;4;202;85087
52;85;03;15;088;Le Fenouiller;4854;136;4990;85088
52;85;02;03;089;La Ferrière;5315;157;5472;85089
52;85;01;06;090;Sèvremont;6423;255;6678;85090
52;85;01;05;092;Fontenay-le-Comte;13235;724;13959;85092
52;85;02;03;093;Fougeré;1224;22;1246;85093
52;85;01;05;094;Foussais-Payré;1157;30;1187;85094
52;85;03;02;095;Froidfond;1942;21;1963;85095
52;85;03;02;096;La Garnache;5114;100;5214;85096
52;85;02;11;097;La Gaubretière;3111;67;3178;85097
52;85;02;01;098;La Genétouze;1982;37;2019;85098
52;85;03;17;099;Le Girouard;1097;23;1120;85099
52;85;03;15;100;Givrand;2230;52;2282;85100
52;85;03;09;101;Le Givre;489;5;494;85101
52;85;02;02;102;Grand'Landes;692;9;701;85102
52;85;03;17;103;Grosbreuil;2229;31;2260;85103
52;85;01;08;104;Grues;895;11;906;85104
52;85;01;08;105;Le Gué-de-Velluire;529;13;542;85105
52;85;03;16;106;La Guérinière;1320;35;1355;85106
52;85;02;01;108;L'Herbergement;3297;110;3407;85108
52;85;02;06;109;Les Herbiers;16250;485;16735;85109
52;85;01;04;110;L'Hermenault;924;14;938;85110
52;85;01;08;111;L'ÃŽle-d'Elle;1501;23;1524;85111
52;85;03;17;112;L'ÃŽle-d'Olonne;2783;59;2842;85112
52;85;03;07;113;L'ÃŽle-d'Yeu;4850;138;4988;85113
52;85;03;17;114;Jard-sur-Mer;2665;31;2696;85114
52;85;01;04;115;La Jaudonnière;600;11;611;85115
52;85;03;09;116;La Jonchère;461;6;467;85116
52;85;01;08;117;Lairoux;621;19;640;85117
52;85;02;12;118;Landeronde;2363;50;2413;85118
52;85;02;11;119;Les Landes-Genusson;2403;42;2445;85119
52;85;03;15;120;Landevieille;1449;36;1485;85120
52;85;01;05;121;Le Langon;993;31;1024;85121
52;85;01;05;123;Liez;280;4;284;85123
52;85;01;04;125;Loge-Fougereuse;400;4;404;85125
52;85;01;05;126;Longèves;1341;50;1391;85126
52;85;03;17;127;Longeville-sur-Mer;2405;26;2431;85127
52;85;01;08;128;Luçon;9554;386;9940;85128
52;85;02;01;129;Les Lucs-sur-Boulogne;3522;72;3594;85129
52;85;02;02;130;Maché;1589;20;1609;85130
52;85;01;08;131;Les Magnils-Reigniers;1486;40;1526;85131
52;85;01;05;132;Maillé;749;13;762;85132
52;85;01;05;133;Maillezais;921;23;944;85133
52;85;02;11;134;Mallièvre;243;10;253;85134
52;85;01;09;135;Mareuil-sur-Lay-Dissais;2792;122;2914;85135
52;85;01;04;136;Marillet;123;1;124;85136
52;85;01;04;137;Marsais-Sainte-Radégonde;480;14;494;85137
52;85;03;17;138;Martinet;1171;12;1183;85138
52;85;01;05;139;Le Mazeau;445;14;459;85139
52;85;01;06;140;La Meilleraie-Tillay;1502;43;1545;85140
52;85;01;04;141;Menomblet;675;13;688;85141
52;85;02;03;142;La Merlatière;1014;23;1037;85142
52;85;01;05;143;Mervent;1047;20;1067;85143
52;85;02;10;144;Mesnard-la-Barotière;1504;27;1531;85144
52;85;01;06;145;Monsireigne;957;17;974;85145
52;85;02;10;146;Montaigu-Vendée;20424;634;21058;85146
52;85;01;06;147;Montournais;1641;50;1691;85147
52;85;01;05;148;Montreuil;814;23;837;85148
52;85;01;08;149;Moreilles;413;5;418;85149
52;85;02;11;151;Mortagne-sur-Sèvre;6059;168;6227;85151
52;85;03;17;152;Les Achards;5271;108;5379;85152
52;85;02;06;153;Mouchamps;2922;46;2968;85153
52;85;01;04;154;Mouilleron-Saint-Germain;1806;92;1898;85154
52;85;02;12;155;Mouilleron-le-Captif;4971;123;5094;85155
52;85;03;09;156;Moutiers-les-Mauxfaits;2212;34;2246;85156
52;85;01;09;157;Moutiers-sur-le-Lay;761;12;773;85157
52;85;01;08;158;Mouzeuil-Saint-Martin;1194;27;1221;85158
52;85;01;08;159;Nalliers;2310;47;2357;85159
52;85;02;13;160;Nesmy;2912;45;2957;85160
52;85;03;17;161;Nieul-le-Dolent;2549;26;2575;85161
52;85;01;05;162;Rives-d'Autise;2094;51;2145;85162
52;85;03;16;163;Noirmoutier-en-l'ÃŽle;4550;106;4656;85163
52;85;03;16;164;Notre-Dame-de-Monts;2149;47;2196;85164
52;85;01;05;167;L'Orbrie;787;17;804;85167
52;85;02;02;169;Palluau;1106;17;1123;85169
52;85;01;09;171;Péault;608;23;631;85171
52;85;03;16;172;Le Perrier;2056;34;2090;85172
52;85;01;04;174;Petosse;687;18;705;85174
52;85;01;09;175;Les Pineaux;660;3;663;85175
52;85;01;05;176;Pissotte;1160;36;1196;85176
52;85;01;05;177;Les Velluire-sur-Vendée;1383;22;1405;85177
52;85;02;01;178;Le Poiré-sur-Vie;8596;220;8816;85178
52;85;03;17;179;Poiroux;1158;11;1169;85179
52;85;01;08;181;Pouillé;644;17;661;85181
52;85;01;06;182;Pouzauges;5557;204;5761;85182
52;85;01;05;184;Puy-de-Serre;321;7;328;85184
52;85;01;08;185;Puyravault;657;6;663;85185
52;85;02;10;186;La Rabatelière;999;15;1014;85186
52;85;01;06;187;Réaumur;862;15;877;85187
52;85;01;04;188;La Réorthe;1097;22;1119;85188
52;85;03;16;189;Notre-Dame-de-Riez;2156;44;2200;85189
52;85;02;01;190;Rocheservière;3400;47;3447;85190
52;85;02;99;191;La Roche-sur-Yon;55147;2956;58103;85191
52;85;02;03;192;Rochetrejoux;988;9;997;85192
52;85;01;09;193;Rosnay;645;17;662;85193
52;85;03;14;194;Les Sables-d'Olonne;45030;1433;46463;85194
52;85;02;10;196;Saint-André-Goule-d'Oie;1892;16;1908;85196
52;85;02;01;197;Montréverd;3761;58;3819;85197
52;85;02;11;198;Saint-Aubin-des-Ormeaux;1344;18;1362;85198
52;85;01;04;199;Saint-Aubin-la-Plaine;542;6;548;85199
52;85;03;09;200;Saint-Avaugourd-des-Landes;1082;21;1103;85200
52;85;03;09;201;Saint-Benoist-sur-Mer;493;6;499;85201
52;85;02;03;202;Sainte-Cécile;1597;114;1711;85202
52;85;03;02;204;Saint-Christophe-du-Ligneron;2586;43;2629;85204
52;85;01;04;205;Saint-Cyr-des-Gâts;528;8;536;85205
52;85;03;09;206;Saint-Cyr-en-Talmondais;394;13;407;85206
52;85;01;08;207;Saint-Denis-du-Payré;389;8;397;85207
52;85;02;01;208;Saint-Denis-la-Chevasse;2376;37;2413;85208
52;85;01;04;209;Saint-Etienne-de-Brillouet;642;9;651;85209
52;85;02;02;210;Saint-Etienne-du-Bois;2135;25;2160;85210
52;85;03;17;211;Sainte-Flaive-des-Loups;2439;25;2464;85211
52;85;02;09;213;Rives de l'Yon;4217;171;4388;85213
52;85;03;17;214;Sainte-Foy;2378;47;2425;85214
52;85;02;10;215;Saint-Fulgent;3814;139;3953;85215
52;85;01;08;216;Sainte-Gemme-la-Plaine;2058;213;2271;85216
52;85;03;17;218;Saint-Georges-de-Pointindoux;1696;15;1711;85218
52;85;02;03;220;Saint-Germain-de-Prinçay;1598;27;1625;85220
52;85;03;16;221;Saint-Gervais;2697;36;2733;85221
52;85;03;15;222;Saint-Gilles-Croix-de-Vie;7862;250;8112;85222
52;85;01;04;223;Sainte-Hermine;2940;62;3002;85223
52;85;03;15;226;Saint-Hilaire-de-Riez;11297;204;11501;85226
52;85;01;05;227;Saint-Hilaire-des-Loges;1921;52;1973;85227
52;85;01;04;229;Saint-Hilaire-de-Voust;585;12;597;85229
52;85;03;17;231;Saint-Hilaire-la-Forêt;790;15;805;85231
52;85;02;03;232;Saint-Hilaire-le-Vouhis;1079;23;1102;85232
52;85;01;04;233;Saint-Jean-de-Beugné;604;9;613;85233
52;85;03;16;234;Saint-Jean-de-Monts;8696;226;8922;85234
52;85;01;04;235;Saint-Juire-Champgillon;421;13;434;85235
52;85;03;17;236;Saint-Julien-des-Landes;1872;21;1893;85236
52;85;01;04;237;Saint-Laurent-de-la-Salle;378;12;390;85237
52;85;02;11;238;Saint-Laurent-sur-Sèvre;3689;441;4130;85238
52;85;03;15;239;Saint-Maixent-sur-Vie;1124;5;1129;85239
52;85;02;11;240;Saint-Malô-du-Bois;1615;50;1665;85240
52;85;02;06;242;Saint-Mars-la-Réorthe;999;20;1019;85242
52;85;03;15;243;Brem-sur-Mer;2817;49;2866;85243
52;85;01;05;244;Saint-Martin-de-Fraigneau;821;58;879;85244
52;85;01;04;245;Saint-Martin-des-Fontaines;171;2;173;85245
52;85;02;03;246;Saint-Martin-des-Noyers;2483;39;2522;85246
52;85;02;11;247;Saint-Martin-des-Tilleuls;1082;18;1100;85247
52;85;01;04;248;Saint-Martin-Lars-en-Sainte-Hermine;416;12;428;85248
52;85;03;17;250;Saint-Mathurin;2323;35;2358;85250
52;85;01;04;251;Saint-Maurice-des-Noues;632;18;650;85251
52;85;01;04;252;Saint-Maurice-le-Girard;593;24;617;85252
52;85;01;06;254;Saint-Mesmin;1755;44;1799;85254
52;85;01;08;255;Saint-Michel-en-l'Herm;2341;80;2421;85255
52;85;01;05;256;Saint-Michel-le-Cloucq;1287;32;1319;85256
52;85;02;06;259;Saint-Paul-en-Pareds;1328;35;1363;85259
52;85;02;02;260;Saint-Paul-Mont-Penit;826;11;837;85260
52;85;01;09;261;Sainte-Pexine;278;12;290;85261
52;85;02;01;262;Saint-Philbert-de-Bouaine;3535;39;3574;85262
52;85;01;04;264;Saint-Pierre-du-Chemin;1331;20;1351;85264
52;85;01;05;265;Saint-Pierre-le-Vieux;940;21;961;85265
52;85;02;03;266;Saint-Prouant;1662;29;1691;85266
52;85;01;08;267;Sainte-Radégonde-des-Noyers;934;18;952;85267
52;85;03;15;268;Saint-Révérend;1459;31;1490;85268
52;85;01;05;269;Saint-Sigismond;419;7;426;85269
52;85;01;04;271;Saint-Sulpice-en-Pareds;436;13;449;85271
52;85;03;16;273;Saint-Urbain;1879;35;1914;85273
52;85;01;04;274;Saint-Valérien;532;12;544;85274
52;85;02;03;276;Saint-Vincent-Sterlanges;759;13;772;85276
52;85;03;09;277;Saint-Vincent-sur-Graon;1535;25;1560;85277
52;85;03;17;278;Saint-Vincent-sur-Jard;1312;22;1334;85278
52;85;03;02;280;Sallertaine;3171;71;3242;85280
52;85;01;04;281;Sérigné;987;30;1017;85281
52;85;02;03;282;Sigournais;912;16;928;85282
52;85;03;16;284;Soullans;4259;95;4354;85284
52;85;02;09;285;Le Tablier;740;13;753;85285
52;85;01;08;286;La Taillée;561;5;566;85286
52;85;01;06;287;Tallud-Sainte-Gemme;458;8;466;85287
52;85;03;17;288;Talmont-Saint-Hilaire;7831;185;8016;85288
52;85;01;04;289;La Tardière;1327;26;1353;85289
52;85;01;04;290;Thiré;553;13;566;85290
52;85;02;03;291;Thorigny;1231;20;1251;85291
52;85;01;04;292;Thouarsais-Bouildroux;778;10;788;85292
52;85;02;11;293;Tiffauges;1576;38;1614;85293
52;85;03;09;294;La Tranche-sur-Mer;2904;65;2969;85294
52;85;02;10;295;Treize-Septiers;3280;82;3362;85295
52;85;02;11;296;Treize-Vents;1246;24;1270;85296
52;85;01;08;297;Triaize;986;15;1001;85297
52;85;03;17;298;Vairé;1744;31;1775;85298
52;85;02;12;300;Venansault;4628;178;4806;85300
52;85;02;10;301;Vendrennes;1772;22;1794;85301
52;85;02;11;302;Chanverrie;5453;130;5583;85302
52;85;01;05;303;Vix;1809;30;1839;85303
52;85;01;08;304;Vouillé-les-Marais;753;10;763;85304
52;85;01;04;305;Vouvant;880;49;929;85305
52;85;01;05;306;Xanton-Chassenon;732;9;741;85306
52;85;03;09;307;La Faute-sur-Mer;665;8;673;85307
75;86;02;10;001;Adriers;714;8;722;86001
75;86;03;11;002;Amberre;580;20;600;86002
75;86;02;09;003;Anché;338;7;345;86003
75;86;01;12;004;Angles-sur-l'Anglin;347;14;361;86004
75;86;01;08;005;Angliers;617;23;640;86005
75;86;02;12;006;Antigny;546;19;565;86006
75;86;01;03;007;Antran;1163;32;1195;86007
75;86;01;08;008;Arçay;343;6;349;86008
75;86;01;05;009;Archigny;1070;17;1087;86009
75;86;03;18;010;Aslonnes;1119;19;1138;86010
75;86;02;10;011;Asnières-sur-Blour;180;4;184;86011
75;86;02;06;012;Asnois;164;8;172;86012
75;86;01;08;013;Aulnay;97;3;100;86013
75;86;01;05;014;Availles-en-Châtellerault;1740;42;1782;86014
75;86;02;06;015;Availles-Limouzine;1244;26;1270;86015
75;86;03;11;016;Avanton;2200;40;2240;86016
75;86;03;19;017;Ayron;1104;17;1121;86017
75;86;01;08;018;Basses;321;2;323;86018
75;86;03;07;019;Beaumont Saint-Cyr;2958;43;3001;86019
75;86;01;05;020;Bellefonds;253;4;257;86020
75;86;01;08;022;Berrie;259;4;263;86022
75;86;01;08;023;Berthegon;280;6;286;86023
75;86;03;19;024;Béruges;1553;24;1577;86024
75;86;02;12;025;Béthines;474;5;479;86025
75;86;01;08;026;Beuxes;546;5;551;86026
75;86;03;13;027;Biard;1832;62;1894;86027
75;86;03;01;028;Bignoux;1067;18;1085;86028
75;86;02;06;029;Blanzay;780;24;804;86029
75;86;03;01;031;Bonnes;1729;20;1749;86031
75;86;01;05;032;Bonneuil-Matours;2079;99;2178;86032
75;86;02;10;034;Bouresse;601;13;614;86034
75;86;02;12;035;Bourg-Archambault;185;6;191;86035
75;86;01;08;036;Bournand;885;20;905;86036
75;86;02;12;037;Brigueil-le-Chantre;507;6;513;86037
75;86;02;10;038;Brion;219;8;227;86038
75;86;02;09;039;Brux;733;9;742;86039
75;86;02;12;040;La Bussière;314;11;325;86040
75;86;03;14;041;Buxerolles;10060;139;10199;86041
75;86;01;03;042;Buxeuil;919;12;931;86042
75;86;01;08;044;Ceaux-en-Loudun;548;11;559;86044
75;86;03;09;045;Celle-Lévescault;1351;17;1368;86045
75;86;01;05;046;Cenon-sur-Vienne;1737;29;1766;86046
75;86;01;08;047;Cernay;485;13;498;86047
75;86;03;07;048;Chabournay;1153;12;1165;86048
75;86;01;08;049;Chalais;501;16;517;86049
75;86;03;19;050;Chalandray;843;13;856;86050
75;86;02;06;051;Champagné-le-Sec;197;4;201;86051
75;86;02;06;052;Champagné-Saint-Hilaire;995;20;1015;86052
75;86;03;11;053;Champigny en Rochereau;1961;36;1997;86053
75;86;02;06;054;Champniers;352;5;357;86054
75;86;02;06;055;La Chapelle-Bâton;356;12;368;86055
75;86;03;01;058;La Chapelle-Moulière;726;20;746;86058
75;86;02;05;059;Chapelle-Viviers;581;4;585;86059
75;86;02;06;061;Charroux;1128;25;1153;86061
75;86;03;01;062;Chasseneuil-du-Poitou;4692;51;4743;86062
75;86;02;06;063;Chatain;249;1;250;86063
75;86;02;06;064;Château-Garnier;613;10;623;86064
75;86;03;18;065;Château-Larcher;1045;16;1061;86065
75;86;01;98;066;Châtellerault;31487;799;32286;86066
75;86;02;09;068;Chaunay;1211;17;1228;86068
75;86;01;08;069;La Chaussée;180;4;184;86069
75;86;03;05;070;Chauvigny;7062;114;7176;86070
75;86;01;04;072;Chenevelles;454;9;463;86072
75;86;03;11;073;Cherves;528;11;539;86073
75;86;03;19;074;Chiré-en-Montreuil;915;15;930;86074
75;86;03;08;075;Chouppes;750;19;769;86075
75;86;03;11;076;Cissé;2835;48;2883;86076
75;86;02;10;077;Civaux;1209;17;1226;86077
75;86;02;06;078;Civray;2596;137;2733;86078
75;86;01;08;079;La Roche-Rigault;560;36;596;86079
75;86;03;09;080;Cloué;493;5;498;86080
75;86;01;02;081;Colombiers;1438;30;1468;86081
75;86;02;09;082;Valence-en-Poitou;4455;116;4571;86082
75;86;03;09;083;Coulombiers;1132;13;1145;86083
75;86;02;12;084;Coulonges;235;5;240;86084
75;86;03;08;085;Coussay;249;6;255;86085
75;86;01;04;086;Coussay-les-Bois;954;17;971;86086
75;86;01;08;087;Craon;185;4;189;86087
75;86;03;13;088;Croutelle;865;24;889;86088
75;86;03;11;089;Cuhon;391;6;397;86089
75;86;01;08;090;Curçay-sur-Dive;216;1;217;86090
75;86;03;09;091;Curzay-sur-Vonne;387;7;394;86091
75;86;01;03;092;Dangé-Saint-Romain;2969;58;3027;86092
75;86;01;08;093;Dercé;156;3;159;86093
75;86;03;18;094;Dienné;573;12;585;86094
75;86;03;07;095;Dissay;3255;50;3305;86095
75;86;01;08;096;Doussay;659;9;668;86096
75;86;02;06;097;La Ferrière-Airoux;328;5;333;86097
75;86;02;05;098;Fleix;141;2;143;86098
75;86;03;18;099;Fleuré;1054;9;1063;86099
75;86;03;13;100;Fontaine-le-Comte;3934;74;4008;86100
75;86;03;19;102;Frozes;583;8;591;86102
75;86;02;10;103;Gençay;1746;65;1811;86103
75;86;02;06;104;Genouillé;497;5;502;86104
75;86;03;18;105;Gizay;369;1;370;86105
75;86;01;08;106;Glénouze;98;2;100;86106
75;86;02;10;107;Gouex;467;8;475;86107
75;86;01;08;108;La Grimaudière;402;12;414;86108
75;86;01;08;109;Guesnes;220;8;228;86109
75;86;02;12;110;Haims;227;4;231;86110
75;86;01;03;111;Ingrandes;1744;35;1779;86111
75;86;02;10;112;L'Isle-Jourdain;1165;12;1177;86112
75;86;03;18;113;Iteuil;2966;49;3015;86113
75;86;03;01;114;Jardres;1279;23;1302;86114
75;86;03;07;115;Jaunay-Marigny;7600;255;7855;86115
75;86;03;09;116;Jazeneuil;783;17;800;86116
75;86;02;12;117;Jouhet;525;7;532;86117
75;86;02;12;118;Journet;373;9;382;86118
75;86;02;06;119;Joussé;302;1;303;86119
75;86;02;12;120;Lathus-Saint-Rémy;1217;16;1233;86120
75;86;03;19;121;Latillé;1458;27;1485;86121
75;86;02;05;122;Lauthiers;67;3;70;86122
75;86;03;19;123;Boivre-la-Vallée;3073;52;3125;86123
75;86;03;01;124;Lavoux;1185;19;1204;86124
75;86;01;04;125;Leigné-les-Bois;596;13;609;86125
75;86;02;05;126;Leignes-sur-Fontaine;644;13;657;86126
75;86;01;03;127;Leigné-sur-Usseau;465;3;468;86127
75;86;01;02;128;Lencloître;2457;31;2488;86128
75;86;01;04;129;Lésigny;527;8;535;86129
75;86;01;03;130;Leugny;382;4;386;86130
75;86;02;10;131;Lhommaizé;883;24;907;86131
75;86;02;12;132;Liglet;310;3;313;86132
75;86;03;17;133;Ligugé;3374;59;3433;86133
75;86;02;06;134;Linazay;221;1;222;86134
75;86;03;01;135;Liniers;573;11;584;86135
75;86;02;06;136;Lizant;391;8;399;86136
75;86;01;08;137;Loudun;6712;351;7063;86137
75;86;02;10;138;Luchapt;250;3;253;86138
75;86;03;09;139;Lusignan;2659;38;2697;86139
75;86;02;10;140;Lussac-les-Châteaux;2294;50;2344;86140
75;86;02;06;141;Magné;674;14;688;86141
75;86;03;19;142;Maillé;642;12;654;86142
75;86;01;04;143;Mairé;169;5;174;86143
75;86;03;11;144;Maisonneuve;328;8;336;86144
75;86;03;18;145;Marçay;1228;15;1243;86145
75;86;03;18;147;Marigny-Chemereau;605;12;617;86147
75;86;03;18;148;Marnay;712;12;724;86148
75;86;01;08;149;Martaizé;376;9;385;86149
75;86;03;11;150;Massognes;274;7;281;86150
75;86;01;08;151;Maulay;174;8;182;86151
75;86;02;06;152;Mauprévoir;583;15;598;86152
75;86;02;10;153;Mazerolles;862;13;875;86153
75;86;01;08;154;Mazeuil;263;4;267;86154
75;86;01;08;156;Messemé;239;4;243;86156
75;86;03;16;157;Mignaloux-Beauvoir;5026;176;5202;86157
75;86;03;11;158;Migné-Auxances;6154;117;6271;86158
75;86;02;10;159;Millac;552;14;566;86159
75;86;03;11;160;Mirebeau;2171;34;2205;86160
75;86;01;08;161;Moncontour;998;19;1017;86161
75;86;01;03;162;Mondion;110;1;111;86162
75;86;03;01;163;Montamisé;3677;61;3738;86163
75;86;01;05;164;Monthoiron;665;5;670;86164
75;86;02;12;165;Montmorillon;5940;459;6399;86165
75;86;01;08;167;Monts-sur-Guesnes;909;7;916;86167
75;86;01;08;169;Morton;348;5;353;86169
75;86;02;12;170;Moulismes;367;12;379;86170
75;86;02;10;171;Moussac;441;14;455;86171
75;86;02;10;172;Mouterre-sur-Blourde;162;4;166;86172
75;86;01;08;173;Mouterre-Silly;661;12;673;86173
75;86;01;02;174;Naintré;5941;119;6060;86174
75;86;02;12;175;Nalliers;312;12;324;86175
75;86;02;10;176;Nérignac;123;5;128;86176
75;86;03;11;177;Neuville-de-Poitou;5359;84;5443;86177
75;86;03;18;178;Nieuil-l'Espoir;2757;38;2795;86178
75;86;03;18;180;Nouaillé-Maupertuis;2847;52;2899;86180
75;86;01;08;181;Nueil-sous-Faye;208;5;213;86181
75;86;01;03;182;Orches;378;9;387;86182
75;86;01;03;183;Les Ormes;1606;21;1627;86183
75;86;01;02;184;Ouzilly;939;11;950;86184
75;86;01;03;186;Oyré;952;23;975;86186
75;86;02;05;187;Paizay-le-Sec;458;14;472;86187
75;86;02;06;189;Payroux;475;6;481;86189
75;86;02;10;190;Persac;737;14;751;86190
75;86;02;12;191;Pindray;248;7;255;86191
75;86;02;12;192;Plaisance;174;4;178;86192
75;86;01;04;193;Pleumartin;1217;13;1230;86193
75;86;03;99;194;Poitiers;89212;2275;91487;86194
75;86;01;03;195;Port-de-Piles;571;11;582;86195
75;86;01;08;196;Pouançay;234;5;239;86196
75;86;01;08;197;Pouant;416;11;427;86197
75;86;03;01;198;Pouillé;692;9;701;86198
75;86;02;06;200;Pressac;572;12;584;86200
75;86;01;08;201;Prinçay;212;2;214;86201
75;86;03;12;202;La Puye;599;10;609;86202
75;86;02;10;203;Queaux;547;11;558;86203
75;86;03;19;204;Quinçay;2160;56;2216;86204
75;86;01;08;205;Ranton;200;3;203;86205
75;86;01;08;206;Raslay;138;5;143;86206
75;86;01;04;207;La Roche-Posay;1560;31;1591;86207
75;86;03;18;209;Roches-Prémarie-Andillé;2034;32;2066;86209
75;86;01;08;210;Roiffé;753;20;773;86210
75;86;02;09;211;Romagne;905;92;997;86211
75;86;03;09;213;Rouillé;2496;185;2681;86213
75;86;03;17;214;Saint-Benoît;7267;247;7514;86214
75;86;01;03;217;Saint-Christophe;290;12;302;86217
75;86;01;08;218;Saint-Clair;198;8;206;86218
75;86;02;06;220;Saint-Gaudent;313;8;321;86220
75;86;01;02;221;Saint-Genest-d'Ambière;1205;22;1227;86221
75;86;03;07;222;Saint-Georges-lès-Baillargeaux;4233;56;4289;86222
75;86;02;12;223;Saint-Germain;915;25;940;86223
75;86;01;03;224;Saint-Gervais-les-Trois-Clochers;1327;32;1359;86224
75;86;01;08;225;Saint-Jean-de-Sauves;1408;29;1437;86225
75;86;03;01;226;Saint-Julien-l'Ars;2779;49;2828;86226
75;86;01;08;227;Saint-Laon;133;4;137;86227
75;86;02;10;228;Saint-Laurent-de-Jourdes;198;3;201;86228
75;86;01;08;229;Saint-Léger-de-Montbrillais;338;5;343;86229
75;86;02;12;230;Saint-Léomer;174;4;178;86230
75;86;02;06;231;Saint-Macoux;485;17;502;86231
75;86;02;05;233;Valdivienne;2749;43;2792;86233
75;86;02;06;234;Saint-Martin-l'Ars;385;5;390;86234
75;86;02;10;235;Saint-Maurice-la-Clouère;1299;36;1335;86235
75;86;02;12;236;Saint-Pierre-de-Maillé;885;16;901;86236
75;86;02;06;237;Saint-Pierre-d'Exideuil;769;20;789;86237
75;86;03;05;239;Sainte-Radégonde;172;0;172;86239
75;86;01;03;241;Saint-Rémy-sur-Creuse;391;6;397;86241
75;86;02;06;242;Saint-Romain;394;7;401;86242
75;86;03;09;244;Saint-Sauvant;1255;24;1279;86244
75;86;01;04;245;Senillé-Saint-Sauveur;1795;43;1838;86245
75;86;02;12;246;Saint-Savin;826;16;842;86246
75;86;02;06;247;Saint-Saviol;534;13;547;86247
75;86;02;10;248;Saint-Secondin;536;16;552;86248
75;86;01;08;249;Saires;125;6;131;86249
75;86;01;08;250;Saix;290;5;295;86250
75;86;01;08;252;Sammarçolles;651;14;665;86252
75;86;03;09;253;Sanxay;550;11;561;86253
75;86;02;12;254;Saulgé;1005;11;1016;86254
75;86;02;06;255;Savigné;1337;27;1364;86255
75;86;03;01;256;Savigny-Lévescault;1187;25;1212;86256
75;86;01;03;257;Savigny-sous-Faye;373;5;378;86257
75;86;01;02;258;Scorbé-Clairvaux;2242;31;2273;86258
75;86;01;03;260;Sérigny;311;1;312;86260
75;86;03;01;261;Sèvres-Anxaumont;2236;77;2313;86261
75;86;02;10;262;Sillars;593;15;608;86262
75;86;03;18;263;Smarves;2892;44;2936;86263
75;86;02;06;264;Sommières-du-Clain;753;17;770;86264
75;86;01;03;265;Sossais;428;7;435;86265
75;86;02;06;266;Surin;142;2;144;86266
75;86;03;01;268;Tercé;1118;17;1135;86268
75;86;01;08;269;Ternay;191;3;194;86269
75;86;02;12;270;Thollet;151;3;154;86270
75;86;03;11;271;Thurageau;814;14;828;86271
75;86;01;02;272;Thuré;2858;151;3009;86272
75;86;02;12;273;La Trimouille;859;23;882;86273
75;86;01;08;274;Les Trois-Moutiers;1097;24;1121;86274
75;86;01;03;275;Usseau;601;9;610;86275
75;86;02;10;276;Usson-du-Poitou;1251;22;1273;86276
75;86;01;03;279;Vaux-sur-Vienne;532;6;538;86279
75;86;01;03;280;Vellèches;358;5;363;86280
75;86;03;07;281;Saint-Martin-la-Pallu;5578;88;5666;86281
75;86;03;18;284;Vernon;714;21;735;86284
75;86;02;10;285;Verrières;969;25;994;86285
75;86;01;08;286;Verrue;389;4;393;86286
75;86;01;08;287;Vézières;357;6;363;86287
75;86;01;04;288;Vicq-sur-Gartempe;607;7;614;86288
75;86;02;10;289;Le Vigeant;676;30;706;86289
75;86;03;18;290;La Villedieu-du-Clain;1555;35;1590;86290
75;86;02;12;291;Villemort;102;7;109;86291
75;86;03;11;292;Villiers;920;18;938;86292
75;86;03;18;293;Vivonne;4409;75;4484;86293
75;86;03;19;294;Vouillé;3683;73;3756;86294
75;86;02;06;295;Voulême;391;5;396;86295
75;86;02;09;296;Voulon;471;7;478;86296
75;86;03;19;297;Vouneuil-sous-Biard;6060;142;6202;86297
75;86;01;05;298;Vouneuil-sur-Vienne;2264;31;2295;86298
75;86;03;11;299;Vouzailles;575;9;584;86299
75;86;03;11;300;Yversay;602;5;607;86300
75;87;02;01;001;Aixe-sur-Vienne;5804;78;5882;87001
75;87;02;02;002;Ambazac;5593;74;5667;87002
75;87;01;04;003;Arnac-la-Poste;936;26;962;87003
75;87;02;07;004;Augne;109;2;111;87004
75;87;02;20;005;Aureil;1008;20;1028;87005
75;87;01;04;006;Azat-le-Ris;246;1;247;87006
75;87;01;04;007;Balledent;196;3;199;87007
75;87;01;04;008;La Bazeuge;147;0;147;87008
75;87;02;07;009;Beaumont-du-Lac;142;5;147;87009
75;87;01;03;011;Bellac;3639;127;3766;87011
75;87;01;03;012;Berneuil;437;5;442;87012
75;87;02;02;013;Bersac-sur-Rivalier;651;16;667;87013
75;87;01;02;014;Bessines-sur-Gartempe;2803;57;2860;87014
75;87;02;01;015;Beynac;702;73;775;87015
75;87;02;02;016;Les Billanges;282;6;288;87016
75;87;01;03;017;Blanzac;499;11;510;87017
75;87;01;03;018;Blond;696;24;720;87018
75;87;02;05;019;Boisseuil;2926;63;2989;87019
75;87;02;02;020;Bonnac-la-Côte;1651;27;1678;87020
75;87;02;01;021;Bosmie-l'Aiguille;2616;34;2650;87021
75;87;01;03;022;Breuilaufa;120;1;121;87022
75;87;01;03;023;Le Buis;188;4;192;87023
75;87;02;07;024;Bujaleuf;814;9;823;87024
75;87;02;01;025;Burgnac;848;12;860;87025
75;87;02;21;027;Bussière-Galant;1282;16;1298;87027
75;87;01;04;028;Val-d'Oire-et-Gartempe;1646;22;1668;87028
75;87;02;21;029;Les Cars;629;11;640;87029
75;87;03;19;030;Chaillac-sur-Vienne;1257;23;1280;87030
75;87;02;21;031;Le Chalard;310;4;314;87031
75;87;02;21;032;Châlus;1640;29;1669;87032
75;87;01;03;033;Chamboret;791;9;800;87033
75;87;03;18;034;Champagnac-la-Rivière;566;8;574;87034
75;87;02;20;035;Champnétery;530;9;539;87035
75;87;03;18;036;Champsac;669;11;680;87036
75;87;03;18;037;La Chapelle-Montbrandeix;262;2;264;87037
75;87;02;06;038;Chaptelat;2102;18;2120;87038
75;87;02;07;039;Château-Chervix;800;13;813;87039
75;87;02;07;040;Châteauneuf-la-Forêt;1523;20;1543;87040
75;87;01;04;041;Châteauponsac;2042;21;2063;87041
75;87;02;20;042;Le Châtenet-en-Dognon;388;6;394;87042
75;87;02;07;043;Cheissoux;204;2;206;87043
75;87;03;18;044;Chéronnac;323;6;329;87044
75;87;01;03;045;Cieux;1002;13;1015;87045
75;87;03;18;046;Cognac-la-Forêt;1188;9;1197;87046
75;87;01;03;047;Compreignac;1854;16;1870;87047
75;87;02;05;048;Condat-sur-Vienne;5128;73;5201;87048
75;87;02;07;049;Coussac-Bonneval;1317;34;1351;87049
75;87;02;06;050;Couzeix;9518;161;9679;87050
75;87;02;07;051;La Croisille-sur-Briance;624;12;636;87051
75;87;01;04;052;La Croix-sur-Gartempe;180;1;181;87052
75;87;01;04;053;Cromac;244;2;246;87053
75;87;03;18;054;Cussac;1192;18;1210;87054
75;87;01;04;056;Dinsac;275;3;278;87056
75;87;01;04;057;Dompierre-les-Eglises;369;5;374;87057
75;87;02;07;058;Domps;107;3;110;87058
75;87;01;04;059;Le Dorat;1586;64;1650;87059
75;87;03;18;060;Dournazac;671;9;680;87060
75;87;01;04;061;Droux;346;5;351;87061
75;87;02;20;062;Eybouleuf;457;8;465;87062
75;87;02;05;063;Eyjeaux;1316;22;1338;87063
75;87;02;07;064;Eymoutiers;2077;24;2101;87064
75;87;02;17;065;Feytiat;6118;78;6196;87065
75;87;02;21;066;Flavignac;1075;11;1086;87066
75;87;01;02;067;Folles;466;9;475;87067
75;87;01;02;068;Fromental;517;16;533;87068
75;87;01;03;069;Gajoubert;140;1;141;87069
75;87;02;20;070;La Geneytouse;975;17;992;87070
75;87;02;21;071;Glandon;780;18;798;87071
75;87;02;07;072;Glanges;507;10;517;87072
75;87;03;18;073;Gorre;388;9;397;87073
75;87;01;04;074;Les Grands-Chézeaux;246;2;248;87074
75;87;02;16;075;Isle;7847;151;7998;87075
75;87;02;02;076;Jabreilles-les-Bordes;235;3;238;87076
75;87;02;21;077;Janailhac;527;9;536;87077
75;87;03;19;078;Javerdat;695;5;700;87078
75;87;02;02;079;La Jonchère-Saint-Maurice;839;12;851;87079
75;87;01;04;080;Jouac;179;3;182;87080
75;87;02;01;081;Jourgnac;1106;14;1120;87081
75;87;02;21;082;Ladignac-le-Long;1165;12;1177;87082
75;87;02;02;083;Laurière;543;7;550;87083
75;87;02;21;084;Lavignac;165;4;169;87084
75;87;02;99;085;Limoges;130876;2260;133136;87085
75;87;02;07;086;Linards;1030;16;1046;87086
75;87;01;04;087;Lussac-les-Eglises;488;3;491;87087
75;87;02;07;088;Magnac-Bourg;1106;20;1126;87088
75;87;01;04;089;Magnac-Laval;1711;168;1879;87089
75;87;01;04;090;Mailhac-sur-Benaize;265;5;270;87090
75;87;03;18;091;Maisonnais-sur-Tardoire;384;7;391;87091
75;87;03;18;092;Marval;500;6;506;87092
75;87;02;07;093;Masléon;281;3;284;87093
75;87;02;21;094;Meilhac;527;5;532;87094
75;87;02;07;095;Meuzac;733;13;746;87095
75;87;02;21;096;La Meyze;847;20;867;87096
75;87;01;03;097;Val d'Issoire;1025;12;1037;87097
75;87;02;20;099;Moissannes;337;16;353;87099
75;87;01;03;100;Montrol-Sénard;268;2;270;87100
75;87;01;03;101;Mortemart;119;1;120;87101
75;87;01;03;103;Nantiat;1614;25;1639;87103
75;87;02;07;104;Nedde;456;4;460;87104
75;87;02;07;105;Neuvic-Entier;923;17;940;87105
75;87;02;21;106;Nexon;2509;45;2554;87106
75;87;02;06;107;Nieul;1635;18;1653;87107
75;87;01;03;108;Nouic;461;5;466;87108
75;87;01;04;109;Oradour-Saint-Genest;329;34;363;87109
75;87;03;19;110;Oradour-sur-Glane;2477;22;2499;87110
75;87;03;18;111;Oradour-sur-Vayres;1490;20;1510;87111
75;87;02;21;112;Pageas;576;13;589;87112
75;87;02;12;113;Le Palais-sur-Vienne;6023;64;6087;87113
75;87;02;17;114;Panazol;10900;212;11112;87114
75;87;03;18;115;Pensol;173;2;175;87115
75;87;01;03;116;Peyrat-de-Bellac;1044;24;1068;87116
75;87;02;07;117;Peyrat-le-Château;1027;16;1043;87117
75;87;02;06;118;Peyrilhac;1278;13;1291;87118
75;87;02;05;119;Pierre-Buffière;1161;11;1172;87119
75;87;02;07;120;La Porcherie;504;11;515;87120
75;87;01;04;121;Rancon;488;11;499;87121
75;87;01;02;122;Razès;1173;13;1186;87122
75;87;02;07;123;Rempnat;149;4;153;87123
75;87;02;21;124;Rilhac-Lastours;373;2;375;87124
75;87;02;12;125;Rilhac-Rancon;4608;65;4673;87125
75;87;03;18;126;Rochechouart;3767;51;3818;87126
75;87;02;21;127;La Roche-l'Abeille;604;13;617;87127
75;87;01;03;128;Saint-Pardoux-le-Lac;1327;13;1340;87128
75;87;02;20;129;Royères;955;7;962;87129
75;87;02;07;130;Roziers-Saint-Georges;172;0;172;87130
75;87;03;19;131;Saillat-sur-Vienne;812;12;824;87131
75;87;02;07;132;Saint-Amand-le-Petit;110;4;114;87132
75;87;01;04;133;Saint-Amand-Magnazeix;496;4;500;87133
75;87;02;07;134;Sainte-Anne-Saint-Priest;155;3;158;87134
75;87;03;18;135;Saint-Auvent;960;18;978;87135
75;87;03;18;137;Saint-Bazile;129;2;131;87137
75;87;02;05;138;Saint-Bonnet-Briance;571;14;585;87138
75;87;01;03;139;Saint-Bonnet-de-Bellac;460;8;468;87139
75;87;03;19;140;Saint-Brice-sur-Vienne;1682;17;1699;87140
75;87;03;18;141;Saint-Cyr;683;10;693;87141
75;87;02;20;142;Saint-Denis-des-Murs;541;7;548;87142
75;87;02;06;143;Saint-Gence;2170;27;2197;87143
75;87;02;05;144;Saint-Genest-sur-Roselle;518;5;523;87144
75;87;01;04;145;Saint-Georges-les-Landes;237;1;238;87145
75;87;02;07;146;Saint-Germain-les-Belles;1159;13;1172;87146
75;87;02;07;147;Saint-Gilles-les-Forêts;47;2;49;87147
75;87;02;05;148;Saint-Hilaire-Bonneval;990;12;1002;87148
75;87;01;04;149;Saint-Hilaire-la-Treille;374;8;382;87149
75;87;02;21;150;Saint-Hilaire-les-Places;849;14;863;87150
75;87;02;05;151;Saint-Jean-Ligoure;500;9;509;87151
75;87;02;06;152;Saint-Jouvent;1658;23;1681;87152
75;87;02;07;153;Saint-Julien-le-Petit;291;0;291;87153
75;87;03;19;154;Saint-Junien;11254;277;11531;87154
75;87;01;03;155;Saint-Junien-les-Combes;179;7;186;87155
75;87;02;20;156;Saint-Just-le-Martel;2670;46;2716;87156
75;87;02;02;157;Saint-Laurent-les-Eglises;843;34;877;87157
75;87;03;18;158;Saint-Laurent-sur-Gorre;1439;14;1453;87158
75;87;02;02;159;Saint-Léger-la-Montagne;350;3;353;87159
75;87;01;04;160;Saint-Léger-Magnazeix;495;4;499;87160
75;87;02;20;161;Saint-Léonard-de-Noblat;4385;115;4500;87161
75;87;03;18;162;Sainte-Marie-de-Vaux;204;2;206;87162
75;87;01;03;163;Saint-Martial-sur-Isop;140;4;144;87163
75;87;03;19;164;Saint-Martin-de-Jussac;568;10;578;87164
75;87;01;04;165;Saint-Martin-le-Mault;137;1;138;87165
75;87;02;01;166;Saint-Martin-le-Vieux;930;16;946;87166
75;87;02;20;167;Saint-Martin-Terressus;553;5;558;87167
75;87;03;18;168;Saint-Mathieu;1079;14;1093;87168
75;87;02;05;169;Saint-Maurice-les-Brousses;1052;25;1077;87169
75;87;02;07;170;Saint-Méard;351;7;358;87170
75;87;01;04;172;Saint-Ouen-sur-Gartempe;216;5;221;87172
75;87;02;05;174;Saint-Paul;1227;23;1250;87174
75;87;02;07;176;Saint-Priest-Ligoure;667;12;679;87176
75;87;02;01;177;Saint-Priest-sous-Aixe;1790;19;1809;87177
75;87;02;20;178;Saint-Priest-Taurion;2888;32;2920;87178
75;87;01;04;179;Saint-Sornin-la-Marche;241;0;241;87179
75;87;01;04;180;Saint-Sornin-Leulac;577;4;581;87180
75;87;02;02;181;Saint-Sulpice-Laurière;825;17;842;87181
75;87;01;04;182;Saint-Sulpice-les-Feuilles;1203;17;1220;87182
75;87;02;02;183;Saint-Sylvestre;919;10;929;87183
75;87;03;19;185;Saint-Victurnien;1774;29;1803;87185
75;87;02;07;186;Saint-Vitte-sur-Briance;320;4;324;87186
75;87;02;21;187;Saint-Yrieix-la-Perche;6718;432;7150;87187
75;87;02;01;188;Saint-Yrieix-sous-Aixe;432;3;435;87188
75;87;03;18;189;Les Salles-Lavauguyon;139;1;140;87189
75;87;02;20;190;Sauviat-sur-Vige;870;7;877;87190
75;87;02;01;191;Séreilhac;1989;23;2012;87191
75;87;02;05;192;Solignac;1583;24;1607;87192
75;87;02;07;193;Surdoux;44;3;47;87193
75;87;02;07;194;Sussac;347;3;350;87194
75;87;01;04;195;Tersannes;135;1;136;87195
75;87;01;03;197;Thouron;565;9;574;87197
75;87;01;03;198;Vaulry;413;5;418;87198
75;87;03;18;199;Vayres;734;13;747;87199
75;87;01;04;200;Verneuil-Moustiers;129;0;129;87200
75;87;02;01;201;Verneuil-sur-Vienne;4881;217;5098;87201
75;87;02;06;202;Veyrac;2112;35;2147;87202
75;87;02;07;203;Vicq-sur-Breuilh;1327;27;1354;87203
75;87;03;18;204;Videix;204;4;208;87204
75;87;02;05;205;Le Vigen;2236;40;2276;87205
75;87;01;04;206;Villefavard;159;1;160;87206
44;88;01;04;001;Les Ableuvenettes;58;0;58;88001
44;88;01;04;002;Ahéville;75;0;75;88002
44;88;02;17;003;Aingeville;62;1;63;88003
44;88;02;04;004;Ainvelle;133;6;139;88004
44;88;03;11;005;Allarmont;203;4;207;88005
44;88;01;09;006;Ambacourt;290;8;298;88006
44;88;02;04;007;Ameuvelle;48;1;49;88007
44;88;01;11;008;Anglemont;168;3;171;88008
44;88;03;07;009;Anould;3368;68;3436;88009
44;88;02;09;010;Aouze;198;1;199;88010
44;88;01;05;011;Arches;1634;53;1687;88011
44;88;01;06;012;Archettes;1105;13;1118;88012
44;88;02;09;013;Aroffe;86;0;86;88013
44;88;03;07;014;Arrentès-de-Corcieux;183;5;188;88014
44;88;02;10;015;Attignéville;206;3;209;88015
44;88;02;04;016;Attigny;212;9;221;88016
44;88;02;17;017;Aulnois;166;6;172;88017
44;88;02;10;019;Autigny-la-Tour;149;3;152;88019
44;88;02;10;020;Autreville;188;5;193;88020
44;88;01;13;021;Autrey;283;12;295;88021
44;88;02;17;022;Auzainvilliers;234;6;240;88022
44;88;01;03;023;Avillers;81;2;83;88023
44;88;01;03;024;Avrainville;114;0;114;88024
44;88;02;10;025;Avranville;69;3;72;88025
44;88;01;02;026;Aydoilles;1009;48;1057;88026
44;88;01;02;027;Badménil-aux-Bois;144;6;150;88027
44;88;01;06;028;La Baffe;618;95;713;88028
44;88;01;16;029;La Vôge-les-Bains;1609;126;1735;88029
44;88;01;04;030;Bainville-aux-Saules;147;0;147;88030
44;88;02;09;031;Balléville;99;4;103;88031
44;88;03;14;032;Ban-de-Laveline;1199;33;1232;88032
44;88;03;11;033;Ban-de-Sapt;350;7;357;88033
44;88;03;07;035;Barbey-Seroux;145;6;151;88035
44;88;02;10;036;Barville;96;2;98;88036
44;88;03;01;037;Basse-sur-le-Rupt;871;27;898;88037
44;88;01;03;038;Battexey;36;0;36;88038
44;88;01;09;039;Baudricourt;331;7;338;88039
44;88;01;02;040;Bayecourt;250;5;255;88040
44;88;01;04;041;Bazegney;109;8;117;88041
44;88;01;11;042;Bazien;80;1;81;88042
44;88;02;17;043;Bazoilles-et-Ménil;110;3;113;88043
44;88;02;10;044;Bazoilles-sur-Meuse;603;16;619;88044
44;88;02;10;045;Beaufremont;87;0;87;88045
44;88;01;02;046;Beauménil;130;4;134;88046
44;88;01;04;047;Begnécourt;148;7;155;88047
44;88;01;16;048;Bellefontaine;981;26;1007;88048
44;88;02;04;049;Belmont-lès-Darney;113;2;115;88049
44;88;01;02;050;Belmont-sur-Buttant;303;5;308;88050
44;88;02;17;051;Belmont-sur-Vair;133;1;134;88051
44;88;02;04;052;Belrupt;97;2;99;88052
44;88;03;11;053;Belval;161;2;163;88053
44;88;03;14;054;Bertrimoutier;306;10;316;88054
44;88;01;03;055;Bettegney-Saint-Brice;164;0;164;88055
44;88;01;03;056;Bettoncourt;96;2;98;88056
44;88;03;14;057;Le Beulay;92;6;98;88057
44;88;01;09;058;Biécourt;97;5;102;88058
44;88;03;02;059;Biffontaine;398;12;410;88059
44;88;01;09;060;Blémerey;32;1;33;88060
44;88;02;04;061;Bleurville;298;13;311;88061
44;88;02;04;062;Blevaincourt;98;2;100;88062
44;88;01;04;063;Bocquegney;136;4;140;88063
44;88;03;02;064;Bois-de-Champ;108;1;109;88064
44;88;02;04;065;Bonvillet;288;5;293;88065
44;88;01;09;066;Boulaincourt;68;4;72;88066
44;88;03;13;068;La Bourgonce;899;20;919;88068
44;88;01;03;069;Bouxières-aux-Bois;136;6;142;88069
44;88;01;03;070;Bouxurulles;174;1;175;88070
44;88;01;04;071;Bouzemont;52;1;53;88071
44;88;01;03;073;Brantigny;213;4;217;88073
44;88;02;10;074;Brechainville;60;0;60;88074
44;88;03;01;075;La Bresse;4143;150;4293;88075
44;88;01;02;076;Brouvelieures;433;10;443;88076
44;88;01;11;077;Brû;566;14;580;88077
44;88;01;02;078;Bruyères;3073;54;3127;88078
44;88;02;17;079;Bulgnéville;1539;103;1642;88079
44;88;01;03;080;Bult;306;2;308;88080
44;88;01;15;081;Bussang;1349;23;1372;88081
44;88;03;11;082;Celles-sur-Plaine;784;17;801;88082
44;88;02;10;083;Certilleux;211;10;221;88083
44;88;01;03;084;Chamagne;466;9;475;88084
44;88;03;02;085;Champdray;187;2;189;88085
44;88;01;02;086;Champ-le-Duc;518;24;542;88086
44;88;01;05;087;Chantraine;3197;95;3292;88087
44;88;01;16;088;La Chapelle-aux-Bois;672;8;680;88088
44;88;03;07;089;La Chapelle-devant-Bruyères;562;14;576;88089
44;88;01;03;090;Charmes;4690;55;4745;88090
44;88;01;02;091;Charmois-devant-Bruyères;387;9;396;88091
44;88;01;16;092;Charmois-l'Orgueilleux;587;8;595;88092
44;88;03;11;093;Châtas;43;2;45;88093
44;88;01;03;094;Châtel-sur-Moselle;1708;50;1758;88094
44;88;02;09;095;Châtenois;1702;44;1746;88095
44;88;02;04;096;Châtillon-sur-Saône;112;8;120;88096
44;88;01;09;097;Chauffecourt;43;1;44;88097
44;88;01;05;098;Chaumousey;901;25;926;88098
44;88;01;08;099;Chavelot;1367;22;1389;88099
44;88;01;09;100;Chef-Haut;46;2;48;88100
44;88;01;02;101;Cheniménil;1236;24;1260;88101
44;88;02;10;102;Chermisey;95;1;96;88102
44;88;01;04;103;Circourt;87;2;89;88103
44;88;02;10;104;Circourt-sur-Mouzon;185;10;195;88104
44;88;02;04;105;Claudon;213;4;217;88105
44;88;03;07;106;Ban-sur-Meurthe-Clefcy;946;29;975;88106
44;88;02;10;107;Clérey-la-Côte;34;0;34;88107
44;88;01;16;108;Le Clerjus;508;19;527;88108
44;88;03;12;109;Cleurie;646;13;659;88109
44;88;01;03;110;Clézentaine;219;5;224;88110
44;88;03;14;111;Coinches;355;4;359;88111
44;88;03;14;113;Combrimont;134;1;135;88113
44;88;02;17;114;Contrexéville;3190;224;3414;88114
44;88;03;07;115;Corcieux;1500;14;1514;88115
44;88;03;01;116;Cornimont;3111;71;3182;88116
44;88;02;09;117;Courcelles-sous-Châtenois;78;1;79;88117
44;88;02;10;118;Coussey;713;20;733;88118
44;88;02;17;119;Crainvilliers;174;2;176;88119
44;88;03;14;120;La Croix-aux-Mines;486;9;495;88120
44;88;01;03;121;Damas-aux-Bois;271;6;277;88121
44;88;01;04;122;Damas-et-Bettegney;364;7;371;88122
44;88;02;04;123;Damblain;252;5;257;88123
44;88;02;04;124;Darney;1076;53;1129;88124
44;88;02;09;125;Darney-aux-Chênes;66;1;67;88125
44;88;01;08;126;Darnieulles;1380;31;1411;88126
44;88;01;03;127;Deinvillers;59;2;61;88127
44;88;03;11;128;Denipaire;249;5;254;88128
44;88;01;03;129;Derbamont;114;3;117;88129
44;88;01;02;130;Destord;248;4;252;88130
44;88;01;02;131;Deycimont;307;14;321;88131
44;88;01;06;132;Deyvillers;1361;38;1399;88132
44;88;01;06;133;Dignonville;199;9;208;88133
44;88;01;05;134;Dinozé;624;14;638;88134
44;88;01;02;135;Docelles;864;17;881;88135
44;88;01;06;136;Dogneville;1484;27;1511;88136
44;88;02;09;137;Dolaincourt;100;0;100;88137
44;88;02;04;138;Dombasle-devant-Darney;79;2;81;88138
44;88;01;09;139;Dombasle-en-Xaintois;120;1;121;88139
44;88;02;17;140;Dombrot-le-Sec;368;14;382;88140
44;88;02;17;141;Dombrot-sur-Vair;239;3;242;88141
44;88;01;08;142;Domèvre-sur-Avière;406;8;414;88142
44;88;01;02;143;Domèvre-sur-Durbion;265;14;279;88143
44;88;02;17;144;Domèvre-sous-Montfort;56;0;56;88144
44;88;01;02;145;Domfaing;216;2;218;88145
44;88;02;17;146;Domjulien;175;2;177;88146
44;88;01;04;147;Dommartin-aux-Bois;382;5;387;88147
44;88;01;15;148;Dommartin-lès-Remiremont;1882;51;1933;88148
44;88;02;04;149;Dommartin-lès-Vallois;54;0;54;88149
44;88;02;09;150;Dommartin-sur-Vraine;294;6;300;88150
44;88;01;04;151;Dompaire;1108;28;1136;88151
44;88;01;02;152;Dompierre;249;14;263;88152
44;88;01;11;153;Domptail;346;8;354;88153
44;88;02;10;154;Domrémy-la-Pucelle;91;2;93;88154
44;88;01;09;155;Domvallier;101;8;109;88155
44;88;01;11;156;Doncières;132;2;134;88156
44;88;01;16;157;Dounoux;856;18;874;88157
44;88;01;12;158;Eloyes;3122;60;3182;88158
44;88;03;14;159;Entre-deux-Eaux;497;8;505;88159
44;88;01;98;160;Epinal;32256;1450;33706;88160
44;88;02;04;161;Escles;434;12;446;88161
44;88;02;04;162;Esley;193;5;198;88162
44;88;01;03;163;Essegney;745;9;754;88163
44;88;02;17;164;Estrennes;94;1;95;88164
44;88;03;11;165;Etival-Clairefontaine;2610;53;2663;88165
44;88;01;03;166;Evaux-et-Ménil;356;3;359;88166
44;88;01;01;167;Faucompierre;233;5;238;88167
44;88;01;03;168;Fauconcourt;136;2;138;88168
44;88;01;02;169;Fays;215;6;221;88169
44;88;01;15;170;Ferdrupt;725;17;742;88170
44;88;02;04;171;Fignévelle;47;1;48;88171
44;88;01;02;172;Fiménil;227;4;231;88172
44;88;01;03;173;Florémont;462;12;474;88173
44;88;01;08;174;Fomerey;151;4;155;88174
44;88;01;02;175;Fontenay;458;20;478;88175
44;88;01;16;176;Fontenoy-le-Château;508;35;543;88176
44;88;03;01;177;La Forge;520;11;531;88177
44;88;01;05;178;Les Forges;1833;69;1902;88178
44;88;02;04;179;Fouchécourt;44;3;47;88179
44;88;02;04;180;Frain;126;2;128;88180
44;88;03;07;181;Fraize;2841;46;2887;88181
44;88;03;14;182;Frapelle;195;9;204;88182
44;88;02;10;183;Frebécourt;335;7;342;88183
44;88;01;02;184;Fremifontaine;440;11;451;88184
44;88;01;09;185;Frenelle-la-Grande;109;4;113;88185
44;88;01;09;186;Frenelle-la-Petite;46;0;46;88186
44;88;02;04;187;Frénois;54;1;55;88187
44;88;01;15;188;Fresse-sur-Moselle;1726;48;1774;88188
44;88;02;10;189;Fréville;135;4;139;88189
44;88;01;08;190;Frizon;521;6;527;88190
44;88;01;04;192;Gelvécourt-et-Adompt;105;1;106;88192
44;88;03;14;193;Gemaingoutte;145;1;146;88193
44;88;02;17;194;Gemmelaincourt;140;12;152;88194
44;88;02;17;195;Gendreville;105;3;108;88195
44;88;03;07;196;Gérardmer;7807;624;8431;88196
44;88;03;01;197;Gerbamont;352;11;363;88197
44;88;03;07;198;Gerbépal;601;12;613;88198
44;88;02;04;199;Gignéville;78;3;81;88199
44;88;01;08;200;Gigney;53;1;54;88200
44;88;01;04;201;Girancourt;900;14;914;88201
44;88;01;03;202;Gircourt-lès-Viéville;191;3;194;88202
44;88;01;02;203;Girecourt-sur-Durbion;351;11;362;88203
44;88;01;16;205;Girmont-Val-d'Ajol;254;17;271;88205
44;88;02;09;206;Gironcourt-sur-Vraine;889;17;906;88206
44;88;02;04;208;Godoncourt;115;4;119;88208
44;88;01;08;209;Golbey;8798;123;8921;88209
44;88;01;04;210;Gorhey;173;6;179;88210
44;88;02;10;212;Grand;351;10;361;88212
44;88;03;14;213;La Grande-Fosse;135;0;135;88213
44;88;02;16;214;Grandrupt-de-Bains;76;4;80;88214
44;88;03;11;215;Grandrupt;77;2;79;88215
44;88;01;02;216;Grandvillers;744;11;755;88216
44;88;03;07;218;Granges-Aumontzey;2613;56;2669;88218
44;88;02;10;219;Greux;149;6;155;88219
44;88;02;04;220;Grignoncourt;46;1;47;88220
44;88;01;16;221;Gruey-lès-Surance;237;11;248;88221
44;88;01;02;222;Gugnécourt;253;19;272;88222
44;88;01;03;223;Gugney-aux-Aulx;164;7;171;88223
44;88;01;03;224;Hadigny-les-Verrières;388;12;400;88224
44;88;01;16;225;Hadol;2359;105;2464;88225
44;88;01;04;226;Hagécourt;126;3;129;88226
44;88;02;17;227;Hagnéville-et-Roncourt;86;1;87;88227
44;88;01;03;228;Haillainville;174;4;178;88228
44;88;02;10;229;Harchéchamp;73;4;77;88229
44;88;01;03;230;Hardancourt;40;0;40;88230
44;88;02;17;231;Haréville;477;18;495;88231
44;88;02;10;232;Harmonville;219;4;223;88232
44;88;01;04;233;Harol;628;52;680;88233
44;88;01;16;236;La Haye;125;0;125;88236
44;88;01;04;237;Hennecourt;370;7;377;88237
44;88;02;04;238;Hennezel;393;12;405;88238
44;88;01;03;239;Hergugney;135;3;138;88239
44;88;01;02;240;Herpelmont;279;2;281;88240
44;88;02;09;241;Houécourt;441;12;453;88241
44;88;02;10;242;Houéville;45;1;46;88242
44;88;01;13;243;Housseras;485;7;492;88243
44;88;03;07;244;La Houssière;547;18;565;88244
44;88;03;11;245;Hurbache;319;13;332;88245
44;88;01;09;246;Hymont;484;12;496;88246
44;88;01;08;247;Igney;1160;14;1174;88247
44;88;02;04;248;Isches;174;4;178;88248
44;88;02;10;249;Jainvillotte;76;3;79;88249
44;88;01;12;250;Jarménil;478;5;483;88250
44;88;01;13;251;Jeanménil;1119;35;1154;88251
44;88;02;04;252;Jésonville;132;7;139;88252
44;88;01;06;253;Jeuxey;683;16;699;88253
44;88;01;03;254;Jorxey;82;1;83;88254
44;88;02;10;255;Jubainville;91;3;94;88255
44;88;01;02;256;Jussarupt;270;5;275;88256
44;88;01;09;257;Juvaincourt;179;3;182;88257
44;88;02;04;258;Lamarche;858;16;874;88258
44;88;02;10;259;Landaville;298;9;307;88259
44;88;01;03;260;Langley;154;2;156;88260
44;88;01;02;261;Laval-sur-Vologne;626;11;637;88261
44;88;01;02;262;Laveline-devant-Bruyères;582;12;594;88262
44;88;01;02;263;Laveline-du-Houx;206;6;212;88263
44;88;01;04;264;Légéville-et-Bonfays;61;3;64;88264
44;88;02;10;265;Lemmecourt;30;0;30;88265
44;88;01;02;266;Lépanges-sur-Vologne;834;18;852;88266
44;88;02;04;267;Lerrain;451;16;467;88267
44;88;03;14;268;Lesseux;142;8;150;88268
44;88;03;07;269;Liézey;297;7;304;88269
44;88;02;10;270;Liffol-le-Grand;2124;61;2185;88270
44;88;02;17;271;Lignéville;307;7;314;88271
44;88;02;04;272;Lironcourt;71;0;71;88272
44;88;01;06;273;Longchamp;456;11;467;88273
44;88;02;09;274;Longchamp-sous-Châtenois;78;1;79;88274
44;88;03;14;275;Lubine;239;2;241;88275
44;88;03;14;276;Lusse;395;16;411;88276
44;88;03;11;277;Luvigny;115;3;118;88277
44;88;02;09;278;Maconcourt;72;1;73;88278
44;88;01;09;279;Madecourt;50;1;51;88279
44;88;01;03;280;Madegney;137;0;137;88280
44;88;01;04;281;Madonne-et-Lamerey;405;12;417;88281
44;88;02;17;283;Malaincourt;81;2;83;88283
44;88;03;14;284;Mandray;581;12;593;88284
44;88;02;17;285;Mandres-sur-Vair;440;129;569;88285
44;88;01;03;286;Marainville-sur-Madon;98;0;98;88286
44;88;02;04;287;Marey;63;1;64;88287
44;88;01;04;288;Maroncourt;7;0;7;88288
44;88;02;04;289;Martigny-les-Bains;816;66;882;88289
44;88;02;10;290;Martigny-les-Gerbonvaux;105;2;107;88290
44;88;02;04;291;Martinvelle;131;3;134;88291
44;88;01;09;292;Mattaincourt;806;25;831;88292
44;88;02;10;293;Maxey-sur-Meuse;216;4;220;88293
44;88;01;08;294;Mazeley;263;3;266;88294
44;88;01;09;295;Mazirot;228;7;235;88295
44;88;02;17;296;Médonville;74;0;74;88296
44;88;01;02;297;Méménil;157;5;162;88297
44;88;01;11;298;Ménarmont;67;0;67;88298
44;88;02;09;299;Ménil-en-Xaintois;147;1;148;88299
44;88;03;11;300;Ménil-de-Senones;131;6;137;88300
44;88;01;11;301;Ménil-sur-Belvitte;294;11;305;88301
44;88;01;15;302;Le Ménil;1026;22;1048;88302
44;88;02;10;303;Midrevaux;199;1;200;88303
44;88;01;09;304;Mirecourt;4949;487;5436;88304
44;88;02;10;305;Moncel-sur-Vair;196;5;201;88305
44;88;03;11;306;Le Mont;51;0;51;88306
44;88;02;04;307;Mont-lès-Lamarche;95;2;97;88307
44;88;02;10;308;Mont-lès-Neufchâteau;302;5;307;88308
44;88;02;17;309;Monthureux-le-Sec;159;9;168;88309
44;88;02;04;310;Monthureux-sur-Saône;909;18;927;88310
44;88;01;16;311;Montmotier;37;1;38;88311
44;88;02;09;312;Morelmaison;197;5;202;88312
44;88;01;03;313;Moriville;420;8;428;88313
44;88;02;04;314;Morizécourt;101;4;105;88314
44;88;03;02;315;Mortagne;171;2;173;88315
44;88;02;17;316;Morville;48;2;50;88316
44;88;03;11;317;Moussey;566;5;571;88317
44;88;01;03;318;Moyemont;227;5;232;88318
44;88;03;11;319;Moyenmoutier;3089;64;3153;88319
44;88;03;14;320;Nayemont-les-Fosses;780;39;819;88320
44;88;02;10;321;Neufchâteau;6636;284;6920;88321
44;88;01;02;322;La Neuveville-devant-Lépanges;506;12;518;88322
44;88;02;09;324;La Neuveville-sous-Châtenois;379;10;389;88324
44;88;02;17;325;La Neuveville-sous-Montfort;183;7;190;88325
44;88;03;14;326;Neuvillers-sur-Fave;349;10;359;88326
44;88;01;03;327;Nomexy;2005;22;2027;88327
44;88;03;11;328;Nompatelize;542;23;565;88328
44;88;02;04;330;Nonville;195;2;197;88330
44;88;01;02;331;Nonzeville;53;2;55;88331
44;88;02;17;332;Norroy;215;6;221;88332
44;88;01;11;333;Nossoncourt;123;1;124;88333
44;88;01;09;334;OÃ«lleville;312;5;317;88334
44;88;02;17;335;Offroicourt;154;3;157;88335
44;88;02;09;336;Ollainville;73;1;74;88336
44;88;01;03;338;Ortoncourt;84;0;84;88338
44;88;01;02;340;Padoux;499;11;510;88340
44;88;03;14;341;Pair-et-Grandrupt;508;10;518;88341
44;88;01;02;342;Pallegney;164;3;167;88342
44;88;02;17;343;Parey-sous-Montfort;159;4;163;88343
44;88;02;10;344;Pargny-sous-Mureau;182;5;187;88344
44;88;03;14;345;La Petite-Fosse;72;3;75;88345
44;88;03;11;346;La Petite-Raon;742;12;754;88346
44;88;01;04;347;Pierrefitte;118;1;119;88347
44;88;01;02;348;Pierrepont-sur-l'Arentèle;131;2;133;88348
44;88;03;07;349;Plainfaing;1641;26;1667;88349
44;88;02;09;350;Pleuvezain;78;3;81;88350
44;88;01;16;351;Plombières-les-Bains;1604;34;1638;88351
44;88;02;10;352;Pompierre;195;5;200;88352
44;88;02;04;353;Pont-lès-Bonfays;108;3;111;88353
44;88;01;03;354;Pont-sur-Madon;185;0;185;88354
44;88;01;03;355;Portieux;1239;21;1260;88355
44;88;03;02;356;Les Poulières;272;5;277;88356
44;88;01;09;357;Poussay;685;21;706;88357
44;88;01;12;358;Pouxeux;1980;35;2015;88358
44;88;01;02;359;Prey;91;2;93;88359
44;88;02;04;360;Provenchères-lès-Darney;153;5;158;88360
44;88;03;14;361;Provenchères-et-Colroy;1343;115;1458;88361
44;88;03;11;362;Le Puid;113;1;114;88362
44;88;02;10;363;Punerot;156;5;161;88363
44;88;01;09;364;Puzieux;146;3;149;88364
44;88;01;04;365;Racécourt;158;9;167;88365
44;88;02;09;366;Rainville;279;12;291;88366
44;88;01;13;367;Rambervillers;5096;135;5231;88367
44;88;01;09;368;Ramecourt;191;4;195;88368
44;88;01;15;369;Ramonchamp;1889;135;2024;88369
44;88;01;17;370;Rancourt;61;1;62;88370
44;88;01;12;371;Raon-aux-Bois;1228;18;1246;88371
44;88;03;11;372;Raon-l'Etape;6205;141;6346;88372
44;88;03;11;373;Raon-sur-Plaine;147;2;149;88373
44;88;01;03;374;Rapey;23;0;23;88374
44;88;03;14;375;Raves;471;7;478;88375
44;88;02;10;376;Rebeuville;278;7;285;88376
44;88;02;04;377;Regnévelle;122;2;124;88377
44;88;01;03;378;Regney;96;2;98;88378
44;88;01;03;379;Rehaincourt;356;6;362;88379
44;88;03;02;380;Rehaupal;209;2;211;88380
44;88;02;04;381;Relanges;199;11;210;88381
44;88;01;09;382;Remicourt;67;1;68;88382
44;88;01;12;383;Remiremont;7691;301;7992;88383
44;88;02;17;385;Remoncourt;573;10;583;88385
44;88;03;14;386;Remomeix;457;4;461;88386
44;88;02;09;387;Removille;217;4;221;88387
44;88;01;05;388;Renauvoid;121;3;124;88388
44;88;01;09;389;Repel;81;0;81;88389
44;88;02;04;390;Robécourt;106;8;114;88390
44;88;03;01;391;Rochesson;686;17;703;88391
44;88;02;10;393;Rollainville;315;9;324;88393
44;88;02;04;394;Romain-aux-Bois;51;0;51;88394
44;88;01;03;395;Romont;375;8;383;88395
44;88;03;02;398;Les Rouges-Eaux;85;4;89;88398
44;88;01;02;399;Le Roulier;202;4;206;88399
44;88;01;09;400;Rouvres-en-Xaintois;274;12;286;88400
44;88;02;10;401;Rouvres-la-Chétive;447;9;456;88401
44;88;01;11;402;Roville-aux-Chênes;370;139;509;88402
44;88;02;17;403;Rozerotte;190;2;192;88403
44;88;02;04;404;Rozières-sur-Mouzon;67;1;68;88404
44;88;01;03;406;Rugney;134;1;135;88406
44;88;02;10;407;Ruppes;141;3;144;88407
44;88;01;15;408;Rupt-sur-Moselle;3529;68;3597;88408
44;88;01;12;409;Saint-Amé;2146;38;2184;88409
44;88;01;11;410;Sainte-Barbe;272;4;276;88410
44;88;02;04;411;Saint-Baslemont;78;1;79;88411
44;88;01;11;412;Saint-Benoît-la-Chipotte;438;9;447;88412
44;88;03;99;413;Saint-Dié-des-Vosges;19576;484;20060;88413
44;88;01;12;415;Saint-Etienne-lès-Remiremont;3847;80;3927;88415
44;88;01;03;416;Saint-Genest;135;2;137;88416
44;88;01;13;417;Saint-Gorgon;386;9;395;88417
44;88;01;02;418;Sainte-Hélène;456;4;460;88418
44;88;03;11;419;Saint-Jean-d'Ormont;119;0;119;88419
44;88;02;04;421;Saint-Julien;109;2;111;88421
44;88;03;14;423;Saint-Léonard;1351;22;1373;88423
44;88;03;14;424;Sainte-Marguerite;2308;69;2377;88424
44;88;01;03;425;Saint-Maurice-sur-Mortagne;181;5;186;88425
44;88;01;15;426;Saint-Maurice-sur-Moselle;1367;36;1403;88426
44;88;02;09;427;Saint-Menge;129;1;130;88427
44;88;03;13;428;Saint-Michel-sur-Meurthe;1836;56;1892;88428
44;88;01;12;429;Saint-Nabord;3994;257;4251;88429
44;88;02;17;430;Saint-Ouen-lès-Parey;503;13;516;88430
44;88;02;09;431;Saint-Paul;165;3;168;88431
44;88;01;11;432;Saint-Pierremont;153;3;156;88432
44;88;01;09;433;Saint-Prancher;76;1;77;88433
44;88;02;17;434;Saint-Remimont;222;4;226;88434
44;88;03;11;435;Saint-Remy;518;12;530;88435
44;88;03;11;436;Saint-Stail;72;1;73;88436
44;88;01;03;437;Saint-Vallier;99;3;102;88437
44;88;03;13;438;La Salle;392;7;399;88438
44;88;01;05;439;Sanchey;943;36;979;88439
44;88;02;09;440;Sandaucourt;168;4;172;88440
44;88;02;04;441;Sans-Vallois;128;2;130;88441
44;88;03;01;442;Sapois;635;9;644;88442
44;88;02;10;443;Sartes;95;2;97;88443
44;88;03;11;444;Le Saulcy;326;11;337;88444
44;88;03;14;445;Saulcy-sur-Meurthe;2328;56;2384;88445
44;88;02;17;446;Saulxures-lès-Bulgnéville;250;2;252;88446
44;88;03;01;447;Saulxures-sur-Moselotte;2517;80;2597;88447
44;88;02;17;448;Sauville;178;7;185;88448
44;88;01;03;449;Savigny;187;0;187;88449
44;88;02;04;450;Senaide;183;1;184;88450
44;88;03;11;451;Senones;2423;35;2458;88451
44;88;02;04;452;Senonges;132;0;132;88452
44;88;02;10;453;Seraumont;34;0;34;88453
44;88;01;02;454;SercÅ“ur;231;10;241;88454
44;88;02;04;455;Serécourt;98;6;104;88455
44;88;02;04;456;Serocourt;84;3;87;88456
44;88;02;10;457;Sionne;144;1;145;88457
44;88;01;03;458;Socourt;277;3;280;88458
44;88;02;09;459;Soncourt;43;1;44;88459
44;88;02;10;460;Soulosse-sous-Saint-Elophe;655;13;668;88460
44;88;02;17;461;Suriauville;215;0;215;88461
44;88;03;01;462;Le Syndicat;1884;40;1924;88462
44;88;03;13;463;Taintrux;1529;42;1571;88463
44;88;03;01;464;Tendon;510;7;517;88464
44;88;01;08;465;Capavenir Vosges;8634;214;8848;88465
44;88;02;17;466;They-sous-Montfort;129;5;134;88466
44;88;03;01;467;Thiéfosse;577;15;592;88467
44;88;01;15;468;Le Thillot;3376;56;3432;88468
44;88;01;09;469;Thiraucourt;99;4;103;88469
44;88;03;01;470;Le Tholy;1555;43;1598;88470
44;88;02;04;471;Les Thons;102;1;103;88471
44;88;02;17;472;Thuillières;117;4;121;88472
44;88;02;04;473;Tignécourt;106;4;110;88473
44;88;02;10;474;Tilleux;64;0;64;88474
44;88;02;04;475;Tollaincourt;121;5;126;88475
44;88;01;09;476;Totainville;119;1;120;88476
44;88;02;10;477;Trampot;97;1;98;88477
44;88;02;10;478;Tranqueville-Graux;104;1;105;88478
44;88;01;16;479;Trémonzey;259;4;263;88479
44;88;01;03;480;Ubexy;167;0;167;88480
44;88;01;16;481;Uriménil;1340;22;1362;88481
44;88;02;17;482;Urville;56;2;58;88482
44;88;01;08;483;Uxegney;2296;67;2363;88483
44;88;01;16;484;Uzemain;1035;30;1065;88484
44;88;02;17;485;La Vacheresse-et-la-Rouillie;120;0;120;88485
44;88;03;01;486;Vagney;3911;108;4019;88486
44;88;01;16;487;Le Val-d'Ajol;3864;99;3963;88487
44;88;02;17;488;Valfroicourt;235;5;240;88488
44;88;01;09;489;Valleroy-aux-Saules;253;8;261;88489
44;88;02;17;490;Valleroy-le-Sec;178;4;182;88490
44;88;02;04;491;Les Vallois;119;5;124;88491
44;88;03;07;492;Le Valtin;73;2;75;88492
44;88;01;03;493;Varmonzey;24;1;25;88493
44;88;01;04;494;Vaubexy;121;2;123;88494
44;88;01;06;495;Vaudéville;177;6;183;88495
44;88;02;17;496;Vaudoncourt;161;3;164;88496
44;88;01;08;497;Vaxoncourt;443;8;451;88497
44;88;01;15;498;Vecoux;858;21;879;88498
44;88;01;04;499;Velotte-et-Tatignécourt;160;3;163;88499
44;88;03;01;500;Ventron;832;14;846;88500
44;88;03;11;501;Le Vermont;71;0;71;88501
44;88;01;02;502;Vervezelle;133;4;137;88502
44;88;03;11;503;Vexaincourt;148;3;151;88503
44;88;02;09;504;Vicherey;207;4;211;88504
44;88;03;07;505;Vienville;124;2;126;88505
44;88;03;11;506;Vieux-Moulin;314;6;320;88506
44;88;01;09;507;Villers;200;6;206;88507
44;88;01;04;508;Ville-sur-Illon;541;11;552;88508
44;88;01;02;509;Villoncourt;109;1;110;88509
44;88;02;04;510;Villotte;154;0;154;88510
44;88;02;10;511;Villouxel;86;2;88;88511
44;88;01;02;512;Viménil;254;3;257;88512
44;88;01;03;513;Vincey;2190;26;2216;88513
44;88;02;09;514;Viocourt;160;7;167;88514
44;88;02;16;515;Vioménil;151;2;153;88515
44;88;02;17;516;Vittel;4832;138;4970;88516
44;88;02;04;517;Viviers-le-Gras;202;3;205;88517
44;88;02;17;518;Viviers-lès-Offroicourt;37;0;37;88518
44;88;03;13;519;La Voivre;676;22;698;88519
44;88;01;16;520;Les Voivres;298;9;307;88520
44;88;01;03;521;Vomécourt;259;3;262;88521
44;88;01;03;522;Vomécourt-sur-Madon;71;3;74;88522
44;88;02;09;523;Vouxey;153;5;158;88523
44;88;02;17;524;Vrécourt;351;4;355;88524
44;88;01;09;525;Vroville;129;2;131;88525
44;88;03;14;526;Wisembach;419;10;429;88526
44;88;01;11;527;Xaffévillers;144;2;146;88527
44;88;01;02;528;Xamontarupt;156;3;159;88528
44;88;01;03;529;Xaronval;111;4;115;88529
44;88;01;16;530;Xertigny;2586;49;2635;88530
44;88;03;07;531;Xonrupt-Longemer;1515;50;1565;88531
44;88;01;02;532;Zincourt;77;4;81;88532
27;89;01;07;002;Aigremont;77;3;80;89002
27;89;01;08;003;Montholon;2856;60;2916;89003
27;89;02;19;004;Aisy-sur-Armançon;238;11;249;89004
27;89;02;19;005;Ancy-le-Franc;853;22;875;89005
27;89;02;19;006;Ancy-le-Libre;160;6;166;89006
27;89;01;21;007;Andryes;425;12;437;89007
27;89;02;07;008;Angely;157;7;164;89008
27;89;02;05;009;Annay-la-Côte;349;17;366;89009
27;89;02;07;010;Annay-sur-Serein;207;5;212;89010
27;89;02;05;011;Annéot;122;10;132;89011
27;89;02;07;012;Annoux;84;2;86;89012
27;89;01;02;013;Appoigny;3245;50;3295;89013
27;89;03;06;014;Arces-Dilo;607;8;615;89014
27;89;02;12;015;Arcy-sur-Cure;472;12;484;89015
27;89;02;19;016;Argentenay;78;3;81;89016
27;89;02;19;017;Argenteuil-sur-Armançon;220;2;222;89017
27;89;03;20;018;Armeau;769;6;775;89018
27;89;02;19;019;Arthonnay;151;1;152;89019
27;89;02;12;020;Asnières-sous-Bois;113;2;115;89020
27;89;02;12;021;Asquins;291;13;304;89021
27;89;02;05;022;Athie;132;3;135;89022
27;89;01;03;023;Augy;1008;23;1031;89023
27;89;01;98;024;Auxerre;34451;1103;35554;89024
27;89;02;05;025;Avallon;6462;220;6682;89025
27;89;03;06;027;Bagneaux;205;5;210;89027
27;89;02;19;028;Baon;61;5;66;89028
27;89;01;13;029;Bassou;877;20;897;89029
27;89;01;12;030;Bazarnes;413;9;422;89030
27;89;01;15;031;Beaumont;632;12;644;89031
27;89;02;05;032;Beauvilliers;67;3;70;89032
27;89;01;09;033;Beauvoir;394;11;405;89033
27;89;01;07;034;Beine;470;13;483;89034
27;89;01;06;035;Bellechaume;443;14;457;89035
27;89;03;10;036;La Belliole;246;6;252;89036
27;89;03;11;037;Béon;519;18;537;89037
27;89;02;19;038;Bernouil;112;0;112;89038
27;89;01;07;039;Béru;76;4;80;89039
27;89;01;12;040;Bessy-sur-Cure;188;3;191;89040
27;89;01;15;041;Beugnon;301;15;316;89041
27;89;02;07;042;Bierry-les-Belles-Fontaines;166;5;171;89042
27;89;02;07;043;Blacy;100;1;101;89043
27;89;02;12;044;Blannay;106;1;107;89044
27;89;01;03;045;Bleigny-le-Carreau;283;7;290;89045
27;89;01;09;046;Bléneau;1176;17;1193;89046
27;89;03;06;048;BÅ“urs-en-Othe;341;7;348;89048
27;89;02;12;049;Bois-d'Arcy;21;3;24;89049
27;89;01;13;050;Bonnard;859;10;869;89050
27;89;03;20;051;Les Bordes;542;12;554;89051
27;89;01;02;053;Branches;439;10;449;89053
27;89;03;10;054;Brannay;787;9;796;89054
27;89;01;06;055;Brienon-sur-Armançon;3192;71;3263;89055
27;89;03;13;056;Brion;628;14;642;89056
27;89;02;12;057;Brosses;303;4;307;89057
27;89;02;05;058;Bussières;122;2;124;89058
27;89;03;13;059;Bussy-en-Othe;716;11;727;89059
27;89;03;20;060;Bussy-le-Repos;457;11;468;89060
27;89;01;15;061;Butteaux;251;3;254;89061
27;89;01;07;062;Carisey;360;4;364;89062
27;89;03;11;063;La Celle-Saint-Cyr;805;19;824;89063
27;89;02;07;064;Censy;56;1;57;89064
27;89;03;06;065;Cérilly;39;1;40;89065
27;89;03;06;066;Cerisiers;972;24;996;89066
27;89;03;11;067;Cézy;1106;16;1122;89067
27;89;01;07;068;Chablis;2205;39;2244;89068
27;89;01;15;069;Chailley;531;11;542;89069
27;89;02;12;071;Chamoux;103;0;103;89071
27;89;01;09;072;Champcevrais;306;3;309;89072
27;89;01;09;073;Champignelles;920;40;960;89073
27;89;03;14;074;Champigny;2117;40;2157;89074
27;89;03;11;075;Champlay;723;11;734;89075
27;89;01;06;076;Champlost;787;11;798;89076
27;89;01;03;077;Champs-sur-Yonne;1571;92;1663;89077
27;89;03;08;079;Chamvres;659;23;682;89079
27;89;03;18;080;La Chapelle-sur-Oreuse;642;4;646;89080
27;89;01;07;081;La Chapelle-Vaupelteigne;89;0;89;89081
27;89;01;02;083;Charbuy;1854;47;1901;89083
27;89;01;21;084;Charentenay;281;5;286;89084
27;89;01;13;085;Charmoy;1130;23;1153;89085
27;89;01;08;086;Charny Orée de Puisaye;4815;71;4886;89086
27;89;02;19;087;Chassignelles;300;9;309;89087
27;89;01;08;088;Chassy;464;12;476;89088
27;89;02;05;089;Chastellux-sur-Cure;137;5;142;89089
27;89;02;12;091;Châtel-Censoir;597;15;612;89091
27;89;02;07;092;Châtel-Gérard;207;11;218;89092
27;89;03;14;093;Chaumont;645;11;656;89093
27;89;03;20;094;Chaumot;708;15;723;89094
27;89;01;07;095;Chemilly-sur-Serein;140;8;148;89095
27;89;01;15;096;Chemilly-sur-Yonne;906;26;932;89096
27;89;02;19;098;Cheney;225;6;231;89098
27;89;01;13;099;Cheny;2356;38;2394;89099
27;89;03;10;100;Chéroy;1676;16;1692;89100
27;89;01;15;101;Chéu;551;11;562;89101
27;89;01;04;102;Chevannes;2169;64;2233;89102
27;89;01;07;104;Chichée;303;13;316;89104
27;89;01;13;105;Chichery;484;17;501;89105
27;89;01;07;108;Chitry;345;9;354;89108
27;89;03;06;111;Les Clérimois;301;5;306;89111
27;89;02;19;112;Collan;163;8;171;89112
27;89;03;10;113;Collemiers;676;17;693;89113
27;89;03;18;115;Compigny;206;6;212;89115
27;89;03;10;116;Cornant;359;7;366;89116
27;89;01;21;117;Coulangeron;217;1;218;89117
27;89;01;21;118;Coulanges-la-Vineuse;806;19;825;89118
27;89;01;12;119;Coulanges-sur-Yonne;512;10;522;89119
27;89;03;06;120;Coulours;129;3;132;89120
27;89;03;06;122;Courgenay;569;8;577;89122
27;89;01;07;123;Courgis;260;8;268;89123
27;89;03;18;124;Courlon-sur-Yonne;1190;20;1210;89124
27;89;01;21;125;Courson-les-Carrières;939;20;959;89125
27;89;03;10;126;Courtoin;33;1;34;89126
27;89;03;14;127;Courtois-sur-Yonne;784;24;808;89127
27;89;02;12;128;Coutarnoux;137;4;141;89128
27;89;01;12;129;Crain;410;9;419;89129
27;89;01;12;130;Deux Rivières;1265;29;1294;89130
27;89;02;19;131;Cruzy-le-Châtel;234;4;238;89131
27;89;02;19;132;Cry;165;6;171;89132
27;89;03;11;133;Cudot;351;4;355;89133
27;89;02;05;134;Cussy-les-Forges;327;8;335;89134
27;89;03;18;136;Cuy;861;29;890;89136
27;89;02;19;137;Dannemoine;472;10;482;89137
27;89;01;09;139;Diges;1102;35;1137;89139
27;89;02;12;141;Dissangis;116;7;123;89141
27;89;03;20;142;Dixmont;918;26;944;89142
27;89;03;10;143;Dollot;316;3;319;89143
27;89;03;10;144;Domats;812;14;826;89144
27;89;02;12;145;Domecy-sur-Cure;379;12;391;89145
27;89;02;05;146;Domecy-sur-le-Vault;86;3;89;89146
27;89;01;09;147;Dracy;233;2;235;89147
27;89;01;21;148;Druyes-les-Belles-Fontaines;266;4;270;89148
27;89;02;19;149;Dyé;214;6;220;89149
27;89;01;09;150;Egleny;449;9;458;89150
27;89;03;10;151;Egriselles-le-Bocage;1346;21;1367;89151
27;89;01;13;152;Epineau-les-Voves;742;15;757;89152
27;89;02;19;153;Epineuil;554;17;571;89153
27;89;01;21;154;Escamps;886;24;910;89154
27;89;01;21;155;Escolives-Sainte-Camille;699;11;710;89155
27;89;01;06;156;Esnon;394;7;401;89156
27;89;01;21;158;Etais-la-Sauvin;626;15;641;89158
27;89;02;05;159;Etaule;390;10;400;89159
27;89;03;20;160;Etigny;761;25;786;89160
27;89;02;07;161;Etivey;195;5;200;89161
27;89;03;18;162;Evry;390;3;393;89162
27;89;01;08;163;La Ferté-Loupière;526;9;535;89163
27;89;01;12;164;Festigny;91;0;91;89164
27;89;03;06;165;Flacy;107;2;109;89165
27;89;01;08;167;Fleury-la-Vallée;1112;35;1147;89167
27;89;01;07;168;Fleys;175;3;178;89168
27;89;02;19;169;Flogny-la-Chapelle;974;21;995;89169
27;89;02;12;170;Foissy-lès-Vézelay;124;2;126;89170
27;89;03;06;171;Foissy-sur-Vanne;297;3;300;89171
27;89;03;06;172;Fontaine-la-Gaillarde;503;25;528;89172
27;89;01;09;173;Fontaines;469;5;474;89173
27;89;01;07;175;Fontenay-près-Chablis;149;6;155;89175
27;89;02;12;176;Fontenay-près-Vézelay;137;2;139;89176
27;89;01;12;177;Fontenay-sous-Fouronnes;72;0;72;89177
27;89;01;21;179;Fontenoy;300;8;308;89179
27;89;03;10;180;Fouchères;480;10;490;89180
27;89;03;06;181;Fournaudin;119;2;121;89181
27;89;01;21;182;Fouronnes;171;4;175;89182
27;89;02;07;183;Fresnes;68;0;68;89183
27;89;02;19;184;Fulvy;130;2;132;89184
27;89;01;15;186;Germigny;530;13;543;89186
27;89;02;19;187;Gigny;88;2;90;89187
27;89;02;05;188;Girolles;167;6;173;89188
27;89;03;18;189;Gisy-les-Nobles;575;19;594;89189
27;89;02;12;190;Givry;180;8;188;89190
27;89;02;19;191;Gland;46;2;48;89191
27;89;02;07;194;Grimault;116;6;122;89194
27;89;03;17;195;Gron;1251;73;1324;89195
27;89;01;08;196;Valravillon;1755;52;1807;89196
27;89;02;07;197;Guillon-Terre-Plaine;748;8;756;89197
27;89;01;02;198;Gurgy;1699;38;1737;89198
27;89;01;21;199;Gy-l'Evêque;454;10;464;89199
27;89;01;15;200;Hauterive;389;16;405;89200
27;89;01;15;201;Héry;1786;40;1826;89201
27;89;01;21;202;Irancy;260;7;267;89202
27;89;02;05;203;Island;186;6;192;89203
27;89;02;07;204;L'Isle-sur-Serein;661;14;675;89204
27;89;01;15;205;Jaulges;579;4;583;89205
27;89;03;11;206;Joigny;9557;322;9879;89206
27;89;02;07;207;Jouancy;25;0;25;89207
27;89;02;12;208;Joux-la-Ville;1153;18;1171;89208
27;89;03;10;209;Jouy;512;11;523;89209
27;89;02;19;210;Jully;131;7;138;89210
27;89;02;19;211;Junay;68;0;68;89211
27;89;01;21;212;Jussy;368;15;383;89212
27;89;03;06;214;Lailly;194;2;196;89214
27;89;01;21;215;Lain;186;4;190;89215
27;89;01;21;216;Lainsecq;319;10;329;89216
27;89;01;09;217;Lalande;137;2;139;89217
27;89;01;13;218;Laroche-Saint-Cydroine;1260;22;1282;89218
27;89;01;15;219;Lasson;144;0;144;89219
27;89;01;09;220;Lavau;459;8;467;89220
27;89;01;09;221;Leugny;327;5;332;89221
27;89;01;21;222;Levis;219;6;225;89222
27;89;02;19;223;Lézinnes;661;20;681;89223
27;89;01;07;224;Lichères-près-Aigremont;156;3;159;89224
27;89;02;12;225;Lichères-sur-Yonne;44;0;44;89225
27;89;01;07;226;Lignorelles;190;5;195;89226
27;89;01;07;227;Ligny-le-Châtel;1228;27;1255;89227
27;89;01;01;228;Lindry;1393;43;1436;89228
27;89;03;10;229;Lixy;472;12;484;89229
27;89;03;11;230;Looze;437;18;455;89230
27;89;02;05;232;Lucy-le-Bois;289;16;305;89232
27;89;01;12;233;Lucy-sur-Cure;200;5;205;89233
27;89;01;12;234;Lucy-sur-Yonne;120;2;122;89234
27;89;02;05;235;Magny;873;22;895;89235
27;89;03;17;236;Maillot;1178;31;1209;89236
27;89;01;12;237;Mailly-la-Ville;497;9;506;89237
27;89;01;12;238;Mailly-le-Château;545;6;551;89238
27;89;03;17;239;Malay-le-Grand;1547;45;1592;89239
27;89;03;06;240;Malay-le-Petit;327;9;336;89240
27;89;01;07;242;Maligny;805;19;824;89242
27;89;02;07;244;Marmeaux;86;4;90;89244
27;89;03;20;245;Marsangy;843;19;862;89245
27;89;02;07;246;Massangis;355;5;360;89246
27;89;02;19;247;Mélisey;237;2;239;89247
27;89;02;05;248;Menades;41;2;43;89248
27;89;01;06;249;Mercy;78;1;79;89249
27;89;01;07;250;Méré;201;3;204;89250
27;89;01;08;251;Merry-la-Vallée;371;9;380;89251
27;89;01;21;252;Merry-Sec;177;4;181;89252
27;89;02;12;253;Merry-sur-Yonne;192;1;193;89253
27;89;01;09;254;Mézilles;523;8;531;89254
27;89;03;18;255;Michery;1067;22;1089;89255
27;89;01;21;256;Migé;415;3;418;89256
27;89;01;13;257;Migennes;7258;112;7370;89257
27;89;02;07;259;Môlay;90;2;92;89259
27;89;03;06;261;Molinons;275;6;281;89261
27;89;02;19;262;Molosmes;171;8;179;89262
27;89;01;02;263;Monéteau;4125;79;4204;89263
27;89;03;10;264;Montacher-Villegardin;732;27;759;89264
27;89;01;07;265;Montigny-la-Resle;583;20;603;89265
27;89;02;12;266;Montillot;262;7;269;89266
27;89;02;07;267;Montréal;177;6;183;89267
27;89;01;15;268;Mont-Saint-Sulpice;793;16;809;89268
27;89;01;21;270;Mouffy;127;2;129;89270
27;89;02;07;271;Moulins-en-Tonnerrois;104;1;105;89271
27;89;01;09;272;Moulins-sur-Ouanne;293;2;295;89272
27;89;01;21;273;Moutiers-en-Puisaye;280;4;284;89273
27;89;03;10;274;Nailly;1336;36;1372;89274
27;89;01;15;276;Neuvy-Sautour;885;40;925;89276
27;89;01;07;277;Nitry;367;10;377;89277
27;89;03;06;278;Noé;552;5;557;89278
27;89;02;07;279;Noyers;589;18;607;89279
27;89;02;19;280;Nuits;393;9;402;89280
27;89;01;08;281;Les Ormes;362;2;364;89281
27;89;01;15;282;Ormoy;678;12;690;89282
27;89;01;21;283;Ouanne;599;16;615;89283
27;89;02;19;284;Pacy-sur-Armançon;183;4;187;89284
27;89;03;18;285;Pailly;314;3;317;89285
27;89;01;09;286;Parly;830;15;845;89286
27;89;03;17;287;Paron;4828;118;4946;89287
27;89;01;06;288;Paroy-en-Othe;179;3;182;89288
27;89;03;08;289;Paroy-sur-Tholon;283;12;295;89289
27;89;02;07;290;Pasilly;44;1;45;89290
27;89;03;20;291;Passy;340;10;350;89291
27;89;01;15;292;Percey;250;5;255;89292
27;89;01;02;295;Perrigny;1258;32;1290;89295
27;89;02;19;296;Perrigny-sur-Armançon;130;1;131;89296
27;89;02;12;297;Pierre-Perthuis;112;1;113;89297
27;89;03;20;298;Piffonds;612;9;621;89298
27;89;02;19;299;Pimelles;63;2;65;89299
27;89;02;07;300;Pisy;80;1;81;89300
27;89;03;18;302;Plessis-Saint-Jean;205;5;210;89302
27;89;01;07;303;Poilly-sur-Serein;251;6;257;89303
27;89;01;08;304;Poilly-sur-Tholon;677;17;694;89304
27;89;02;05;306;Pontaubert;366;11;377;89306
27;89;01;07;307;Pontigny;749;9;758;89307
27;89;03;06;308;Pont-sur-Vanne;188;7;195;89308
27;89;03;14;309;Pont-sur-Yonne;3316;60;3376;89309
27;89;03;06;310;La Postolle;140;3;143;89310
27;89;01;09;311;Pourrain;1392;34;1426;89311
27;89;02;12;312;Précy-le-Sec;248;5;253;89312
27;89;03;11;313;Précy-sur-Vrin;425;16;441;89313
27;89;01;12;314;Prégilbert;181;1;182;89314
27;89;01;07;315;Préhy;153;1;154;89315
27;89;02;05;316;Provency;254;8;262;89316
27;89;02;05;318;Quarré-les-Tombes;633;20;653;89318
27;89;01;03;319;Quenne;483;14;497;89319
27;89;02;19;320;Quincerot;63;2;65;89320
27;89;02;19;321;Ravières;718;17;735;89321
27;89;02;19;323;Roffey;141;4;145;89323
27;89;01;09;324;Rogny-les-Sept-Ecluses;657;17;674;89324
27;89;01;09;325;Ronchères;91;1;92;89325
27;89;03;17;326;Rosoy;1090;32;1122;89326
27;89;03;20;327;Rousson;395;10;405;89327
27;89;01;07;328;Rouvray;371;9;380;89328
27;89;02;19;329;Rugny;75;1;76;89329
27;89;01;21;331;Sainpuits;312;12;324;89331
27;89;03;10;332;Saint-Agnan;953;27;980;89332
27;89;02;07;333;Saint-André-en-Terre-Plaine;152;4;156;89333
27;89;01;08;334;Le Val d'Ocre;557;7;564;89334
27;89;03;11;335;Saint-Aubin-sur-Yonne;418;13;431;89335
27;89;02;05;336;Saint-Brancher;283;7;290;89336
27;89;01;03;337;Saint-Bris-le-Vineux;1021;26;1047;89337
27;89;03;16;338;Saint-Clément;2740;77;2817;89338
27;89;02;12;339;Sainte-Colombe;190;7;197;89339
27;89;01;07;341;Saint-Cyr-les-Colons;448;5;453;89341
27;89;03;18;342;Saint-Denis-lès-Sens;650;18;668;89342
27;89;01;09;344;Saint-Fargeau;1495;15;1510;89344
27;89;01;15;345;Saint-Florentin;4240;62;4302;89345
27;89;01;01;346;Saint-Georges-sur-Baulche;3225;143;3368;89346
27;89;02;05;347;Saint-Germain-des-Champs;349;10;359;89347
27;89;03;11;348;Saint-Julien-du-Sault;2236;48;2284;89348
27;89;02;05;349;Saint-Léger-Vauban;354;6;360;89349
27;89;03;11;350;Saint-Loup-d'Ordon;261;4;265;89350
27;89;02;05;351;Sainte-Magnance;482;8;490;89351
27;89;01;09;352;Saint-Martin-des-Champs;268;7;275;89352
27;89;03;11;353;Saint-Martin-d'Ordon;418;4;422;89353
27;89;03;16;354;Saint-Martin-du-Tertre;1525;42;1567;89354
27;89;02;19;355;Saint-Martin-sur-Armançon;145;6;151;89355
27;89;03;06;359;Saint-Maurice-aux-Riches-Hommes;417;5;422;89359
27;89;01;08;360;Saint-Maurice-le-Vieil;372;6;378;89360
27;89;01;08;361;Saint-Maurice-Thizouaille;255;2;257;89361
27;89;02;12;362;Saint-Moré;178;5;183;89362
27;89;01;12;363;Sainte-Pallaye;107;2;109;89363
27;89;02;12;364;Saint-Père;295;5;300;89364
27;89;01;09;365;Saint-Privé;526;15;541;89365
27;89;01;21;367;Saints-en-Puisaye;548;11;559;89367
27;89;01;21;368;Saint-Sauveur-en-Puisaye;892;20;912;89368
27;89;03;14;369;Saint-Sérotin;572;12;584;89369
27;89;03;10;370;Saint-Valérien;1727;21;1748;89370
27;89;02;07;371;Sainte-Vertu;84;0;84;89371
27;89;03;06;373;Saligny;675;10;685;89373
27;89;02;19;374;Sambourg;73;3;76;89374
27;89;02;07;375;Santigny;84;3;87;89375
27;89;02;07;376;Sarry;144;7;151;89376
27;89;02;07;377;Sauvigny-le-Beuréal;70;0;70;89377
27;89;02;05;378;Sauvigny-le-Bois;722;15;737;89378
27;89;02;07;379;Savigny-en-Terre-Plaine;151;3;154;89379
27;89;03;10;380;Savigny-sur-Clairis;454;7;461;89380
27;89;01;15;382;Seignelay;1476;37;1513;89382
27;89;01;21;383;Sementron;104;2;106;89383
27;89;01;08;384;Senan;683;24;707;89384
27;89;02;19;385;Sennevoy-le-Bas;77;3;80;89385
27;89;02;19;386;Sennevoy-le-Haut;115;1;116;89386
27;89;03;99;387;Sens;26688;515;27203;89387
27;89;03;08;388;Sépeaux-Saint Romain;519;14;533;89388
27;89;03;18;390;Serbonnes;663;10;673;89390
27;89;03;18;391;Sergines;1269;26;1295;89391
27;89;02;05;392;Sermizelles;248;3;251;89392
27;89;02;19;393;Serrigny;110;2;112;89393
27;89;01;12;394;Sery;80;1;81;89394
27;89;03;06;395;Les Sièges;409;8;417;89395
27;89;01;08;397;Sommecaise;364;5;369;89397
27;89;01;15;398;Sormery;360;4;364;89398
27;89;03;18;399;Soucy;1592;45;1637;89399
27;89;01;21;400;Sougères-en-Puisaye;316;5;321;89400
27;89;01;15;402;Soumaintrain;221;4;225;89402
27;89;02;19;403;Stigny;88;8;96;89403
27;89;03;10;404;Subligny;523;9;532;89404
27;89;01;21;405;Les Hauts de Forterre;499;6;505;89405
27;89;02;07;406;Talcy;72;2;74;89406
27;89;02;19;407;Tanlay;935;31;966;89407
27;89;01;09;408;Tannerre-en-Puisaye;277;7;284;89408
27;89;02;12;409;Tharoiseau;61;1;62;89409
27;89;02;05;410;Tharot;100;1;101;89410
27;89;03;06;411;Les Vallées de la Vanne;1038;18;1056;89411
27;89;02;07;412;Thizy;185;8;193;89412
27;89;02;19;413;Thorey;36;1;37;89413
27;89;03;18;414;Thorigny-sur-Oreuse;1417;30;1447;89414
27;89;02;05;415;Thory;200;3;203;89415
27;89;01;21;416;Thury;439;7;446;89416
27;89;02;19;417;Tissey;109;2;111;89417
27;89;02;19;418;Tonnerre;4381;165;4546;89418
27;89;01;09;419;Toucy;2615;141;2756;89419
27;89;01;21;420;Treigny-Perreuse-Sainte-Colombe;969;20;989;89420
27;89;02;19;422;Trichey;41;2;43;89422
27;89;02;19;423;Tronchoy;127;3;130;89423
27;89;01;12;424;Trucy-sur-Yonne;134;6;140;89424
27;89;01;15;425;Turny;674;20;694;89425
27;89;01;21;426;Val-de-Mercy;387;12;399;89426
27;89;01;04;427;Vallan;681;19;700;89427
27;89;03;10;428;Vallery;564;6;570;89428
27;89;01;07;430;Varennes;322;9;331;89430
27;89;02;07;431;Vassy-sous-Pisy;71;1;72;89431
27;89;03;06;432;Vaudeurs;461;8;469;89432
27;89;02;05;433;Vault-de-Lugny;274;5;279;89433
27;89;03;06;434;Vaumort;349;8;357;89434
27;89;01;06;436;Venizy;877;15;892;89436
27;89;01;07;437;Venouse;301;7;308;89437
27;89;01;03;438;Venoy;1759;200;1959;89438
27;89;01;15;439;Vergigny;1528;24;1552;89439
27;89;03;11;440;Verlin;413;5;418;89440
27;89;01;12;441;Vermenton;1255;25;1280;89441
27;89;03;10;442;Vernoy;241;7;248;89442
27;89;03;20;443;Véron;1887;62;1949;89443
27;89;02;19;445;Vézannes;52;2;54;89445
27;89;02;12;446;Vézelay;418;4;422;89446
27;89;02;19;447;Vézinnes;156;5;161;89447
27;89;03;14;449;Villeblevin;1815;35;1850;89449
27;89;03;10;450;Villebougis;627;22;649;89450
27;89;03;06;451;Villechétive;250;4;254;89451
27;89;03;11;452;Villecien;380;13;393;89452
27;89;01;01;453;Villefargeau;1126;30;1156;89453
27;89;03;14;456;Villemanoche;668;8;676;89456
27;89;03;14;458;Villenavotte;166;9;175;89458
27;89;03;10;459;Villeneuve-la-Dondagre;318;0;318;89459
27;89;03;14;460;Villeneuve-la-Guyard;3515;46;3561;89460
27;89;03;06;461;Villeneuve-l'Archevêque;1112;19;1131;89461
27;89;01;09;462;Villeneuve-les-Genêts;296;3;299;89462
27;89;01;07;463;Villeneuve-Saint-Salves;254;4;258;89463
27;89;03;20;464;Villeneuve-sur-Yonne;5165;85;5250;89464
27;89;03;14;465;Villeperrot;321;1;322;89465
27;89;03;10;466;Villeroy;388;9;397;89466
27;89;03;10;467;Villethierry;819;14;833;89467
27;89;03;11;468;Villevallier;419;59;478;89468
27;89;03;18;469;Perceneige;949;21;970;89469
27;89;02;19;470;Villiers-les-Hauts;121;7;128;89470
27;89;03;06;471;Villiers-Louis;467;15;482;89471
27;89;01;09;472;Villiers-Saint-Benoît;448;9;457;89472
27;89;01;15;474;Villiers-Vineux;275;6;281;89474
27;89;02;19;475;Villon;109;2;111;89475
27;89;01;07;477;Villy;112;2;114;89477
27;89;01;21;478;Vincelles;914;15;929;89478
27;89;01;21;479;Vincelottes;292;6;298;89479
27;89;03;18;480;Vinneuf;1594;24;1618;89480
27;89;02;19;481;Vireaux;107;6;113;89481
27;89;02;19;482;Viviers;111;1;112;89482
27;89;03;18;483;Voisines;509;18;527;89483
27;89;02;12;485;Voutenay-sur-Cure;204;6;210;89485
27;89;02;19;486;Yrouerre;154;3;157;89486
27;90;01;05;001;Andelnans;1171;21;1192;90001
27;90;01;08;002;Angeot;356;8;364;90002
27;90;01;07;003;Anjoutey;589;22;611;90003
27;90;01;05;004;Argiésans;512;15;527;90004
27;90;01;07;005;Auxelles-Bas;453;13;466;90005
27;90;01;07;006;Auxelles-Haut;286;7;293;90006
27;90;01;05;007;Banvillars;288;12;300;90007
27;90;01;01;008;Bavilliers;4659;108;4767;90008
27;90;01;06;009;Beaucourt;5010;64;5074;90009
27;90;01;99;010;Belfort;46443;799;47242;90010
27;90;01;05;011;Bermont;378;9;387;90011
27;90;01;08;012;Bessoncourt;1283;46;1329;90012
27;90;01;08;013;Bethonvilliers;239;11;250;90013
27;90;01;08;014;Boron;488;8;496;90014
27;90;01;05;015;Botans;238;9;247;90015
27;90;01;07;016;Bourg-sous-Châtelet;123;2;125;90016
27;90;01;05;017;Bourogne;1903;26;1929;90017
27;90;01;08;018;Brebotte;396;7;403;90018
27;90;01;08;019;Bretagne;270;6;276;90019
27;90;01;05;020;Buc;275;9;284;90020
27;90;01;05;021;Charmois;363;4;367;90021
27;90;01;05;022;Châtenois-les-Forges;2667;51;2718;90022
27;90;01;07;023;Chaux;1164;32;1196;90023
27;90;01;08;024;Chavanatte;141;3;144;90024
27;90;01;08;025;Chavannes-les-Grands;344;4;348;90025
27;90;01;05;026;Chèvremont;1570;38;1608;90026
27;90;01;06;027;Courcelles;116;0;116;90027
27;90;01;06;028;Courtelevant;388;7;395;90028
27;90;01;01;029;Cravanche;1951;53;2004;90029
27;90;01;06;030;Croix;168;3;171;90030
27;90;01;08;031;Cunelières;344;9;353;90031
27;90;01;01;032;Danjoutin;3620;68;3688;90032
27;90;01;06;033;Delle;5667;86;5753;90033
27;90;01;09;034;Denney;757;26;783;90034
27;90;01;05;035;Dorans;797;10;807;90035
27;90;01;08;036;Eguenigue;270;9;279;90036
27;90;01;09;037;Eloie;941;26;967;90037
27;90;01;01;039;Essert;3321;103;3424;90039
27;90;01;07;041;Etueffont;1430;51;1481;90041
27;90;01;09;042;Evette-Salbert;2032;69;2101;90042
27;90;01;06;043;Faverois;582;2;584;90043
27;90;01;07;044;Felon;239;5;244;90044
27;90;01;06;045;Fêche-l'Eglise;762;13;775;90045
27;90;01;06;046;Florimont;447;6;453;90046
27;90;01;08;047;Fontaine;596;15;611;90047
27;90;01;08;048;Fontenelle;122;3;125;90048
27;90;01;08;049;Foussemagne;919;18;937;90049
27;90;01;08;050;Frais;240;7;247;90050
27;90;01;08;051;Froidefontaine;467;8;475;90051
27;90;01;07;052;Giromagny;2929;80;3009;90052
27;90;01;08;053;Grandvillars;3003;61;3064;90053
27;90;01;07;054;Grosmagny;521;10;531;90054
27;90;01;08;055;Grosne;336;2;338;90055
27;90;01;06;056;Joncherey;1410;29;1439;90056
27;90;01;07;057;Lachapelle-sous-Chaux;746;26;772;90057
27;90;01;07;058;Lachapelle-sous-Rougemont;580;6;586;90058
27;90;01;08;059;Lacollonge;227;10;237;90059
27;90;01;08;060;Lagrange;139;3;142;90060
27;90;01;07;061;Lamadeleine-Val-des-Anges;43;2;45;90061
27;90;01;08;062;Larivière;284;10;294;90062
27;90;01;06;063;Lebetain;415;9;424;90063
27;90;01;06;064;Lepuix-Neuf;303;4;307;90064
27;90;01;07;065;Lepuix;1156;21;1177;90065
27;90;01;07;066;Leval;242;1;243;90066
27;90;01;08;067;Menoncourt;397;18;415;90067
27;90;01;05;068;Meroux-Moval;1368;31;1399;90068
27;90;01;08;069;Méziré;1308;24;1332;90069
27;90;01;06;070;Montbouton;404;9;413;90070
27;90;01;08;071;Montreux-Château;1175;21;1196;90071
27;90;01;08;072;Morvillars;1076;22;1098;90072
27;90;01;08;074;Novillard;302;4;306;90074
27;90;01;09;075;Offemont;4219;99;4318;90075
27;90;01;01;076;Pérouse;1176;41;1217;90076
27;90;01;08;077;Petit-Croix;299;7;306;90077
27;90;01;07;078;Petitefontaine;189;5;194;90078
27;90;01;07;079;Petitmagny;314;6;320;90079
27;90;01;08;080;Phaffans;439;13;452;90080
27;90;01;06;081;Réchésy;776;13;789;90081
27;90;01;08;082;Autrechêne;277;9;286;90082
27;90;01;08;083;Recouvrance;124;0;124;90083
27;90;01;08;084;Reppe;343;10;353;90084
27;90;01;07;085;Riervescemont;95;2;97;90085
27;90;01;07;086;Romagny-sous-Rougemont;221;6;227;90086
27;90;01;09;087;Roppe;1040;31;1071;90087
27;90;01;07;088;Rougegoutte;966;25;991;90088
27;90;01;07;089;Rougemont-le-Château;1497;65;1562;90089
27;90;01;06;090;Saint-Dizier-l'Evêque;435;12;447;90090
27;90;01;07;091;Saint-Germain-le-Châtelet;643;23;666;90091
27;90;01;09;093;Sermamagny;916;20;936;90093
27;90;01;05;094;Sevenans;702;24;726;90094
27;90;01;08;095;Suarce;434;3;437;90095
27;90;01;06;096;Thiancourt;282;8;290;90096
27;90;01;05;097;Trévenans;1283;32;1315;90097
27;90;01;05;098;Urcerey;242;11;253;90098
27;90;01;09;099;Valdoie;5269;239;5508;90099
27;90;01;08;100;Vauthiermont;201;12;213;90100
27;90;01;08;101;Vellescot;243;6;249;90101
27;90;01;07;102;Vescemont;719;23;742;90102
27;90;01;09;103;Vétrigne;660;22;682;90103
27;90;01;05;104;Vézelois;986;23;1009;90104
27;90;01;06;105;Villars-le-Sec;179;5;184;90105
11;91;01;08;001;Abbéville-la-Rivière;324;8;332;91001
11;91;01;08;016;Angerville;4353;70;4423;91016
11;91;03;05;017;Angervilliers;1723;26;1749;91017
11;91;03;01;021;Arpajon;11355;92;11447;91021
11;91;01;08;022;Arrancourt;135;5;140;91022
11;91;03;02;027;Athis-Mons;35670;331;36001;91027
11;91;01;08;035;Authon-la-Plaine;374;6;380;91035
11;91;02;13;037;Auvernaux;324;1;325;91037
11;91;01;08;038;Auvers-Saint-Georges;1273;22;1295;91038
11;91;03;01;041;Avrainville;995;7;1002;91041
11;91;03;11;044;Ballainvilliers;4600;42;4642;91044
11;91;02;13;045;Ballancourt-sur-Essonne;7593;100;7693;91045
11;91;01;13;047;Baulne;1311;13;1324;91047
11;91;03;10;064;Bièvres;4823;112;4935;91064
11;91;01;08;067;Blandy;117;4;121;91067
11;91;02;13;069;Boigneville;387;10;397;91069
11;91;01;08;075;Bois-Herpin;80;1;81;91075
11;91;01;08;079;Boissy-la-Rivière;510;7;517;91079
11;91;01;08;080;Boissy-le-Cutté;1341;14;1355;91080
11;91;01;08;081;Boissy-le-Sec;689;17;706;91081
11;91;01;01;085;Boissy-sous-Saint-Yon;3828;47;3875;91085
11;91;02;15;086;Bondoufle;10046;98;10144;91086
11;91;03;10;093;Boullay-les-Troux;648;21;669;91093
11;91;01;01;095;Bouray-sur-Juine;2113;26;2139;91095
11;91;02;07;097;Boussy-Saint-Antoine;7983;75;8058;91097
11;91;01;08;098;Boutervilliers;426;5;431;91098
11;91;01;13;099;Boutigny-sur-Essonne;2963;41;3004;91099
11;91;01;08;100;Bouville;646;16;662;91100
11;91;03;03;103;Brétigny-sur-Orge;27412;321;27733;91103
11;91;03;05;105;Breuillet;8566;120;8686;91105
11;91;01;05;106;Breux-Jouy;1290;12;1302;91106
11;91;01;08;109;Brières-les-Scellés;1260;9;1269;91109
11;91;03;05;111;Briis-sous-Forges;3342;39;3381;91111
11;91;01;08;112;Brouy;128;4;132;91112
11;91;02;98;114;Brunoy;25330;427;25757;91114
11;91;03;01;115;Bruyères-le-Châtel;3497;43;3540;91115
11;91;02;13;121;Buno-Bonnevaux;434;7;441;91121
11;91;03;10;122;Bures-sur-Yvette;9408;220;9628;91122
11;91;01;08;129;Cerny;3337;165;3502;91129
11;91;01;08;130;Chalo-Saint-Mars;1026;28;1054;91130
11;91;01;08;131;Chalou-Moulineux;404;8;412;91131
11;91;01;05;132;Chamarande;1133;12;1145;91132
11;91;02;13;135;Champcueil;2867;56;2923;91135
11;91;03;11;136;Champlan;2778;18;2796;91136
11;91;01;08;137;Champmotteux;370;6;376;91137
11;91;01;08;145;Chatignonville;69;0;69;91145
11;91;01;05;148;Chauffour-lès-Etréchy;137;0;137;91148
11;91;03;01;156;Cheptainville;2226;30;2256;91156
11;91;02;13;159;Chevannes;1590;28;1618;91159
11;91;03;12;161;Chilly-Mazarin;19822;128;19950;91161
11;91;02;04;174;Corbeil-Essonnes;51234;294;51528;91174
11;91;01;05;175;Corbreuse;1718;31;1749;91175
11;91;02;13;179;Le Coudray-Montceaux;4844;45;4889;91179
11;91;02;13;180;Courances;337;10;347;91180
11;91;02;13;184;Courdimanche-sur-Essonne;276;7;283;91184
11;91;03;05;186;Courson-Monteloup;577;8;585;91186
11;91;02;19;191;Crosne;9369;58;9427;91191
11;91;02;13;195;Dannemois;822;6;828;91195
11;91;01;08;198;D'Huison-Longueville;1495;24;1519;91198
11;91;01;05;200;Dourdan;10452;187;10639;91200
11;91;02;06;201;Draveil;28602;265;28867;91201
11;91;02;04;204;Echarcon;791;17;808;91204
11;91;03;01;207;Egly;6322;53;6375;91207
11;91;02;07;215;Epinay-sous-Sénart;12266;83;12349;91215
11;91;03;11;216;Epinay-sur-Orge;11184;145;11329;91216
11;91;01;08;223;Etampes;25629;184;25813;91223
11;91;02;06;225;Etiolles;3144;150;3294;91225
11;91;01;05;226;Etréchy;6729;92;6821;91226
11;91;02;09;228;Evry-Courcouronnes;66851;466;67317;91228
11;91;01;13;232;La Ferté-Alais;3659;55;3714;91232
11;91;02;15;235;Fleury-Mérogis;13641;18;13659;91235
11;91;01;08;240;Fontaine-la-Rivière;182;4;186;91240
11;91;03;05;243;Fontenay-lès-Briis;2232;32;2264;91243
11;91;02;13;244;Fontenay-le-Vicomte;1591;26;1617;91244
11;91;01;05;247;La Forêt-le-Roi;519;7;526;91247
11;91;01;08;248;La Forêt-Sainte-Croix;161;1;162;91248
11;91;03;05;249;Forges-les-Bains;3923;75;3998;91249
11;91;03;10;272;Gif-sur-Yvette;21007;595;21602;91272
11;91;02;13;273;Gironville-sur-Essonne;766;18;784;91273
11;91;03;10;274;Gometz-la-Ville;1502;24;1526;91274
11;91;03;18;275;Gometz-le-Châtel;2664;50;2714;91275
11;91;01;05;284;Les Granges-le-Roi;1177;23;1200;91284
11;91;02;20;286;Grigny;28201;98;28299;91286
11;91;03;01;292;Guibeville;842;15;857;91292
11;91;01;13;293;Guigneville-sur-Essonne;903;17;920;91293
11;91;01;08;294;Guillerval;814;11;825;91294
11;91;03;14;312;Igny;9917;303;10220;91312
11;91;01;13;315;Itteville;6522;61;6583;91315
11;91;01;01;318;Janville-sur-Juine;1970;49;2019;91318
11;91;03;05;319;Janvry;635;10;645;91319
11;91;03;02;326;Juvisy-sur-Orge;17454;127;17581;91326
11;91;01;01;330;Lardy;5483;102;5585;91330
11;91;03;03;332;Leudeville;1477;24;1501;91332
11;91;03;01;333;Leuville-sur-Orge;4378;43;4421;91333
11;91;03;05;338;Limours;6492;121;6613;91338
11;91;03;11;339;Linas;6842;51;6893;91339
11;91;02;04;340;Lisses;7333;63;7396;91340
11;91;03;11;345;Longjumeau;21269;143;21412;91345
11;91;03;03;347;Longpont-sur-Orge;6375;53;6428;91347
11;91;02;13;359;Maisse;2780;40;2820;91359
11;91;03;18;363;Marcoussis;8138;157;8295;91363
11;91;01;08;374;Marolles-en-Beauce;237;3;240;91374
11;91;03;03;376;Marolles-en-Hurepoix;5610;54;5664;91376
11;91;03;12;377;Massy;50644;352;50996;91377
11;91;01;05;378;Mauchamps;289;3;292;91378
11;91;02;13;386;Mennecy;15292;291;15583;91386
11;91;01;08;390;Le Mérévillois;3305;43;3348;91390
11;91;01;08;393;Mérobert;625;8;633;91393
11;91;01;08;399;Mespuits;227;5;232;91399
11;91;02;13;405;Milly-la-Forêt;4635;92;4727;91405
11;91;02;13;408;Moigny-sur-Ecole;1252;30;1282;91408
11;91;03;10;411;Les Molières;1874;49;1923;91411
11;91;01;13;412;Mondeville;738;15;753;91412
11;91;01;08;414;Monnerville;382;5;387;91414
11;91;02;99;421;Montgeron;23760;293;24053;91421
11;91;03;11;425;Montlhéry;7681;223;7904;91425
11;91;03;17;432;Morangis;13424;78;13502;91432
11;91;01;08;433;Morigny-Champigny;4346;106;4452;91433
11;91;02;16;434;Morsang-sur-Orge;20124;165;20289;91434
11;91;02;07;435;Morsang-sur-Seine;550;27;577;91435
11;91;02;13;441;Nainville-les-Roches;503;11;514;91441
11;91;03;01;457;La Norville;4331;46;4377;91457
11;91;03;18;458;Nozay;4511;73;4584;91458
11;91;03;01;461;Ollainville;4759;58;4817;91461
11;91;02;13;463;Oncy-sur-Ecole;1044;21;1065;91463
11;91;02;13;468;Ormoy;2158;21;2179;91468
11;91;01;08;469;Ormoy-la-Rivière;911;49;960;91469
11;91;03;14;471;Orsay;15503;329;15832;91471
11;91;01;08;473;Orveau;168;2;170;91473
11;91;03;14;477;Palaiseau;35236;332;35568;91477
11;91;03;02;479;Paray-Vieille-Poste;7814;58;7872;91479
11;91;03;10;482;Pecqueuse;548;11;559;91482
11;91;03;15;494;Le Plessis-Pâté;4140;58;4198;91494
11;91;01;08;495;Plessis-Saint-Benoist;337;3;340;91495
11;91;02;13;507;Prunay-sur-Essonne;289;5;294;91507
11;91;01;08;508;Puiselet-le-Marais;258;4;262;91508
11;91;01;08;511;Pussay;2106;29;2135;91511
11;91;02;07;514;Quincy-sous-Sénart;9426;47;9473;91514
11;91;01;05;519;Richarville;393;11;404;91519
11;91;02;15;521;Ris-Orangis;29745;182;29927;91521
11;91;01;05;525;Roinville;1340;25;1365;91525
11;91;01;08;526;Roinvilliers;107;1;108;91526
11;91;01;08;533;Saclas;1859;24;1883;91533
11;91;03;10;534;Saclay;4256;57;4313;91534
11;91;03;10;538;Saint-Aubin;696;20;716;91538
11;91;01;05;540;Saint-Chéron;5238;79;5317;91540
11;91;01;08;544;Saint-Cyr-la-Rivière;524;9;533;91544
11;91;01;05;546;Saint-Cyr-sous-Dourdan;937;22;959;91546
11;91;01;08;547;Saint-Escobille;506;17;523;91547
11;91;03;16;549;Sainte-Geneviève-des-Bois;35830;310;36140;91549
11;91;03;01;552;Saint-Germain-lès-Arpajon;10983;77;11060;91552
11;91;02;06;553;Saint-Germain-lès-Corbeil;7488;97;7585;91553
11;91;01;08;556;Saint-Hilaire;410;9;419;91556
11;91;03;18;560;Saint-Jean-de-Beauregard;487;7;494;91560
11;91;03;05;568;Saint-Maurice-Montcouronne;1544;37;1581;91568
11;91;03;03;570;Saint-Michel-sur-Orge;20484;147;20631;91570
11;91;02;07;573;Saint-Pierre-du-Perray;11220;111;11331;91573
11;91;02;07;577;Saintry-sur-Seine;5797;65;5862;91577
11;91;01;05;578;Saint-Sulpice-de-Favières;278;5;283;91578
11;91;03;03;579;Saint-Vrain;3059;52;3111;91579
11;91;01;01;581;Saint-Yon;902;10;912;91581
11;91;03;11;587;Saulx-les-Chartreux;6416;56;6472;91587
11;91;03;17;589;Savigny-sur-Orge;36577;246;36823;91589
11;91;01;05;593;Sermaise;1610;38;1648;91593
11;91;02;13;599;Soisy-sur-Ecole;1282;22;1304;91599
11;91;02;06;600;Soisy-sur-Seine;7213;138;7351;91600
11;91;01;05;602;Souzy-la-Briche;441;9;450;91602
11;91;01;08;613;Congerville-Thionville;216;8;224;91613
11;91;02;07;617;Tigery;4294;76;4370;91617
11;91;01;01;619;Torfou;274;10;284;91619
11;91;01;08;629;Valpuiseaux;620;12;632;91629
11;91;01;05;630;Le Val-Saint-Germain;1486;32;1518;91630
11;91;02;07;631;Varennes-Jarcy;2300;31;2331;91631
11;91;03;05;634;Vaugrigneuse;1355;31;1386;91634
11;91;03;10;635;Vauhallan;2064;32;2096;91635
11;91;01;08;639;Vayres-sur-Essonne;959;68;1027;91639
11;91;03;10;645;Verrières-le-Buisson;14888;360;15248;91645
11;91;02;15;648;Vert-le-Grand;2262;27;2289;91648
11;91;02;15;649;Vert-le-Petit;2818;38;2856;91649
11;91;01;13;654;Videlles;595;17;612;91654
11;91;02;19;657;Vigneux-sur-Seine;31394;181;31575;91657
11;91;02;04;659;Villabé;5487;43;5530;91659
11;91;03;18;661;Villebon-sur-Yvette;10466;165;10631;91661
11;91;01;05;662;Villeconin;726;22;748;91662
11;91;03;11;665;La Ville-du-Bois;8010;65;8075;91665
11;91;03;18;666;Villejust;2425;18;2443;91666
11;91;03;16;667;Villemoisson-sur-Orge;7058;90;7148;91667
11;91;01;08;671;Villeneuve-sur-Auvers;604;7;611;91671
11;91;03;10;679;Villiers-le-Bâcle;1212;17;1229;91679
11;91;03;16;685;Villiers-sur-Orge;4600;39;4639;91685
11;91;02;20;687;Viry-Châtillon;30865;214;31079;91687
11;91;03;17;689;Wissous;7133;69;7202;91689
11;91;02;21;691;Yerres;29318;209;29527;91691
11;91;03;18;692;Les Ulis;25024;150;25174;91692
11;92;01;01;002;Antony;62760;775;63535;92002
11;92;02;95;004;Asnières-sur-Seine;87143;666;87809;92004
11;92;01;03;007;Bagneux;40936;134;41070;92007
11;92;02;11;009;Bois-Colombes;28841;241;29082;92009
11;92;03;96;012;Boulogne-Billancourt;121583;1242;122825;92012
11;92;01;03;014;Bourg-la-Reine;21050;360;21410;92014
11;92;01;06;019;Châtenay-Malabry;34021;357;34378;92019
11;92;01;07;020;Châtillon;36639;295;36934;92020
11;92;03;17;022;Chaville;20771;310;21081;92022
11;92;01;08;023;Clamart;52925;499;53424;92023
11;92;02;09;024;Clichy;63089;257;63346;92024
11;92;02;97;025;Colombes;86534;586;87120;92025
11;92;02;98;026;Courbevoie;81558;655;82213;92026
11;92;01;07;032;Fontenay-aux-Roses;25531;231;25762;92032
11;92;02;23;033;Garches;17795;438;18233;92033
11;92;02;11;035;La Garenne-Colombes;29642;247;29889;92035
11;92;02;14;036;Gennevilliers;48530;216;48746;92036
11;92;03;15;040;Issy-les-Moulineaux;67981;704;68685;92040
11;92;02;16;044;Levallois-Perret;66082;571;66653;92044
11;92;01;18;046;Malakoff;30950;201;31151;92046
11;92;03;23;047;Marnes-la-Coquette;1774;61;1835;92047
11;92;03;17;048;Meudon;45818;684;46502;92048
11;92;01;18;049;Montrouge;48352;235;48587;92049
11;92;02;99;050;Nanterre;96277;640;96917;92050
11;92;02;21;051;Neuilly-sur-Seine;59599;985;60584;92051
11;92;01;06;060;Le Plessis-Robinson;30061;154;30215;92060
11;92;02;13;062;Puteaux;45157;289;45446;92062
11;92;02;22;063;Rueil-Malmaison;78317;1471;79788;92063
11;92;02;23;064;Saint-Cloud;30012;598;30610;92064
11;92;01;06;071;Sceaux;20004;370;20374;92071
11;92;03;05;072;Sèvres;23463;389;23852;92072
11;92;02;20;073;Suresnes;49311;505;49816;92073
11;92;03;08;075;Vanves;27846;285;28131;92075
11;92;02;23;076;Vaucresson;8683;325;9008;92076
11;92;03;23;077;Ville-d'Avray;11225;302;11527;92077
11;92;02;14;078;Villeneuve-la-Garenne;24097;86;24183;92078
11;93;03;01;001;Aubervilliers;88948;191;89139;93001
11;93;02;02;005;Aulnay-sous-Bois;86969;410;87379;93005
11;93;01;03;006;Bagnolet;36060;106;36166;93006
11;93;02;04;007;Le Blanc-Mesnil;57498;166;57664;93007
11;93;01;95;008;Bobigny;54363;165;54528;93008
11;93;01;06;010;Bondy;54587;159;54746;93010
11;93;02;07;013;Le Bourget;15905;43;15948;93013
11;93;02;11;014;Clichy-sous-Bois;28782;92;28874;93014
11;93;02;20;015;Coubron;4921;42;4963;93015
11;93;03;07;027;La Courneuve;45053;128;45181;93027
11;93;02;96;029;Drancy;72376;282;72658;93029
11;93;02;07;030;Dugny;11073;40;11113;93030
11;93;03;97;031;Epinay-sur-Seine;54611;157;54768;93031
11;93;02;10;032;Gagny;39661;199;39860;93032
11;93;02;14;033;Gournay-sur-Marne;6844;61;6905;93033
11;93;03;18;039;L'ÃŽle-Saint-Denis;8288;41;8329;93039
11;93;01;03;045;Les Lilas;23447;128;23575;93045
11;93;02;11;046;Livry-Gargan;45692;216;45908;93046
11;93;02;20;047;Montfermeil;27928;130;28058;93047
11;93;01;98;048;Montreuil;111240;570;111810;93048
11;93;02;21;049;Neuilly-Plaisance;20878;129;21007;93049
11;93;02;10;050;Neuilly-sur-Marne;35907;121;36028;93050
11;93;02;14;051;Noisy-le-Grand;67871;385;68256;93051
11;93;01;05;053;Noisy-le-Sec;44463;128;44591;93053
11;93;01;15;055;Pantin;59846;181;60027;93055
11;93;02;06;057;Les Pavillons-sous-Bois;23898;97;23995;93057
11;93;03;09;059;Pierrefitte-sur-Seine;30861;47;30908;93059
11;93;01;15;061;Le Pré-Saint-Gervais;17351;72;17423;93061
11;93;02;21;062;Le Raincy;14569;198;14767;93062
11;93;01;03;063;Romainville;30087;84;30171;93063
11;93;02;12;064;Rosny-sous-Bois;46024;174;46198;93064
11;93;03;99;066;Saint-Denis;112852;914;113766;93066
11;93;03;18;070;Saint-Ouen-sur-Seine;50697;129;50826;93070
11;93;02;19;071;Sevran;51734;173;51907;93071
11;93;03;17;072;Stains;38285;76;38361;93072
11;93;02;20;073;Tremblay-en-France;36461;163;36624;93073
11;93;02;20;074;Vaujours;7181;89;7270;93074
11;93;02;21;077;Villemomble;30405;185;30590;93077
11;93;02;19;078;Villepinte;37713;83;37796;93078
11;93;03;09;079;Villetaneuse;13574;82;13656;93079
11;94;03;15;001;Ablon-sur-Seine;5852;27;5879;94001
11;94;01;01;002;Alfortville;44805;161;44966;94002
11;94;03;02;003;Arcueil;21788;122;21910;94003
11;94;01;16;004;Boissy-Saint-Léger;16977;55;17032;94004
11;94;01;18;011;Bonneuil-sur-Marne;18062;72;18134;94011
11;94;02;22;015;Bry-sur-Marne;17525;198;17723;94015
11;94;03;02;016;Cachan;30440;274;30714;94016
11;94;02;93;017;Champigny-sur-Marne;76990;344;77334;94017
11;94;02;05;018;Charenton-le-Pont;29882;204;30086;94018
11;94;01;04;019;Chennevières-sur-Marne;18039;114;18153;94019
11;94;03;19;021;Chevilly-Larue;19988;69;20057;94021
11;94;03;06;022;Choisy-le-Roi;46150;209;46359;94022
11;94;01;94;028;Créteil;93246;476;93722;94028
11;94;02;09;033;Fontenay-sous-Bois;52008;419;52427;94033
11;94;03;10;034;Fresnes;28710;112;28822;94034
11;94;03;12;037;Gentilly;18815;106;18921;94037
11;94;03;10;038;L'HaÃ¿-les-Roses;32071;173;32244;94038
11;94;03;11;041;Ivry-sur-Seine;63748;250;63998;94041
11;94;02;05;042;Joinville-le-Pont;19652;155;19807;94042
11;94;03;12;043;Le Kremlin-Bicêtre;24971;114;25085;94043
11;94;01;21;044;Limeil-Brévannes;27833;112;27945;94044
11;94;02;13;046;Maisons-Alfort;56483;291;56774;94046
11;94;01;16;047;Mandres-les-Roses;4777;48;4825;94047
11;94;01;16;048;Marolles-en-Brie;4783;105;4888;94048
11;94;02;95;052;Nogent-sur-Marne;34042;236;34278;94052
11;94;01;16;053;Noiseau;4607;42;4649;94053
11;94;03;15;054;Orly;24627;178;24805;94054
11;94;01;18;055;Ormesson-sur-Marne;10419;91;10510;94055
11;94;01;16;056;Périgny;2688;24;2712;94056
11;94;02;14;058;Le Perreux-sur-Marne;33588;303;33891;94058
11;94;01;22;059;Le Plessis-Trévise;19829;78;19907;94059
11;94;01;16;060;La Queue-en-Brie;12051;133;12184;94060
11;94;03;19;065;Rungis;5657;67;5724;94065
11;94;02;23;067;Saint-Mandé;22377;199;22576;94067
11;94;02;96;068;Saint-Maur-des-Fossés;74976;912;75888;94068
11;94;02;05;069;Saint-Maurice;14189;118;14307;94069
11;94;01;16;070;Santeny;4014;61;4075;94070
11;94;01;18;071;Sucy-en-Brie;27157;258;27415;94071
11;94;03;19;073;Thiais;30676;234;30910;94073
11;94;03;21;074;Valenton;14883;51;14934;94074
11;94;01;16;075;Villecresnes;11779;65;11844;94075
11;94;03;20;076;Villejuif;55208;243;55451;94076
11;94;03;15;077;Villeneuve-le-Roi;21679;96;21775;94077
11;94;03;97;078;Villeneuve-Saint-Georges;34890;102;34992;94078
11;94;02;22;079;Villiers-sur-Marne;28895;119;29014;94079
11;94;02;98;080;Vincennes;49788;442;50230;94080
11;94;03;99;081;Vitry-sur-Seine;95510;459;95969;94081
11;95;03;16;002;Ableiges;1124;14;1138;95002
11;95;03;20;008;Aincourt;887;12;899;95008
11;95;03;20;011;Ambleville;387;3;390;95011
11;95;03;20;012;Amenucourt;205;6;211;95012
11;95;02;15;014;Andilly;2574;54;2628;95014
11;95;01;98;018;Argenteuil;111038;557;111595;95018
11;95;02;11;019;Arnouville;14255;80;14335;95019
11;95;03;16;023;Arronville;637;3;640;95023
11;95;03;20;024;Arthies;271;5;276;95024
11;95;02;14;026;Asnières-sur-Oise;2939;39;2978;95026
11;95;02;09;028;Attainville;1691;8;1699;95028
11;95;03;17;039;Auvers-sur-Oise;6813;102;6915;95039
11;95;03;20;040;Avernes;857;14;871;95040
11;95;02;07;042;Baillet-en-France;1899;15;1914;95042
11;95;03;20;046;Banthelu;148;2;150;95046
11;95;01;19;051;Beauchamp;8687;94;8781;95051
11;95;03;14;052;Beaumont-sur-Oise;9504;103;9607;95052
11;95;03;16;054;Le Bellay-en-Vexin;212;5;217;95054
11;95;02;09;055;Bellefontaine;477;3;480;95055
11;95;02;09;056;Belloy-en-France;2203;9;2212;95056
11;95;03;14;058;Bernes-sur-Oise;2733;24;2757;95058
11;95;03;16;059;Berville;350;3;353;95059
11;95;01;19;060;Bessancourt;7878;61;7939;95060
11;95;03;07;061;Béthemont-la-Forêt;410;2;412;95061
11;95;01;03;063;Bezons;31671;124;31795;95063
11;95;03;05;074;Boisemont;818;15;833;95074
11;95;03;16;078;Boissy-l'Aillerie;1844;31;1875;95078
11;95;02;21;088;Bonneuil-en-France;1129;2;1131;95088
11;95;02;07;091;Bouffémont;6578;58;6636;95091
11;95;02;21;094;Bouqueval;302;3;305;95094
11;95;03;20;101;Bray-et-Lû;962;12;974;95101
11;95;03;16;102;Bréançon;404;9;413;95102
11;95;03;16;110;Brignancourt;212;3;215;95110
11;95;03;14;116;Bruyères-sur-Oise;4347;34;4381;95116
11;95;03;20;119;Buhy;322;3;325;95119
11;95;03;17;120;Butry-sur-Oise;2276;24;2300;95120
11;95;03;99;127;Cergy;65911;518;66429;95127
11;95;03;14;134;Champagne-sur-Oise;5018;42;5060;95134
11;95;03;20;139;La Chapelle-en-Vexin;316;5;321;95139
11;95;03;20;141;Charmont;36;0;36;95141
11;95;03;16;142;Chars;2046;17;2063;95142
11;95;02;09;144;Châtenay-en-France;76;1;77;95144
11;95;02;09;149;Chaumontel;3241;54;3295;95149
11;95;03;20;150;Chaussy;582;15;597;95150
11;95;03;07;151;Chauvry;299;5;304;95151
11;95;02;12;154;Chennevières-lès-Louvres;305;3;308;95154
11;95;03;20;157;Chérence;124;4;128;95157
11;95;03;20;166;Cléry-en-Vexin;465;7;472;95166
11;95;03;16;169;Commeny;498;3;501;95169
11;95;03;20;170;Condécourt;548;1;549;95170
11;95;01;10;176;Cormeilles-en-Parisis;25406;214;25620;95176
11;95;03;16;177;Cormeilles-en-Vexin;1333;14;1347;95177
11;95;03;16;181;Courcelles-sur-Viosne;288;3;291;95181
11;95;03;20;183;Courdimanche;6709;111;6820;95183
11;95;02;06;197;Deuil-la-Barre;22149;187;22336;95197
11;95;02;07;199;Domont;15504;194;15698;95199
11;95;01;08;203;Eaubonne;25335;318;25653;95203
11;95;02;09;205;Ecouen;7125;44;7169;95205
11;95;02;15;210;Enghien-les-Bains;11470;158;11628;95210
11;95;03;16;211;Ennery;2418;24;2442;95211
11;95;02;12;212;Epiais-lès-Louvres;109;0;109;95212
11;95;03;16;213;Epiais-Rhus;616;15;631;95213
11;95;02;09;214;Epinay-Champlâtreux;70;0;70;95214
11;95;03;05;218;Eragny;18296;120;18416;95218
11;95;01;08;219;Ermont;28939;244;29183;95219
11;95;02;09;229;Ezanville;9656;56;9712;95229
11;95;02;09;241;Fontenay-en-Parisis;2007;16;2023;95241
11;95;02;09;250;Fosses;9791;61;9852;95250
11;95;01;10;252;Franconville;37394;170;37564;95252
11;95;03;20;253;Frémainville;520;11;531;95253
11;95;03;16;254;Frémécourt;558;7;565;95254
11;95;01;17;256;Frépillon;3342;44;3386;95256
11;95;01;13;257;La Frette-sur-Seine;4701;41;4742;95257
11;95;03;17;258;Frouville;349;8;357;95258
11;95;02;11;268;Garges-lès-Gonesse;43239;94;43333;95268
11;95;03;20;270;Genainville;541;19;560;95270
11;95;03;16;271;Génicourt;519;9;528;95271
11;95;02;21;277;Gonesse;26106;122;26228;95277
11;95;02;12;280;Goussainville;31068;143;31211;95280
11;95;03;16;282;Gouzangrez;160;1;161;95282
11;95;03;16;287;Grisy-les-Plâtres;694;12;706;95287
11;95;02;06;288;Groslay;8509;52;8561;95288
11;95;03;20;295;Guiry-en-Vexin;142;3;145;95295
11;95;03;16;298;Haravilliers;561;7;568;95298
11;95;03;20;301;Haute-Isle;286;6;292;95301
11;95;03;16;303;Le Heaulme;206;1;207;95303
11;95;03;17;304;Hédouville;281;2;283;95304
11;95;01;13;306;Herblay-sur-Seine;31314;231;31545;95306
11;95;03;17;308;Hérouville-en-Vexin;576;12;588;95308
11;95;03;20;309;Hodent;207;3;210;95309
11;95;03;14;313;L'Isle-Adam;12063;216;12279;95313
11;95;02;09;316;Jagny-sous-Bois;271;2;273;95316
11;95;03;05;323;Jouy-le-Moutier;16741;132;16873;95323
11;95;03;17;328;Labbeville;643;7;650;95328
11;95;02;09;331;Lassy;190;3;193;95331
11;95;03;16;341;Livilliers;383;9;392;95341
11;95;03;20;348;Longuesse;550;6;556;95348
11;95;02;12;351;Louvres;11037;83;11120;95351
11;95;02;09;352;Luzarches;4733;79;4812;95352
11;95;02;09;353;Maffliers;1834;17;1851;95353
11;95;03;20;355;Magny-en-Vexin;5846;58;5904;95355
11;95;02;09;365;Mareil-en-France;707;8;715;95365
11;95;02;15;369;Margency;2846;50;2896;95369
11;95;03;16;370;Marines;3446;52;3498;95370
11;95;02;12;371;Marly-la-Ville;5663;43;5706;95371
11;95;03;20;379;Maudétour-en-Vexin;188;2;190;95379
11;95;03;16;387;Menouville;62;0;62;95387
11;95;03;20;388;Menucourt;5902;53;5955;95388
11;95;03;17;392;Mériel;5168;53;5221;95392
11;95;03;17;394;Méry-sur-Oise;9865;97;9962;95394
11;95;02;09;395;Le Mesnil-Aubry;898;9;907;95395
11;95;02;07;409;Moisselles;1287;3;1290;95409
11;95;03;16;422;Montgeroult;347;3;350;95422
11;95;01;13;424;Montigny-lès-Cormeilles;21528;110;21638;95424
11;95;02;15;426;Montlignon;2937;75;3012;95426
11;95;02;06;427;Montmagny;14523;65;14588;95427
11;95;02;15;428;Montmorency;21723;252;21975;95428
11;95;03;20;429;Montreuil-sur-Epte;406;10;416;95429
11;95;02;07;430;Montsoult;3633;35;3668;95430
11;95;03;14;436;Mours;1629;9;1638;95436
11;95;03;16;438;Moussy;121;2;123;95438
11;95;03;14;445;Nerville-la-Forêt;747;4;751;95445
11;95;03;17;446;Nesles-la-Vallée;1803;31;1834;95446
11;95;03;16;447;Neuilly-en-Vexin;220;4;224;95447
11;95;03;05;450;Neuville-sur-Oise;2043;28;2071;95450
11;95;03;14;452;Nointel;863;7;870;95452
11;95;03;14;456;Noisy-sur-Oise;653;4;657;95456
11;95;03;16;459;Nucourt;699;15;714;95459
11;95;03;20;462;Omerville;323;8;331;95462
11;95;03;04;476;Osny;17446;239;17685;95476
11;95;03;14;480;Parmain;5589;112;5701;95480
11;95;03;16;483;Le Perchay;533;4;537;95483
11;95;03;14;487;Persan;13734;54;13788;95487
11;95;01;19;488;Pierrelaye;9423;39;9462;95488
11;95;02;07;489;Piscop;671;69;740;95489
11;95;01;07;491;Le Plessis-Bouchard;8514;75;8589;95491
11;95;02;09;492;Le Plessis-Gassot;74;0;74;95492
11;95;02;09;493;Le Plessis-Luzarches;128;1;129;95493
11;95;03;16;500;Pontoise;32405;486;32891;95500
11;95;03;14;504;Presles;3923;51;3974;95504
11;95;02;09;509;Puiseux-en-France;3563;32;3595;95509
11;95;03;04;510;Puiseux-Pontoise;583;11;594;95510
11;95;03;20;523;La Roche-Guyon;479;37;516;95523
11;95;02;21;527;Roissy-en-France;2833;26;2859;95527
11;95;03;14;529;Ronquerolles;866;8;874;95529
11;95;03;20;535;Sagy;1104;26;1130;95535
11;95;02;06;539;Saint-Brice-sous-Forêt;15043;78;15121;95539
11;95;03;20;541;Saint-Clair-sur-Epte;1001;13;1014;95541
11;95;03;20;543;Saint-Cyr-en-Arthies;240;1;241;95543
11;95;03;20;554;Saint-Gervais;896;19;915;95554
11;95;02;01;555;Saint-Gratien;20895;166;21061;95555
11;95;01;07;563;Saint-Leu-la-Forêt;16130;174;16304;95563
11;95;02;09;566;Saint-Martin-du-Tertre;2697;24;2721;95566
11;95;03;17;572;Saint-Ouen-l'Aumône;24674;115;24789;95572
11;95;02;07;574;Saint-Prix;7036;107;7143;95574
11;95;02;12;580;Saint-Witz;2379;104;2483;95580
11;95;01;01;582;Sannois;26565;336;26901;95582
11;95;03;16;584;Santeuil;663;7;670;95584
11;95;02;18;585;Sarcelles;59196;252;59448;95585
11;95;03;20;592;Seraincourt;1290;14;1304;95592
11;95;02;09;594;Seugy;1025;14;1039;95594
11;95;02;15;598;Soisy-sous-Montmorency;18033;161;18194;95598
11;95;02;12;604;Survilliers;4213;25;4238;95604
11;95;01;19;607;Taverny;26872;190;27062;95607
11;95;03;20;610;Théméricourt;300;7;307;95610
11;95;03;16;611;Theuville;50;0;50;95611
11;95;02;21;612;Le Thillay;4567;21;4588;95612
11;95;03;16;625;Us;1339;12;1351;95625
11;95;03;16;627;Vallangoujard;598;13;611;95627
11;95;03;17;628;Valmondois;1213;25;1238;95628
11;95;02;21;633;Vaudherland;98;0;98;95633
11;95;03;20;637;Vauréal;16456;219;16675;95637
11;95;02;12;641;Vémars;2699;22;2721;95641
11;95;03;20;651;Vétheuil;884;19;903;95651
11;95;02;09;652;Viarmes;5194;73;5267;95652
11;95;03;20;656;Vienne-en-Arthies;379;6;385;95656
11;95;03;20;658;Vigny;1083;22;1105;95658
11;95;02;09;660;Villaines-sous-Bois;775;8;783;95660
11;95;02;12;675;Villeron;1506;14;1520;95675
11;95;03;20;676;Villers-en-Arthies;490;10;500;95676
11;95;03;14;678;Villiers-Adam;861;11;872;95678
11;95;02;21;680;Villiers-le-Bel;28423;117;28540;95680
11;95;02;09;682;Villiers-le-Sec;189;3;192;95682
11;95;03;20;690;Wy-dit-Joli-Village;330;7;337;95690
01;971;02;93;101;Les Abymes;53514;513;54027;971101
01;971;02;14;102;Anse-Bertrand;4001;64;4065;971102
01;971;01;94;103;Baie-Mahault;30837;498;31335;971103
01;971;01;21;104;Baillif;5203;92;5295;971104
01;971;01;06;105;Basse-Terre;9861;244;10105;971105
01;971;01;95;106;Bouillante;6847;111;6958;971106
01;971;01;07;107;Capesterre-Belle-Eau;17741;173;17914;971107
01;971;02;10;108;Capesterre-de-Marie-Galante;3298;43;3341;971108
01;971;01;20;109;Gourbeyre;7760;185;7945;971109
01;971;02;16;110;La Désirade;1419;34;1453;971110
01;971;01;18;111;Deshaies;3998;65;4063;971111
01;971;02;10;112;Grand-Bourg;4870;132;5002;971112
01;971;02;96;113;Le Gosier;26489;344;26833;971113
01;971;01;13;114;Goyave;7621;138;7759;971114
01;971;01;09;115;Lamentin;16354;297;16651;971115
01;971;02;12;116;Morne-Ã -l'Eau;16495;197;16692;971116
01;971;02;11;117;Le Moule;22149;274;22423;971117
01;971;01;97;118;Petit-Bourg;24753;421;25174;971118
01;971;02;14;119;Petit-Canal;8203;123;8326;971119
01;971;02;15;120;Pointe-Ã -Pitre;15181;108;15289;971120
01;971;01;18;121;Pointe-Noire;6031;144;6175;971121
01;971;02;14;122;Port-Louis;5618;70;5688;971122
01;971;01;06;124;Saint-Claude;10466;265;10731;971124
01;971;02;16;125;Saint-François;11689;160;11849;971125
01;971;02;10;126;Saint-Louis;2397;54;2451;971126
01;971;;;127;Saint-Martin;32489;592;33081;971127
01;971;02;98;128;Sainte-Anne;24151;269;24420;971128
01;971;01;99;129;Sainte-Rose;17985;294;18279;971129
01;971;01;20;130;Terre-de-Bas;975;24;999;971130
01;971;01;20;131;Terre-de-Haut;1519;51;1570;971131
01;971;01;20;132;Trois-Rivières;7862;148;8010;971132
01;971;01;20;133;Vieux-Fort;1842;31;1873;971133
01;971;01;21;134;Vieux-Habitants;7110;190;7300;971134
02;972;02;  ;201;L'Ajoupa-Bouillon;1756;31;1787;972201
02;972;03;  ;202;Les Anses-d'Arlet;3494;53;3547;972202
02;972;02;  ;203;Basse-Pointe;2823;42;2865;972203
02;972;04;  ;204;Le Carbet;3461;47;3508;972204
02;972;04;  ;205;Case-Pilote;4455;68;4523;972205
02;972;03;  ;206;Le Diamant;5511;74;5585;972206
02;972;03;  ;207;Ducos;17655;287;17942;972207
02;972;04;  ;208;Fonds-Saint-Denis;680;12;692;972208
02;972;01;  ;209;Fort-de-France;76512;898;77410;972209
02;972;03;  ;210;Le François;15980;210;16190;972210
02;972;02;  ;211;Grand'Rivière;610;11;621;972211
02;972;02;  ;212;Gros-Morne;9689;88;9777;972212
02;972;01;  ;213;Le Lamentin;40095;590;40685;972213
02;972;02;  ;214;Le Lorrain;6768;76;6844;972214
02;972;02;  ;215;Macouba;1050;8;1058;972215
02;972;02;  ;216;Le Marigot;3117;49;3166;972216
02;972;03;  ;217;Le Marin;8751;145;8896;972217
02;972;04;  ;218;Le Morne-Rouge;4795;53;4848;972218
02;972;04;  ;219;Le Prêcheur;1203;23;1226;972219
02;972;03;  ;220;Rivière-Pilote;11877;143;12020;972220
02;972;03;  ;221;Rivière-Salée;11874;237;12111;972221
02;972;02;  ;222;Le Robert;21913;183;22096;972222
02;972;03;  ;223;Saint-Esprit;9890;97;9987;972223
02;972;01;  ;224;Saint-Joseph;15883;249;16132;972224
02;972;04;  ;225;Saint-Pierre;4121;55;4176;972225
02;972;03;  ;226;Sainte-Anne;4444;59;4503;972226
02;972;03;  ;227;Sainte-Luce;9487;204;9691;972227
02;972;02;  ;228;Sainte-Marie;15487;165;15652;972228
02;972;01;  ;229;SchÅ“lcher;19612;218;19830;972229
02;972;02;  ;230;La Trinité;12025;152;12177;972230
02;972;03;  ;231;Les Trois-ÃŽlets;7242;123;7365;972231
02;972;03;  ;232;Le Vauclin;8619;96;8715;972232
02;972;04;  ;233;Le Morne-Vert;1816;26;1842;972233
02;972;04;  ;234;Bellefontaine;1813;126;1939;972234
03;973;01;  ;301;Régina;854;26;880;973301
03;973;01;  ;302;Cayenne;65493;385;65878;973302
03;973;01;  ;303;Iracoubo;1748;20;1768;973303
03;973;01;  ;304;Kourou;24903;245;25148;973304
03;973;01;  ;305;Macouria;16219;186;16405;973305
03;973;02;  ;306;Mana;11675;170;11845;973306
03;973;01;  ;307;Matoury;33458;238;33696;973307
03;973;01;  ;308;Saint-Georges;4245;90;4335;973308
03;973;01;  ;309;Remire-Montjoly;26358;381;26739;973309
03;973;01;  ;310;Roura;3458;54;3512;973310
03;973;02;  ;311;Saint-Laurent-du-Maroni;47621;342;47963;973311
03;973;01;  ;312;Sinnamary;2875;44;2919;973312
03;973;01;  ;313;Montsinéry-Tonnegrande;2957;19;2976;973313
03;973;01;  ;314;Ouanary;242;1;243;973314
03;973;02;  ;352;SaÃ¼l;152;7;159;973352
03;973;02;  ;353;Maripasoula;11842;125;11967;973353
03;973;01;  ;356;Camopi;1864;24;1888;973356
03;973;02;  ;357;Grand-Santi;8779;5;8784;973357
03;973;01;  ;358;Saint-Elie;247;1;248;973358
03;973;02;  ;360;Apatou;9482;15;9497;973360
03;973;02;  ;361;Awala-Yalimapo;1449;12;1461;973361
03;973;02;  ;362;Papaichton;5757;17;5774;973362
04;974;02;01;401;Les Avirons;11440;210;11650;974401
04;974;03;06;402;Bras-Panon;13057;203;13260;974402
04;974;02;16;403;Entre-Deux;6927;65;6992;974403
04;974;02;01;404;L'Etang-Salé;14059;199;14258;974404
04;974;02;22;405;Petite-ÃŽle;12395;123;12518;974405
04;974;03;07;406;La Plaine-des-Palmistes;6626;99;6725;974406
04;974;04;02;407;Le Port;32977;258;33235;974407
04;974;04;03;408;La Possession;32985;420;33405;974408
04;974;03;91;409;Saint-André;56902;464;57366;974409
04;974;03;92;410;Saint-Benoît;37036;249;37285;974410
04;974;01;93;411;Saint-Denis;153810;1492;155302;974411
04;974;02;94;412;Saint-Joseph;37918;507;38425;974412
04;974;04;95;413;Saint-Leu;34586;476;35062;974413
04;974;02;96;414;Saint-Louis;53120;573;53693;974414
04;974;04;97;415;Saint-Paul;103208;1348;104556;974415
04;974;02;98;416;Saint-Pierre;84982;896;85878;974416
04;974;02;08;417;Saint-Philippe;5198;66;5264;974417
04;974;01;23;418;Sainte-Marie;34061;450;34511;974418
04;974;03;08;419;Sainte-Rose;6345;77;6422;974419
04;974;01;04;420;Sainte-Suzanne;24065;227;24292;974420
04;974;03;06;421;Salazie;7136;73;7209;974421
04;974;02;99;422;Le Tampon;79824;1009;80833;974422
04;974;04;14;423;Les Trois-Bassins;7015;91;7106;974423
04;974;02;16;424;Cilaos;5538;85;5623;974424
